rundate,this_period,last_period,grp_cd,grp_name,apt1_apt_name,apt2_apt_name,total_pax_tp,total_pax_shd_tp,total_pax_cht_tp,total_pax_lp,total_pax_shd_lp,total_pax_cht_lp,total_pax_pc
08/03/2018 10:34,2017,2016,A,London Area Airports,GATWICK,ABERDEEN,156446,156446,0,143651,143651,0,8.907
08/03/2018 10:34,2017,2016,A,London Area Airports,GATWICK,BELFAST CITY (GEORGE BEST),0,0,0,39662,39662,0,-100
08/03/2018 10:34,2017,2016,A,London Area Airports,GATWICK,BELFAST INTERNATIONAL,982928,982925,3,858757,858744,13,14.45939
08/03/2018 10:34,2017,2016,A,London Area Airports,GATWICK,BIRMINGHAM,203,55,148,62,60,2,227.41935
08/03/2018 10:34,2017,2016,A,London Area Airports,GATWICK,BOURNEMOUTH,177,176,1,0,0,0,0
08/03/2018 10:34,2017,2016,A,London Area Airports,GATWICK,BRISTOL,1,0,1,2,0,2,-50
08/03/2018 10:34,2017,2016,A,London Area Airports,GATWICK,CARDIFF WALES,86,0,86,112,0,112,-23.21429
08/03/2018 10:34,2017,2016,A,London Area Airports,GATWICK,DONCASTER SHEFFIELD,169,0,169,246,0,246,-31.30081
08/03/2018 10:34,2017,2016,A,London Area Airports,GATWICK,DURHAM TEES VALLEY,0,0,0,124,0,124,-100
08/03/2018 10:34,2017,2016,A,London Area Airports,GATWICK,EAST MIDLANDS INTERNATIONAL,106,0,106,104,0,104,1.92308
08/03/2018 10:34,2017,2016,A,London Area Airports,GATWICK,EDINBURGH,737285,737285,0,700064,699899,165,5.3168
08/03/2018 10:34,2017,2016,A,London Area Airports,GATWICK,EXETER,189,189,0,2,1,1,9350
08/03/2018 10:34,2017,2016,A,London Area Airports,GATWICK,GLASGOW,618673,618423,250,608550,608381,169,1.66346
08/03/2018 10:34,2017,2016,A,London Area Airports,GATWICK,GUERNSEY,319573,319573,0,311468,311468,0,2.60219
08/03/2018 10:34,2017,2016,A,London Area Airports,GATWICK,HEATHROW,735,670,65,457,452,5,60.83151
08/03/2018 10:34,2017,2016,A,London Area Airports,GATWICK,HUMBERSIDE,99,0,99,334,0,334,-70.35928
08/03/2018 10:34,2017,2016,A,London Area Airports,GATWICK,INVERNESS,263411,263411,0,237927,237926,1,10.71085
08/03/2018 10:34,2017,2016,A,London Area Airports,GATWICK,ISLE OF MAN,171386,171386,0,155840,155840,0,9.97562
08/03/2018 10:34,2017,2016,A,London Area Airports,GATWICK,JERSEY,664879,664877,2,658968,658694,274,0.89701
08/03/2018 10:34,2017,2016,A,London Area Airports,GATWICK,LEEDS BRADFORD,190,1,189,213,138,75,-10.79812
08/03/2018 10:34,2017,2016,A,London Area Airports,GATWICK,LIVERPOOL (JOHN LENNON),219,0,219,138,0,138,58.69565
08/03/2018 10:34,2017,2016,A,London Area Airports,GATWICK,LONDON CITY,39,39,0,17,17,0,129.41176
08/03/2018 10:34,2017,2016,A,London Area Airports,GATWICK,LUTON,521,290,231,2,0,2,25950
08/03/2018 10:34,2017,2016,A,London Area Airports,GATWICK,MANCHESTER,1190,239,951,478,249,229,148.95397
08/03/2018 10:34,2017,2016,A,London Area Airports,GATWICK,NEWCASTLE,232,0,232,349,154,195,-33.52436
08/03/2018 10:34,2017,2016,A,London Area Airports,GATWICK,NEWQUAY,161614,161614,0,150137,150137,0,7.64435
08/03/2018 10:34,2017,2016,A,London Area Airports,GATWICK,NORWICH,107,0,107,38,0,38,181.57895
08/03/2018 10:34,2017,2016,A,London Area Airports,GATWICK,PRESTWICK,13,0,13,0,0,0,0
08/03/2018 10:34,2017,2016,A,London Area Airports,GATWICK,SOUTHEND,1,0,1,1,0,1,0
08/03/2018 10:34,2017,2016,A,London Area Airports,GATWICK,STANSTED,790,643,147,2,0,2,39400
08/03/2018 10:34,2017,2016,A,London Area Airports,GATWICK,WARTON,0,0,0,33,0,33,-100
08/03/2018 10:34,2017,2016,A,London Area Airports,HEATHROW,ABERDEEN,622034,622034,0,592701,592701,0,4.94904
08/03/2018 10:34,2017,2016,A,London Area Airports,HEATHROW,BELFAST CITY (GEORGE BEST),691552,691552,0,693937,693937,0,-0.34369
08/03/2018 10:34,2017,2016,A,London Area Airports,HEATHROW,BELFAST INTERNATIONAL,78,78,0,0,0,0,0
08/03/2018 10:34,2017,2016,A,London Area Airports,HEATHROW,BIRMINGHAM,168,168,0,0,0,0,0
08/03/2018 10:34,2017,2016,A,London Area Airports,HEATHROW,EDINBURGH,1179758,1179758,0,1053382,1053382,0,11.99717
08/03/2018 10:34,2017,2016,A,London Area Airports,HEATHROW,EXETER,71,0,71,0,0,0,0
08/03/2018 10:34,2017,2016,A,London Area Airports,HEATHROW,GATWICK,60,0,60,0,0,0,0
08/03/2018 10:34,2017,2016,A,London Area Airports,HEATHROW,GLASGOW,909117,909117,0,893846,893846,0,1.70846
08/03/2018 10:34,2017,2016,A,London Area Airports,HEATHROW,INVERNESS,79065,79065,0,57879,57879,0,36.60395
08/03/2018 10:34,2017,2016,A,London Area Airports,HEATHROW,LEEDS BRADFORD,162042,162042,0,160703,160703,0,0.83321
08/03/2018 10:34,2017,2016,A,London Area Airports,HEATHROW,LIVERPOOL (JOHN LENNON),72,72,0,0,0,0,0
08/03/2018 10:34,2017,2016,A,London Area Airports,HEATHROW,MANCHESTER,665203,665203,0,692960,692923,37,-4.00557
08/03/2018 10:34,2017,2016,A,London Area Airports,HEATHROW,NEWCASTLE,491597,491597,0,499479,499479,0,-1.57804
08/03/2018 10:34,2017,2016,A,London Area Airports,LONDON CITY,ABERDEEN,54350,54350,0,64452,64452,0,-15.67368
08/03/2018 10:34,2017,2016,A,London Area Airports,LONDON CITY,BELFAST CITY (GEORGE BEST),121019,121019,0,111944,111944,0,8.10673
08/03/2018 10:34,2017,2016,A,London Area Airports,LONDON CITY,BIRMINGHAM,55,55,0,0,0,0,0
08/03/2018 10:34,2017,2016,A,London Area Airports,LONDON CITY,CARDIFF WALES,21273,21195,78,12425,12380,45,71.21127
08/03/2018 10:34,2017,2016,A,London Area Airports,LONDON CITY,EDINBURGH,484892,484892,0,528029,527934,95,-8.16944
08/03/2018 10:34,2017,2016,A,London Area Airports,LONDON CITY,EXETER,33616,33616,0,38151,38151,0,-11.88698
08/03/2018 10:34,2017,2016,A,London Area Airports,LONDON CITY,GATWICK,0,0,0,48,48,0,-100
08/03/2018 10:34,2017,2016,A,London Area Airports,LONDON CITY,GLASGOW,231092,231092,0,235075,235075,0,-1.69435
08/03/2018 10:34,2017,2016,A,London Area Airports,LONDON CITY,GUERNSEY,21694,21694,0,26442,26442,0,-17.95628
08/03/2018 10:34,2017,2016,A,London Area Airports,LONDON CITY,HEATHROW,12,12,0,0,0,0,0
08/03/2018 10:34,2017,2016,A,London Area Airports,LONDON CITY,ISLE OF MAN,62061,62061,0,74001,74001,0,-16.13492
08/03/2018 10:34,2017,2016,A,London Area Airports,LONDON CITY,JERSEY,35150,35150,0,36987,36987,0,-4.96661
08/03/2018 10:34,2017,2016,A,London Area Airports,LONDON CITY,LIVERPOOL (JOHN LENNON),0,0,0,43,0,43,-100
08/03/2018 10:34,2017,2016,A,London Area Airports,LONDON CITY,MANCHESTER,2266,2266,0,84,84,0,2597.61905
08/03/2018 10:34,2017,2016,A,London Area Airports,LONDON CITY,SOUTHAMPTON,203,203,0,0,0,0,0
08/03/2018 10:34,2017,2016,A,London Area Airports,LUTON,ABERDEEN,75148,75148,0,72149,72141,8,4.15668
08/03/2018 10:34,2017,2016,A,London Area Airports,LUTON,BELFAST CITY (GEORGE BEST),55,0,55,37,0,37,48.64865
08/03/2018 10:34,2017,2016,A,London Area Airports,LUTON,BELFAST INTERNATIONAL,340072,340020,52,310431,310315,116,9.54834
08/03/2018 10:34,2017,2016,A,London Area Airports,LUTON,BIRMINGHAM,525,525,0,0,0,0,0
08/03/2018 10:34,2017,2016,A,London Area Airports,LUTON,BOURNEMOUTH,78,0,78,64,0,64,21.875
08/03/2018 10:34,2017,2016,A,London Area Airports,LUTON,CARDIFF WALES,85,0,85,74,0,74,14.86486
08/03/2018 10:34,2017,2016,A,London Area Airports,LUTON,DUNDEE,0,0,0,56,29,27,-100
08/03/2018 10:34,2017,2016,A,London Area Airports,LUTON,DURHAM TEES VALLEY,0,0,0,103,0,103,-100
08/03/2018 10:34,2017,2016,A,London Area Airports,LUTON,EAST MIDLANDS INTERNATIONAL,181,181,0,148,148,0,22.2973
08/03/2018 10:34,2017,2016,A,London Area Airports,LUTON,EDINBURGH,309124,309124,0,272503,272446,57,13.43875
08/03/2018 10:34,2017,2016,A,London Area Airports,LUTON,FARNBOROUGH,8,0,8,0,0,0,0
08/03/2018 10:34,2017,2016,A,London Area Airports,LUTON,GATWICK,145,145,0,0,0,0,0
08/03/2018 10:34,2017,2016,A,London Area Airports,LUTON,GLASGOW,234768,234398,370,214693,214631,62,9.35056
08/03/2018 10:34,2017,2016,A,London Area Airports,LUTON,GUERNSEY,108,108,0,0,0,0,0
08/03/2018 10:34,2017,2016,A,London Area Airports,LUTON,HUMBERSIDE,0,0,0,177,0,177,-100
08/03/2018 10:34,2017,2016,A,London Area Airports,LUTON,INVERNESS,136364,136282,82,133945,133876,69,1.80597
08/03/2018 10:34,2017,2016,A,London Area Airports,LUTON,ISLE OF MAN,16975,16969,6,13,0,13,130476.92308
08/03/2018 10:34,2017,2016,A,London Area Airports,LUTON,JERSEY,46574,46574,0,36398,36398,0,27.95758
08/03/2018 10:34,2017,2016,A,London Area Airports,LUTON,LEEDS BRADFORD,113,113,0,21,0,21,438.09524
08/03/2018 10:34,2017,2016,A,London Area Airports,LUTON,LIVERPOOL (JOHN LENNON),112,0,112,400,0,400,-72
08/03/2018 10:34,2017,2016,A,London Area Airports,LUTON,MANCHESTER,372,155,217,588,0,588,-36.73469
08/03/2018 10:34,2017,2016,A,London Area Airports,LUTON,NEWCASTLE,0,0,0,379,0,379,-100
08/03/2018 10:34,2017,2016,A,London Area Airports,LUTON,NORTHOLT,0,0,0,5,0,5,-100
08/03/2018 10:34,2017,2016,A,London Area Airports,LUTON,NORWICH,0,0,0,6,0,6,-100
08/03/2018 10:34,2017,2016,A,London Area Airports,LUTON,SOUTHEND,134,134,0,0,0,0,0
08/03/2018 10:34,2017,2016,A,London Area Airports,LUTON,STANSTED,777,777,0,213,213,0,264.78873
08/03/2018 10:34,2017,2016,A,London Area Airports,LUTON,WICK JOHN O GROATS,0,0,0,100,0,100,-100
08/03/2018 10:34,2017,2016,A,London Area Airports,SOUTHEND,ABERDEEN,320,320,0,245,245,0,30.61224
08/03/2018 10:34,2017,2016,A,London Area Airports,SOUTHEND,BELFAST CITY (GEORGE BEST),506,506,0,315,315,0,60.63492
08/03/2018 10:34,2017,2016,A,London Area Airports,SOUTHEND,BELFAST INTERNATIONAL,0,0,0,154,154,0,-100
08/03/2018 10:34,2017,2016,A,London Area Airports,SOUTHEND,CARDIFF WALES,180,180,0,42,42,0,328.57143
08/03/2018 10:34,2017,2016,A,London Area Airports,SOUTHEND,DUNDEE,0,0,0,22,22,0,-100
08/03/2018 10:34,2017,2016,A,London Area Airports,SOUTHEND,EDINBURGH,671,671,0,424,424,0,58.25472
08/03/2018 10:34,2017,2016,A,London Area Airports,SOUTHEND,EXETER,336,336,0,213,213,0,57.74648
08/03/2018 10:34,2017,2016,A,London Area Airports,SOUTHEND,GLASGOW,6375,6375,0,100,100,0,6275
08/03/2018 10:34,2017,2016,A,London Area Airports,SOUTHEND,GUERNSEY,18,18,0,193,193,0,-90.67358
08/03/2018 10:34,2017,2016,A,London Area Airports,SOUTHEND,ISLE OF MAN,180,180,0,133,133,0,35.33835
08/03/2018 10:34,2017,2016,A,London Area Airports,SOUTHEND,JERSEY,25701,25701,0,23761,23761,0,8.16464
08/03/2018 10:34,2017,2016,A,London Area Airports,SOUTHEND,KIRKWALL,0,0,0,118,0,118,-100
08/03/2018 10:34,2017,2016,A,London Area Airports,SOUTHEND,LIVERPOOL (JOHN LENNON),60,60,0,0,0,0,0
08/03/2018 10:34,2017,2016,A,London Area Airports,SOUTHEND,LONDON CITY,0,0,0,154,154,0,-100
08/03/2018 10:34,2017,2016,A,London Area Airports,SOUTHEND,MANCHESTER,7587,7587,0,0,0,0,0
08/03/2018 10:34,2017,2016,A,London Area Airports,SOUTHEND,NEWCASTLE,0,0,0,85,85,0,-100
08/03/2018 10:34,2017,2016,A,London Area Airports,STANSTED,ABERDEEN,0,0,0,27,27,0,-100
08/03/2018 10:34,2017,2016,A,London Area Airports,STANSTED,BELFAST INTERNATIONAL,375785,375785,0,363943,363943,0,3.25381
08/03/2018 10:34,2017,2016,A,London Area Airports,STANSTED,CITY OF DERRY (EGLINTON),54696,54696,0,116748,116748,0,-53.15038
08/03/2018 10:34,2017,2016,A,London Area Airports,STANSTED,DUNDEE,20652,20652,0,20852,20852,0,-0.95914
08/03/2018 10:34,2017,2016,A,London Area Airports,STANSTED,DURHAM TEES VALLEY,68,0,68,0,0,0,0
08/03/2018 10:34,2017,2016,A,London Area Airports,STANSTED,EDINBURGH,720271,720271,0,836860,836696,164,-13.93172
08/03/2018 10:34,2017,2016,A,London Area Airports,STANSTED,GATWICK,582,582,0,100,100,0,482
08/03/2018 10:34,2017,2016,A,London Area Airports,STANSTED,GLASGOW,527139,527139,0,652434,652434,0,-19.20424
08/03/2018 10:34,2017,2016,A,London Area Airports,STANSTED,GUERNSEY,25739,25739,0,26778,26778,0,-3.88005
08/03/2018 10:34,2017,2016,A,London Area Airports,STANSTED,INVERNESS,410,150,260,56,0,56,632.14286
08/03/2018 10:34,2017,2016,A,London Area Airports,STANSTED,ISLE OF MAN,0,0,0,8968,8968,0,-100
08/03/2018 10:34,2017,2016,A,London Area Airports,STANSTED,LIVERPOOL (JOHN LENNON),0,0,0,182,182,0,-100
08/03/2018 10:34,2017,2016,A,London Area Airports,STANSTED,LONDON CITY,0,0,0,65,65,0,-100
08/03/2018 10:34,2017,2016,A,London Area Airports,STANSTED,LUTON,185,185,0,0,0,0,0
08/03/2018 10:34,2017,2016,A,London Area Airports,STANSTED,MANCHESTER,24,0,24,18,0,18,33.33333
08/03/2018 10:34,2017,2016,A,London Area Airports,STANSTED,NEWCASTLE,0,0,0,1790,1790,0,-100
08/03/2018 10:34,2017,2016,A,London Area Airports,STANSTED,NEWQUAY,21350,21350,0,21364,21364,0,-0.06553
08/03/2018 10:34,2017,2016,A,London Area Airports,STANSTED,PRESTWICK,112,112,0,0,0,0,0
08/03/2018 10:34,2017,2016,B,Other Reporting Airports,ABERDEEN,BELFAST CITY (GEORGE BEST),42806,42806,0,43082,43082,0,-0.64064
08/03/2018 10:34,2017,2016,B,Other Reporting Airports,ABERDEEN,BELFAST INTERNATIONAL,0,0,0,207,0,207,-100
08/03/2018 10:34,2017,2016,B,Other Reporting Airports,ABERDEEN,BIRMINGHAM,131075,131020,55,129606,129535,71,1.13344
08/03/2018 10:34,2017,2016,B,Other Reporting Airports,ABERDEEN,BOURNEMOUTH,0,0,0,92,0,92,-100
08/03/2018 10:34,2017,2016,B,Other Reporting Airports,ABERDEEN,BRISTOL,16664,16664,0,21589,21589,0,-22.81254
08/03/2018 10:34,2017,2016,B,Other Reporting Airports,ABERDEEN,CARDIFF WALES,8363,8363,0,5601,5601,0,49.31262
08/03/2018 10:34,2017,2016,B,Other Reporting Airports,ABERDEEN,DONCASTER SHEFFIELD,12,12,0,0,0,0,0
08/03/2018 10:34,2017,2016,B,Other Reporting Airports,ABERDEEN,DUNDEE,0,0,0,17,0,17,-100
08/03/2018 10:34,2017,2016,B,Other Reporting Airports,ABERDEEN,DURHAM TEES VALLEY,17508,17493,15,13225,13159,66,32.38563
08/03/2018 10:34,2017,2016,B,Other Reporting Airports,ABERDEEN,EAST MIDLANDS INTERNATIONAL,0,0,0,5370,5370,0,-100
08/03/2018 10:34,2017,2016,B,Other Reporting Airports,ABERDEEN,EDINBURGH,119,119,0,30,30,0,296.66667
08/03/2018 10:34,2017,2016,B,Other Reporting Airports,ABERDEEN,GATWICK,156424,156424,0,145110,145110,0,7.79684
08/03/2018 10:34,2017,2016,B,Other Reporting Airports,ABERDEEN,GLASGOW,313,313,0,67,67,0,367.16418
08/03/2018 10:34,2017,2016,B,Other Reporting Airports,ABERDEEN,HEATHROW,622437,622437,0,593576,593576,0,4.86222
08/03/2018 10:34,2017,2016,B,Other Reporting Airports,ABERDEEN,HUMBERSIDE,23615,23615,0,18197,17963,234,29.77414
08/03/2018 10:34,2017,2016,B,Other Reporting Airports,ABERDEEN,INVERNESS,86,86,0,0,0,0,0
08/03/2018 10:34,2017,2016,B,Other Reporting Airports,ABERDEEN,JERSEY,2759,2759,0,2433,2433,0,13.3991
08/03/2018 10:34,2017,2016,B,Other Reporting Airports,ABERDEEN,KIRKWALL,54861,54753,108,35746,35437,309,53.47451
08/03/2018 10:34,2017,2016,B,Other Reporting Airports,ABERDEEN,LEEDS BRADFORD,5076,5063,13,3627,3627,0,39.95037
08/03/2018 10:34,2017,2016,B,Other Reporting Airports,ABERDEEN,LIVERPOOL (JOHN LENNON),40,40,0,0,0,0,0
08/03/2018 10:34,2017,2016,B,Other Reporting Airports,ABERDEEN,LONDON CITY,55090,55090,0,65104,65104,0,-15.38154
08/03/2018 10:34,2017,2016,B,Other Reporting Airports,ABERDEEN,LUTON,75034,75034,0,72050,72050,0,4.14157
08/03/2018 10:34,2017,2016,B,Other Reporting Airports,ABERDEEN,MANCHESTER,208112,208112,0,202391,201704,687,2.82671
08/03/2018 10:34,2017,2016,B,Other Reporting Airports,ABERDEEN,NEWCASTLE,11410,11410,0,8925,8925,0,27.84314
08/03/2018 10:34,2017,2016,B,Other Reporting Airports,ABERDEEN,NEWQUAY,1554,1554,0,1552,1552,0,0.12887
08/03/2018 10:34,2017,2016,B,Other Reporting Airports,ABERDEEN,NORWICH,45386,45386,0,42389,40672,1717,7.07023
08/03/2018 10:34,2017,2016,B,Other Reporting Airports,ABERDEEN,SCATSTA,94611,828,93783,75080,1385,73695,26.01359
08/03/2018 10:34,2017,2016,B,Other Reporting Airports,ABERDEEN,SOUTHAMPTON,14217,14217,0,6709,6590,119,111.90938
08/03/2018 10:34,2017,2016,B,Other Reporting Airports,ABERDEEN,SOUTHEND,84,84,0,74,74,0,13.51351
08/03/2018 10:34,2017,2016,B,Other Reporting Airports,ABERDEEN,STANSTED,0,0,0,27,27,0,-100
08/03/2018 10:34,2017,2016,B,Other Reporting Airports,ABERDEEN,STORNOWAY,4806,4806,0,3593,3561,32,33.76009
08/03/2018 10:34,2017,2016,B,Other Reporting Airports,ABERDEEN,SUMBURGH,155459,117200,38259,107401,95486,11915,44.74632
08/03/2018 10:34,2017,2016,B,Other Reporting Airports,ABERDEEN,WICK JOHN O GROATS,6883,6883,0,5703,5543,160,20.69086
08/03/2018 10:34,2017,2016,B,Other Reporting Airports,ALDERNEY,GUERNSEY,30870,30870,0,34355,34355,0,-10.14408
08/03/2018 10:34,2017,2016,B,Other Reporting Airports,ALDERNEY,JERSEY,198,198,0,0,0,0,0
08/03/2018 10:34,2017,2016,B,Other Reporting Airports,ALDERNEY,SOUTHAMPTON,23692,23692,0,23240,23240,0,1.94492
08/03/2018 10:34,2017,2016,B,Other Reporting Airports,BARRA,BENBECULA,12,12,0,12,12,0,0
08/03/2018 10:34,2017,2016,B,Other Reporting Airports,BARRA,GLASGOW,14890,14890,0,12793,12793,0,16.39178
08/03/2018 10:34,2017,2016,B,Other Reporting Airports,BARRA,TIREE,11,11,0,3,3,0,266.66667
08/03/2018 10:34,2017,2016,B,Other Reporting Airports,BELFAST CITY (GEORGE BEST),ABERDEEN,42261,42261,0,42477,42477,0,-0.50851
08/03/2018 10:34,2017,2016,B,Other Reporting Airports,BELFAST CITY (GEORGE BEST),BELFAST INTERNATIONAL,152,152,0,0,0,0,0
08/03/2018 10:34,2017,2016,B,Other Reporting Airports,BELFAST CITY (GEORGE BEST),BIRMINGHAM,269110,268715,395,256598,256598,0,4.87611
08/03/2018 10:34,2017,2016,B,Other Reporting Airports,BELFAST CITY (GEORGE BEST),CARDIFF WALES,50909,50909,0,43676,43676,0,16.56058
08/03/2018 10:34,2017,2016,B,Other Reporting Airports,BELFAST CITY (GEORGE BEST),EAST MIDLANDS INTERNATIONAL,148988,148988,0,144312,144312,0,3.2402
08/03/2018 10:34,2017,2016,B,Other Reporting Airports,BELFAST CITY (GEORGE BEST),EDINBURGH,172135,171973,162,165550,165550,0,3.97765
08/03/2018 10:34,2017,2016,B,Other Reporting Airports,BELFAST CITY (GEORGE BEST),EXETER,36249,36249,0,32531,32531,0,11.4291
08/03/2018 10:34,2017,2016,B,Other Reporting Airports,BELFAST CITY (GEORGE BEST),GATWICK,0,0,0,39626,39626,0,-100
08/03/2018 10:34,2017,2016,B,Other Reporting Airports,BELFAST CITY (GEORGE BEST),GLASGOW,163559,163371,188,169839,169793,46,-3.69762
08/03/2018 10:34,2017,2016,B,Other Reporting Airports,BELFAST CITY (GEORGE BEST),GLOUCESTERSHIRE,0,0,0,8,8,0,-100
08/03/2018 10:34,2017,2016,B,Other Reporting Airports,BELFAST CITY (GEORGE BEST),HEATHROW,686703,686085,618,689428,689067,361,-0.39526
08/03/2018 10:34,2017,2016,B,Other Reporting Airports,BELFAST CITY (GEORGE BEST),INVERNESS,33097,33019,78,30286,30286,0,9.28152
08/03/2018 10:34,2017,2016,B,Other Reporting Airports,BELFAST CITY (GEORGE BEST),ISLE OF MAN,10864,10864,0,23424,23424,0,-53.62022
08/03/2018 10:34,2017,2016,B,Other Reporting Airports,BELFAST CITY (GEORGE BEST),LEEDS BRADFORD,166872,166816,56,159107,159107,0,4.88036
08/03/2018 10:34,2017,2016,B,Other Reporting Airports,BELFAST CITY (GEORGE BEST),LIVERPOOL (JOHN LENNON),35170,35170,0,97866,97866,0,-64.06311
08/03/2018 10:34,2017,2016,B,Other Reporting Airports,BELFAST CITY (GEORGE BEST),LONDON CITY,121661,121661,0,112066,112066,0,8.56192
08/03/2018 10:34,2017,2016,B,Other Reporting Airports,BELFAST CITY (GEORGE BEST),LUTON,104,0,104,0,0,0,0
08/03/2018 10:34,2017,2016,B,Other Reporting Airports,BELFAST CITY (GEORGE BEST),MANCHESTER,287251,287251,0,266431,266316,115,7.81441
08/03/2018 10:34,2017,2016,B,Other Reporting Airports,BELFAST CITY (GEORGE BEST),NEWCASTLE,3633,3633,0,9911,9911,0,-63.34376
08/03/2018 10:34,2017,2016,B,Other Reporting Airports,BELFAST CITY (GEORGE BEST),NEWQUAY,3534,3534,0,1679,1679,0,110.48243
08/03/2018 10:34,2017,2016,B,Other Reporting Airports,BELFAST CITY (GEORGE BEST),PRESTWICK,75,75,0,0,0,0,0
08/03/2018 10:34,2017,2016,B,Other Reporting Airports,BELFAST CITY (GEORGE BEST),SOUTHAMPTON,118840,118840,0,117277,117277,0,1.33274
08/03/2018 10:34,2017,2016,B,Other Reporting Airports,BELFAST CITY (GEORGE BEST),SOUTHEND,61,61,0,0,0,0,0
08/03/2018 10:34,2017,2016,B,Other Reporting Airports,BELFAST INTERNATIONAL,BELFAST CITY (GEORGE BEST),127,0,127,72,11,61,76.38889
08/03/2018 10:34,2017,2016,B,Other Reporting Airports,BELFAST INTERNATIONAL,BIRMINGHAM,224393,224393,0,227526,227526,0,-1.37699
08/03/2018 10:34,2017,2016,B,Other Reporting Airports,BELFAST INTERNATIONAL,BRISTOL,261739,261739,0,249481,249481,0,4.9134
08/03/2018 10:34,2017,2016,B,Other Reporting Airports,BELFAST INTERNATIONAL,CARDIFF WALES,302,0,302,171,0,171,76.60819
08/03/2018 10:34,2017,2016,B,Other Reporting Airports,BELFAST INTERNATIONAL,DONCASTER SHEFFIELD,133,0,133,0,0,0,0
08/03/2018 10:34,2017,2016,B,Other Reporting Airports,BELFAST INTERNATIONAL,EAST MIDLANDS INTERNATIONAL,263,0,263,0,0,0,0
08/03/2018 10:34,2017,2016,B,Other Reporting Airports,BELFAST INTERNATIONAL,EDINBURGH,284833,284833,0,274292,274292,0,3.84298
08/03/2018 10:34,2017,2016,B,Other Reporting Airports,BELFAST INTERNATIONAL,GATWICK,982790,982622,168,862688,862688,0,13.92184
08/03/2018 10:34,2017,2016,B,Other Reporting Airports,BELFAST INTERNATIONAL,GLASGOW,261020,260749,271,282375,282291,84,-7.56264
08/03/2018 10:34,2017,2016,B,Other Reporting Airports,BELFAST INTERNATIONAL,HEATHROW,244,0,244,0,0,0,0
08/03/2018 10:34,2017,2016,B,Other Reporting Airports,BELFAST INTERNATIONAL,JERSEY,20793,20793,0,19930,19930,0,4.33016
08/03/2018 10:34,2017,2016,B,Other Reporting Airports,BELFAST INTERNATIONAL,LEEDS BRADFORD,75,0,75,0,0,0,0
08/03/2018 10:34,2017,2016,B,Other Reporting Airports,BELFAST INTERNATIONAL,LIVERPOOL (JOHN LENNON),490613,490576,37,465543,465543,0,5.38511
08/03/2018 10:34,2017,2016,B,Other Reporting Airports,BELFAST INTERNATIONAL,LONDON CITY,0,0,0,43,0,43,-100
08/03/2018 10:34,2017,2016,B,Other Reporting Airports,BELFAST INTERNATIONAL,LUTON,340034,340034,0,312064,311899,165,8.96291
08/03/2018 10:34,2017,2016,B,Other Reporting Airports,BELFAST INTERNATIONAL,MANCHESTER,265670,265615,55,253217,253171,46,4.91792
08/03/2018 10:34,2017,2016,B,Other Reporting Airports,BELFAST INTERNATIONAL,NEWCASTLE,259775,259775,0,250418,250418,0,3.73655
08/03/2018 10:34,2017,2016,B,Other Reporting Airports,BELFAST INTERNATIONAL,PERTH (UK),0,0,0,3,0,3,-100
08/03/2018 10:34,2017,2016,B,Other Reporting Airports,BELFAST INTERNATIONAL,STANSTED,376429,376270,159,364910,364770,140,3.15667
08/03/2018 10:34,2017,2016,B,Other Reporting Airports,BENBECULA,BARRA,11,11,0,12,12,0,-8.33333
08/03/2018 10:34,2017,2016,B,Other Reporting Airports,BENBECULA,EDINBURGH,20,20,0,22,22,0,-9.09091
08/03/2018 10:34,2017,2016,B,Other Reporting Airports,BENBECULA,GLASGOW,24143,24143,0,24199,24199,0,-0.23141
08/03/2018 10:34,2017,2016,B,Other Reporting Airports,BENBECULA,INVERNESS,36,36,0,3,3,0,1100
08/03/2018 10:34,2017,2016,B,Other Reporting Airports,BENBECULA,STORNOWAY,9048,9048,0,8203,8203,0,10.30111
08/03/2018 10:34,2017,2016,B,Other Reporting Airports,BIRMINGHAM,ABERDEEN,130399,130399,0,128700,128700,0,1.32012
08/03/2018 10:34,2017,2016,B,Other Reporting Airports,BIRMINGHAM,BELFAST CITY (GEORGE BEST),269018,269018,0,256228,256228,0,4.99165
08/03/2018 10:34,2017,2016,B,Other Reporting Airports,BIRMINGHAM,BELFAST INTERNATIONAL,222666,222666,0,225893,225893,0,-1.42855
08/03/2018 10:34,2017,2016,B,Other Reporting Airports,BIRMINGHAM,BOURNEMOUTH,0,0,0,65,0,65,-100
08/03/2018 10:34,2017,2016,B,Other Reporting Airports,BIRMINGHAM,BRISTOL,37,37,0,0,0,0,0
08/03/2018 10:34,2017,2016,B,Other Reporting Airports,BIRMINGHAM,DONCASTER SHEFFIELD,89,89,0,48,48,0,85.41667
08/03/2018 10:34,2017,2016,B,Other Reporting Airports,BIRMINGHAM,DURHAM TEES VALLEY,46,0,46,0,0,0,0
08/03/2018 10:34,2017,2016,B,Other Reporting Airports,BIRMINGHAM,EAST MIDLANDS INTERNATIONAL,150,150,0,0,0,0,0
08/03/2018 10:34,2017,2016,B,Other Reporting Airports,BIRMINGHAM,EDINBURGH,255142,254974,168,267279,267198,81,-4.54095
08/03/2018 10:34,2017,2016,B,Other Reporting Airports,BIRMINGHAM,EXETER,0,0,0,45,45,0,-100
08/03/2018 10:34,2017,2016,B,Other Reporting Airports,BIRMINGHAM,GATWICK,0,0,0,56,56,0,-100
08/03/2018 10:34,2017,2016,B,Other Reporting Airports,BIRMINGHAM,GLASGOW,221667,221471,196,226731,226469,262,-2.23348
08/03/2018 10:34,2017,2016,B,Other Reporting Airports,BIRMINGHAM,GUERNSEY,34851,34851,0,32746,32746,0,6.42827
08/03/2018 10:34,2017,2016,B,Other Reporting Airports,BIRMINGHAM,INVERNESS,44071,44071,0,42480,42386,94,3.74529
08/03/2018 10:34,2017,2016,B,Other Reporting Airports,BIRMINGHAM,ISLE OF MAN,44064,44064,0,38454,38357,97,14.58886
08/03/2018 10:34,2017,2016,B,Other Reporting Airports,BIRMINGHAM,JERSEY,60251,60251,0,59832,59832,0,0.70029
08/03/2018 10:34,2017,2016,B,Other Reporting Airports,BIRMINGHAM,LEEDS BRADFORD,35,35,0,39,39,0,-10.25641
08/03/2018 10:34,2017,2016,B,Other Reporting Airports,BIRMINGHAM,LIVERPOOL (JOHN LENNON),0,0,0,71,71,0,-100
08/03/2018 10:34,2017,2016,B,Other Reporting Airports,BIRMINGHAM,LONDON CITY,4,4,0,0,0,0,0
08/03/2018 10:34,2017,2016,B,Other Reporting Airports,BIRMINGHAM,MANCHESTER,351,351,0,762,762,0,-53.93701
08/03/2018 10:34,2017,2016,B,Other Reporting Airports,BIRMINGHAM,NEWCASTLE,191,29,162,3612,3495,117,-94.71207
08/03/2018 10:34,2017,2016,B,Other Reporting Airports,BIRMINGHAM,NEWQUAY,27041,27041,0,23955,23920,35,12.88249
08/03/2018 10:34,2017,2016,B,Other Reporting Airports,BIRMINGHAM,SOUTHAMPTON,179,179,0,186,141,45,-3.76344
08/03/2018 10:34,2017,2016,B,Other Reporting Airports,BIRMINGHAM,STANSTED,0,0,0,67,67,0,-100
08/03/2018 10:34,2017,2016,B,Other Reporting Airports,BLACKPOOL,CARDIFF WALES,0,0,0,3,3,0,-100
08/03/2018 10:34,2017,2016,B,Other Reporting Airports,BLACKPOOL,GLOUCESTERSHIRE,0,0,0,13,13,0,-100
08/03/2018 10:34,2017,2016,B,Other Reporting Airports,BLACKPOOL,ISLE OF MAN,1906,1906,0,15750,15750,0,-87.89841
08/03/2018 10:34,2017,2016,B,Other Reporting Airports,BOURNEMOUTH,ABERDEEN,0,0,0,127,35,92,-100
08/03/2018 10:34,2017,2016,B,Other Reporting Airports,BOURNEMOUTH,BELFAST CITY (GEORGE BEST),56,56,0,32,32,0,75
08/03/2018 10:34,2017,2016,B,Other Reporting Airports,BOURNEMOUTH,BIRMINGHAM,83,0,83,178,0,178,-53.37079
08/03/2018 10:34,2017,2016,B,Other Reporting Airports,BOURNEMOUTH,CARDIFF WALES,47,0,47,68,0,68,-30.88235
08/03/2018 10:34,2017,2016,B,Other Reporting Airports,BOURNEMOUTH,DURHAM TEES VALLEY,146,0,146,80,0,80,82.5
08/03/2018 10:34,2017,2016,B,Other Reporting Airports,BOURNEMOUTH,EAST MIDLANDS INTERNATIONAL,38,0,38,0,0,0,0
08/03/2018 10:34,2017,2016,B,Other Reporting Airports,BOURNEMOUTH,EDINBURGH,0,0,0,143,143,0,-100
08/03/2018 10:34,2017,2016,B,Other Reporting Airports,BOURNEMOUTH,GATWICK,1144,1144,0,0,0,0,0
08/03/2018 10:34,2017,2016,B,Other Reporting Airports,BOURNEMOUTH,GLASGOW,25,25,0,387,387,0,-93.54005
08/03/2018 10:34,2017,2016,B,Other Reporting Airports,BOURNEMOUTH,GUERNSEY,0,0,0,204,204,0,-100
08/03/2018 10:34,2017,2016,B,Other Reporting Airports,BOURNEMOUTH,HUMBERSIDE,96,0,96,69,0,69,39.13043
08/03/2018 10:34,2017,2016,B,Other Reporting Airports,BOURNEMOUTH,JERSEY,9,9,0,409,375,34,-97.79951
08/03/2018 10:34,2017,2016,B,Other Reporting Airports,BOURNEMOUTH,LEEDS BRADFORD,267,193,74,0,0,0,0
08/03/2018 10:34,2017,2016,B,Other Reporting Airports,BOURNEMOUTH,LIVERPOOL (JOHN LENNON),556,0,556,364,0,364,52.74725
08/03/2018 10:34,2017,2016,B,Other Reporting Airports,BOURNEMOUTH,LUTON,0,0,0,66,0,66,-100
08/03/2018 10:34,2017,2016,B,Other Reporting Airports,BOURNEMOUTH,MANCHESTER,849,42,807,4135,3254,881,-79.46796
08/03/2018 10:34,2017,2016,B,Other Reporting Airports,BOURNEMOUTH,NEWCASTLE,241,65,176,327,71,256,-26.29969
08/03/2018 10:34,2017,2016,B,Other Reporting Airports,BOURNEMOUTH,NORWICH,0,0,0,70,0,70,-100
08/03/2018 10:34,2017,2016,B,Other Reporting Airports,BOURNEMOUTH,STANSTED,5,4,1,83,0,83,-93.9759
08/03/2018 10:34,2017,2016,B,Other Reporting Airports,BRISTOL,ABERDEEN,16733,16730,3,21765,21765,0,-23.11969
08/03/2018 10:34,2017,2016,B,Other Reporting Airports,BRISTOL,BELFAST INTERNATIONAL,261249,261249,0,249490,249490,0,4.71321
08/03/2018 10:34,2017,2016,B,Other Reporting Airports,BRISTOL,BIRMINGHAM,259,259,0,177,177,0,46.32768
08/03/2018 10:34,2017,2016,B,Other Reporting Airports,BRISTOL,CARDIFF WALES,808,808,0,1188,1188,0,-31.98653
08/03/2018 10:34,2017,2016,B,Other Reporting Airports,BRISTOL,DURHAM TEES VALLEY,26,0,26,0,0,0,0
08/03/2018 10:34,2017,2016,B,Other Reporting Airports,BRISTOL,EAST MIDLANDS INTERNATIONAL,0,0,0,8,2,6,-100
08/03/2018 10:34,2017,2016,B,Other Reporting Airports,BRISTOL,EDINBURGH,393853,393808,45,381945,381945,0,3.11773
08/03/2018 10:34,2017,2016,B,Other Reporting Airports,BRISTOL,EXETER,425,425,0,0,0,0,0
08/03/2018 10:34,2017,2016,B,Other Reporting Airports,BRISTOL,FARNBOROUGH,4,4,0,0,0,0,0
08/03/2018 10:34,2017,2016,B,Other Reporting Airports,BRISTOL,GATWICK,8,8,0,12,12,0,-33.33333
08/03/2018 10:34,2017,2016,B,Other Reporting Airports,BRISTOL,GLASGOW,307010,306936,74,297295,297295,0,3.2678
08/03/2018 10:34,2017,2016,B,Other Reporting Airports,BRISTOL,GUERNSEY,24959,24959,0,26677,26677,0,-6.44
08/03/2018 10:34,2017,2016,B,Other Reporting Airports,BRISTOL,HAWARDEN,3235,45,3190,2340,14,2326,38.24786
08/03/2018 10:34,2017,2016,B,Other Reporting Airports,BRISTOL,HEATHROW,3,3,0,0,0,0,0
08/03/2018 10:34,2017,2016,B,Other Reporting Airports,BRISTOL,HUMBERSIDE,87,0,87,0,0,0,0
08/03/2018 10:34,2017,2016,B,Other Reporting Airports,BRISTOL,INVERNESS,96659,96659,0,87714,87714,0,10.19792
08/03/2018 10:34,2017,2016,B,Other Reporting Airports,BRISTOL,ISLE OF MAN,26758,26758,0,24663,24663,0,8.49451
08/03/2018 10:34,2017,2016,B,Other Reporting Airports,BRISTOL,JERSEY,26579,26579,0,30380,30380,0,-12.51152
08/03/2018 10:34,2017,2016,B,Other Reporting Airports,BRISTOL,LEEDS BRADFORD,95,0,95,0,0,0,0
08/03/2018 10:34,2017,2016,B,Other Reporting Airports,BRISTOL,LIVERPOOL (JOHN LENNON),219,219,0,305,305,0,-28.19672
08/03/2018 10:34,2017,2016,B,Other Reporting Airports,BRISTOL,LONDON CITY,53,35,18,0,0,0,0
08/03/2018 10:34,2017,2016,B,Other Reporting Airports,BRISTOL,LUTON,4,4,0,0,0,0,0
08/03/2018 10:34,2017,2016,B,Other Reporting Airports,BRISTOL,MANCHESTER,811,612,199,346,340,6,134.39306
08/03/2018 10:34,2017,2016,B,Other Reporting Airports,BRISTOL,NEWCASTLE,169962,169634,328,164595,164515,80,3.26073
08/03/2018 10:34,2017,2016,B,Other Reporting Airports,BRISTOL,NEWQUAY,2,2,0,0,0,0,0
08/03/2018 10:34,2017,2016,B,Other Reporting Airports,BRISTOL,NORWICH,121,23,98,218,190,28,-44.49541
08/03/2018 10:34,2017,2016,B,Other Reporting Airports,BRISTOL,SOUTHAMPTON,0,0,0,29,0,29,-100
08/03/2018 10:34,2017,2016,B,Other Reporting Airports,BRISTOL,SOUTHEND,4,4,0,4,4,0,0
08/03/2018 10:34,2017,2016,B,Other Reporting Airports,BRISTOL,STANSTED,66,0,66,19,0,19,247.36842
08/03/2018 10:34,2017,2016,B,Other Reporting Airports,CAMPBELTOWN,FARNBOROUGH,4,4,0,0,0,0,0
08/03/2018 10:34,2017,2016,B,Other Reporting Airports,CAMPBELTOWN,GLASGOW,8620,8620,0,8406,8406,0,2.5458
08/03/2018 10:34,2017,2016,B,Other Reporting Airports,CAMPBELTOWN,ISLAY,15,15,0,37,37,0,-59.45946
08/03/2018 10:34,2017,2016,B,Other Reporting Airports,CAMPBELTOWN,TIREE,87,87,0,29,29,0,200
08/03/2018 10:34,2017,2016,B,Other Reporting Airports,CARDIFF WALES,ABERDEEN,679,679,0,705,705,0,-3.68794
08/03/2018 10:34,2017,2016,B,Other Reporting Airports,CARDIFF WALES,ANGLESEY (VALLEY),13045,13045,0,9187,9187,0,41.99412
08/03/2018 10:34,2017,2016,B,Other Reporting Airports,CARDIFF WALES,BELFAST CITY (GEORGE BEST),51303,51303,0,44154,44154,0,16.19106
08/03/2018 10:34,2017,2016,B,Other Reporting Airports,CARDIFF WALES,BELFAST INTERNATIONAL,627,295,332,790,486,304,-20.63291
08/03/2018 10:34,2017,2016,B,Other Reporting Airports,CARDIFF WALES,BLACKPOOL,81,0,81,0,0,0,0
08/03/2018 10:34,2017,2016,B,Other Reporting Airports,CARDIFF WALES,BOURNEMOUTH,127,0,127,68,0,68,86.76471
08/03/2018 10:34,2017,2016,B,Other Reporting Airports,CARDIFF WALES,DONCASTER SHEFFIELD,34,34,0,137,19,118,-75.18248
08/03/2018 10:34,2017,2016,B,Other Reporting Airports,CARDIFF WALES,DURHAM TEES VALLEY,163,0,163,38,0,38,328.94737
08/03/2018 10:34,2017,2016,B,Other Reporting Airports,CARDIFF WALES,EAST MIDLANDS INTERNATIONAL,76,0,76,166,0,166,-54.21687
08/03/2018 10:34,2017,2016,B,Other Reporting Airports,CARDIFF WALES,EDINBURGH,99369,98597,772,94288,94232,56,5.38881
08/03/2018 10:34,2017,2016,B,Other Reporting Airports,CARDIFF WALES,FARNBOROUGH,0,0,0,63,0,63,-100
08/03/2018 10:34,2017,2016,B,Other Reporting Airports,CARDIFF WALES,GATWICK,86,0,86,138,0,138,-37.68116
08/03/2018 10:34,2017,2016,B,Other Reporting Airports,CARDIFF WALES,GLASGOW,28919,28787,132,37714,37682,32,-23.32025
08/03/2018 10:34,2017,2016,B,Other Reporting Airports,CARDIFF WALES,GLOUCESTERSHIRE,0,0,0,12,12,0,-100
08/03/2018 10:34,2017,2016,B,Other Reporting Airports,CARDIFF WALES,GUERNSEY,3264,3264,0,0,0,0,0
08/03/2018 10:34,2017,2016,B,Other Reporting Airports,CARDIFF WALES,HAWARDEN,0,0,0,22,22,0,-100
08/03/2018 10:34,2017,2016,B,Other Reporting Airports,CARDIFF WALES,HUMBERSIDE,233,0,233,78,0,78,198.71795
08/03/2018 10:34,2017,2016,B,Other Reporting Airports,CARDIFF WALES,INVERNESS,0,0,0,174,120,54,-100
08/03/2018 10:34,2017,2016,B,Other Reporting Airports,CARDIFF WALES,ISLE OF MAN,0,0,0,7,7,0,-100
08/03/2018 10:34,2017,2016,B,Other Reporting Airports,CARDIFF WALES,JERSEY,17134,17134,0,16630,16630,0,3.03067
08/03/2018 10:34,2017,2016,B,Other Reporting Airports,CARDIFF WALES,LEEDS BRADFORD,96,0,96,66,0,66,45.45455
08/03/2018 10:34,2017,2016,B,Other Reporting Airports,CARDIFF WALES,LIVERPOOL (JOHN LENNON),195,0,195,319,0,319,-38.87147
08/03/2018 10:34,2017,2016,B,Other Reporting Airports,CARDIFF WALES,LONDON CITY,21500,21464,36,12475,12434,41,72.34469
08/03/2018 10:34,2017,2016,B,Other Reporting Airports,CARDIFF WALES,LUTON,259,0,259,223,0,223,16.1435
08/03/2018 10:34,2017,2016,B,Other Reporting Airports,CARDIFF WALES,MANCHESTER,733,0,733,480,30,450,52.70833
08/03/2018 10:34,2017,2016,B,Other Reporting Airports,CARDIFF WALES,NEWCASTLE,13855,13541,314,13664,13463,201,1.39783
08/03/2018 10:34,2017,2016,B,Other Reporting Airports,CARDIFF WALES,NORWICH,83,0,83,138,0,138,-39.85507
08/03/2018 10:34,2017,2016,B,Other Reporting Airports,CARDIFF WALES,PRESTWICK,143,143,0,0,0,0,0
08/03/2018 10:34,2017,2016,B,Other Reporting Airports,CARDIFF WALES,SOUTHAMPTON,76,0,76,71,0,71,7.04225
08/03/2018 10:34,2017,2016,B,Other Reporting Airports,CARDIFF WALES,STANSTED,121,0,121,68,0,68,77.94118
08/03/2018 10:34,2017,2016,B,Other Reporting Airports,CITY OF DERRY (EGLINTON),DUNDEE,16,0,16,0,0,0,0
08/03/2018 10:34,2017,2016,B,Other Reporting Airports,CITY OF DERRY (EGLINTON),FARNBOROUGH,1,0,1,0,0,0,0
08/03/2018 10:34,2017,2016,B,Other Reporting Airports,CITY OF DERRY (EGLINTON),GLASGOW,84968,84626,342,80671,80671,0,5.32657
08/03/2018 10:34,2017,2016,B,Other Reporting Airports,CITY OF DERRY (EGLINTON),LIVERPOOL (JOHN LENNON),52354,52353,1,81412,81412,0,-35.69253
08/03/2018 10:34,2017,2016,B,Other Reporting Airports,CITY OF DERRY (EGLINTON),STANSTED,54559,54476,83,116737,116737,0,-53.26332
08/03/2018 10:34,2017,2016,B,Other Reporting Airports,CONINGSBY,ABERDEEN,0,0,0,20,20,0,-100
08/03/2018 10:34,2017,2016,B,Other Reporting Airports,DONCASTER SHEFFIELD,ABERDEEN,50,50,0,19,19,0,163.15789
08/03/2018 10:34,2017,2016,B,Other Reporting Airports,DONCASTER SHEFFIELD,BELFAST CITY (GEORGE BEST),265,265,0,177,177,0,49.71751
08/03/2018 10:34,2017,2016,B,Other Reporting Airports,DONCASTER SHEFFIELD,BELFAST INTERNATIONAL,135,0,135,0,0,0,0
08/03/2018 10:34,2017,2016,B,Other Reporting Airports,DONCASTER SHEFFIELD,BIRMINGHAM,33,33,0,159,159,0,-79.24528
08/03/2018 10:34,2017,2016,B,Other Reporting Airports,DONCASTER SHEFFIELD,BRISTOL,0,0,0,25,0,25,-100
08/03/2018 10:34,2017,2016,B,Other Reporting Airports,DONCASTER SHEFFIELD,CARDIFF WALES,74,74,0,149,25,124,-50.33557
08/03/2018 10:34,2017,2016,B,Other Reporting Airports,DONCASTER SHEFFIELD,EXETER,0,0,0,35,6,29,-100
08/03/2018 10:34,2017,2016,B,Other Reporting Airports,DONCASTER SHEFFIELD,FARNBOROUGH,55,0,55,0,0,0,0
08/03/2018 10:34,2017,2016,B,Other Reporting Airports,DONCASTER SHEFFIELD,GATWICK,203,0,203,309,0,309,-34.30421
08/03/2018 10:34,2017,2016,B,Other Reporting Airports,DONCASTER SHEFFIELD,GLASGOW,0,0,0,94,45,49,-100
08/03/2018 10:34,2017,2016,B,Other Reporting Airports,DONCASTER SHEFFIELD,JERSEY,33096,33096,0,33085,32825,260,0.03325
08/03/2018 10:34,2017,2016,B,Other Reporting Airports,DONCASTER SHEFFIELD,LEEDS BRADFORD,146,3,143,74,74,0,97.2973
08/03/2018 10:34,2017,2016,B,Other Reporting Airports,DONCASTER SHEFFIELD,LIVERPOOL (JOHN LENNON),184,184,0,0,0,0,0
08/03/2018 10:34,2017,2016,B,Other Reporting Airports,DONCASTER SHEFFIELD,LUTON,0,0,0,5,0,5,-100
08/03/2018 10:34,2017,2016,B,Other Reporting Airports,DONCASTER SHEFFIELD,MANCHESTER,4,4,0,2,2,0,100
08/03/2018 10:34,2017,2016,B,Other Reporting Airports,DONCASTER SHEFFIELD,NEWQUAY,7101,7101,0,11255,11255,0,-36.90804
08/03/2018 10:34,2017,2016,B,Other Reporting Airports,DONCASTER SHEFFIELD,SOUTHAMPTON,106,106,0,5,5,0,2020
08/03/2018 10:34,2017,2016,B,Other Reporting Airports,DONCASTER SHEFFIELD,SOUTHEND,2,2,0,0,0,0,0
08/03/2018 10:34,2017,2016,B,Other Reporting Airports,DONCASTER SHEFFIELD,STANSTED,42,0,42,0,0,0,0
08/03/2018 10:34,2017,2016,B,Other Reporting Airports,DUNDEE,DURHAM TEES VALLEY,0,0,0,18,0,18,-100
08/03/2018 10:34,2017,2016,B,Other Reporting Airports,DUNDEE,KIRKWALL,29,29,0,0,0,0,0
08/03/2018 10:34,2017,2016,B,Other Reporting Airports,DUNDEE,STANSTED,20699,20699,0,20773,20773,0,-0.35623
08/03/2018 10:34,2017,2016,B,Other Reporting Airports,DUNDEE,SUMBURGH,17,17,0,0,0,0,0
08/03/2018 10:34,2017,2016,B,Other Reporting Airports,DURHAM TEES VALLEY,ABERDEEN,22036,22036,0,21189,21112,77,3.99736
08/03/2018 10:34,2017,2016,B,Other Reporting Airports,DURHAM TEES VALLEY,BIGGIN HILL,34,0,34,35,0,35,-2.85714
08/03/2018 10:34,2017,2016,B,Other Reporting Airports,DURHAM TEES VALLEY,BIRMINGHAM,69,0,69,41,41,0,68.29268
08/03/2018 10:34,2017,2016,B,Other Reporting Airports,DURHAM TEES VALLEY,BOURNEMOUTH,107,72,35,74,40,34,44.59459
08/03/2018 10:34,2017,2016,B,Other Reporting Airports,DURHAM TEES VALLEY,BRISTOL,36,4,32,4,0,4,800
08/03/2018 10:34,2017,2016,B,Other Reporting Airports,DURHAM TEES VALLEY,CARDIFF WALES,83,39,44,9,9,0,822.22222
08/03/2018 10:34,2017,2016,B,Other Reporting Airports,DURHAM TEES VALLEY,EAST MIDLANDS INTERNATIONAL,104,39,65,0,0,0,0
08/03/2018 10:34,2017,2016,B,Other Reporting Airports,DURHAM TEES VALLEY,FARNBOROUGH,65,65,0,0,0,0,0
08/03/2018 10:34,2017,2016,B,Other Reporting Airports,DURHAM TEES VALLEY,GATWICK,0,0,0,79,21,58,-100
08/03/2018 10:34,2017,2016,B,Other Reporting Airports,DURHAM TEES VALLEY,HUMBERSIDE,941,941,0,108,108,0,771.2963
08/03/2018 10:34,2017,2016,B,Other Reporting Airports,DURHAM TEES VALLEY,JERSEY,2558,2558,0,2111,2111,0,21.1748
08/03/2018 10:34,2017,2016,B,Other Reporting Airports,DURHAM TEES VALLEY,LEEDS BRADFORD,17,17,0,78,78,0,-78.20513
08/03/2018 10:34,2017,2016,B,Other Reporting Airports,DURHAM TEES VALLEY,LIVERPOOL (JOHN LENNON),85,0,85,131,33,98,-35.1145
08/03/2018 10:34,2017,2016,B,Other Reporting Airports,DURHAM TEES VALLEY,LUTON,182,81,101,126,41,85,44.44444
08/03/2018 10:34,2017,2016,B,Other Reporting Airports,DURHAM TEES VALLEY,MANCHESTER,0,0,0,73,35,38,-100
08/03/2018 10:34,2017,2016,B,Other Reporting Airports,DURHAM TEES VALLEY,NEWCASTLE,41,41,0,85,85,0,-51.76471
08/03/2018 10:34,2017,2016,B,Other Reporting Airports,DURHAM TEES VALLEY,NORWICH,678,606,72,14,14,0,4742.85714
08/03/2018 10:34,2017,2016,B,Other Reporting Airports,DURHAM TEES VALLEY,SOUTHAMPTON,151,0,151,66,66,0,128.78788
08/03/2018 10:34,2017,2016,B,Other Reporting Airports,DURHAM TEES VALLEY,STANSTED,101,23,78,80,0,80,26.25
08/03/2018 10:34,2017,2016,B,Other Reporting Airports,EAST MIDLANDS INTERNATIONAL,ABERDEEN,44,44,0,6602,6602,0,-99.33354
08/03/2018 10:34,2017,2016,B,Other Reporting Airports,EAST MIDLANDS INTERNATIONAL,BELFAST CITY (GEORGE BEST),149091,149091,0,144335,144335,0,3.29511
08/03/2018 10:34,2017,2016,B,Other Reporting Airports,EAST MIDLANDS INTERNATIONAL,BELFAST INTERNATIONAL,211,0,211,0,0,0,0
08/03/2018 10:34,2017,2016,B,Other Reporting Airports,EAST MIDLANDS INTERNATIONAL,BIGGIN HILL,34,0,34,35,0,35,-2.85714
08/03/2018 10:34,2017,2016,B,Other Reporting Airports,EAST MIDLANDS INTERNATIONAL,BIRMINGHAM,1089,1085,4,652,652,0,67.02454
08/03/2018 10:34,2017,2016,B,Other Reporting Airports,EAST MIDLANDS INTERNATIONAL,BOURNEMOUTH,37,0,37,0,0,0,0
08/03/2018 10:34,2017,2016,B,Other Reporting Airports,EAST MIDLANDS INTERNATIONAL,BRISTOL,0,0,0,170,170,0,-100
08/03/2018 10:34,2017,2016,B,Other Reporting Airports,EAST MIDLANDS INTERNATIONAL,CARDIFF WALES,140,0,140,33,0,33,324.24242
08/03/2018 10:34,2017,2016,B,Other Reporting Airports,EAST MIDLANDS INTERNATIONAL,DONCASTER SHEFFIELD,0,0,0,180,0,180,-100
08/03/2018 10:34,2017,2016,B,Other Reporting Airports,EAST MIDLANDS INTERNATIONAL,DURHAM TEES VALLEY,68,0,68,0,0,0,0
08/03/2018 10:34,2017,2016,B,Other Reporting Airports,EAST MIDLANDS INTERNATIONAL,EDINBURGH,92883,92883,0,93710,93710,0,-0.88251
08/03/2018 10:34,2017,2016,B,Other Reporting Airports,EAST MIDLANDS INTERNATIONAL,FARNBOROUGH,0,0,0,34,0,34,-100
08/03/2018 10:34,2017,2016,B,Other Reporting Airports,EAST MIDLANDS INTERNATIONAL,GATWICK,66,0,66,166,0,166,-60.24096
08/03/2018 10:34,2017,2016,B,Other Reporting Airports,EAST MIDLANDS INTERNATIONAL,GLASGOW,102712,102617,95,109538,109538,0,-6.23163
08/03/2018 10:34,2017,2016,B,Other Reporting Airports,EAST MIDLANDS INTERNATIONAL,GUERNSEY,23981,23981,0,26709,26709,0,-10.21379
08/03/2018 10:34,2017,2016,B,Other Reporting Airports,EAST MIDLANDS INTERNATIONAL,HUMBERSIDE,0,0,0,94,69,25,-100
08/03/2018 10:34,2017,2016,B,Other Reporting Airports,EAST MIDLANDS INTERNATIONAL,JERSEY,35646,35646,0,26523,26523,0,34.39656
08/03/2018 10:34,2017,2016,B,Other Reporting Airports,EAST MIDLANDS INTERNATIONAL,LEEDS BRADFORD,0,0,0,2,2,0,-100
08/03/2018 10:34,2017,2016,B,Other Reporting Airports,EAST MIDLANDS INTERNATIONAL,LIVERPOOL (JOHN LENNON),256,179,77,74,0,74,245.94595
08/03/2018 10:34,2017,2016,B,Other Reporting Airports,EAST MIDLANDS INTERNATIONAL,LUTON,151,151,0,0,0,0,0
08/03/2018 10:34,2017,2016,B,Other Reporting Airports,EAST MIDLANDS INTERNATIONAL,MANCHESTER,694,319,375,341,0,341,103.51906
08/03/2018 10:34,2017,2016,B,Other Reporting Airports,EAST MIDLANDS INTERNATIONAL,NEWCASTLE,119,119,0,549,122,427,-78.32423
08/03/2018 10:34,2017,2016,B,Other Reporting Airports,EAST MIDLANDS INTERNATIONAL,NORWICH,135,0,135,44,21,23,206.81818
08/03/2018 10:34,2017,2016,B,Other Reporting Airports,EAST MIDLANDS INTERNATIONAL,PRESTWICK,0,0,0,54,0,54,-100
08/03/2018 10:34,2017,2016,B,Other Reporting Airports,EAST MIDLANDS INTERNATIONAL,SOUTHAMPTON,652,579,73,0,0,0,0
08/03/2018 10:34,2017,2016,B,Other Reporting Airports,EAST MIDLANDS INTERNATIONAL,STANSTED,496,496,0,68,0,68,629.41176
08/03/2018 10:34,2017,2016,B,Other Reporting Airports,EAST MIDLANDS INTERNATIONAL,STORNOWAY,0,0,0,173,0,173,-100
08/03/2018 10:34,2017,2016,B,Other Reporting Airports,EAST MIDLANDS INTERNATIONAL,WICK JOHN O GROATS,0,0,0,76,76,0,-100
08/03/2018 10:34,2017,2016,B,Other Reporting Airports,EDINBURGH,ABERDEEN,410,224,186,0,0,0,0
08/03/2018 10:34,2017,2016,B,Other Reporting Airports,EDINBURGH,BELFAST CITY (GEORGE BEST),172684,172507,177,166232,166232,0,3.88132
08/03/2018 10:34,2017,2016,B,Other Reporting Airports,EDINBURGH,BELFAST INTERNATIONAL,284522,284522,0,273487,273487,0,4.03493
08/03/2018 10:34,2017,2016,B,Other Reporting Airports,EDINBURGH,BENBECULA,1153,1153,0,22,22,0,5140.90909
08/03/2018 10:34,2017,2016,B,Other Reporting Airports,EDINBURGH,BIRMINGHAM,254815,254647,168,267574,267412,162,-4.7684
08/03/2018 10:34,2017,2016,B,Other Reporting Airports,EDINBURGH,BOURNEMOUTH,0,0,0,184,184,0,-100
08/03/2018 10:34,2017,2016,B,Other Reporting Airports,EDINBURGH,BRISTOL,392795,392753,42,381766,381766,0,2.88894
08/03/2018 10:34,2017,2016,B,Other Reporting Airports,EDINBURGH,CARDIFF WALES,99099,98299,800,93617,93557,60,5.85577
08/03/2018 10:34,2017,2016,B,Other Reporting Airports,EDINBURGH,DUNDEE,0,0,0,14,14,0,-100
08/03/2018 10:34,2017,2016,B,Other Reporting Airports,EDINBURGH,EAST MIDLANDS INTERNATIONAL,93149,93149,0,93620,93620,0,-0.5031
08/03/2018 10:34,2017,2016,B,Other Reporting Airports,EDINBURGH,EXETER,47587,47587,0,45213,45213,0,5.2507
08/03/2018 10:34,2017,2016,B,Other Reporting Airports,EDINBURGH,FARNBOROUGH,0,0,0,45,0,45,-100
08/03/2018 10:34,2017,2016,B,Other Reporting Airports,EDINBURGH,GATWICK,736896,736896,0,702047,701879,168,4.96391
08/03/2018 10:34,2017,2016,B,Other Reporting Airports,EDINBURGH,GLASGOW,741,741,0,0,0,0,0
08/03/2018 10:34,2017,2016,B,Other Reporting Airports,EDINBURGH,HEATHROW,1179255,1179255,0,1051567,1051567,0,12.14264
08/03/2018 10:34,2017,2016,B,Other Reporting Airports,EDINBURGH,INVERNESS,168,168,0,110,110,0,52.72727
08/03/2018 10:34,2017,2016,B,Other Reporting Airports,EDINBURGH,ISLE OF MAN,3483,3483,0,0,0,0,0
08/03/2018 10:34,2017,2016,B,Other Reporting Airports,EDINBURGH,JERSEY,5474,5474,0,7011,7011,0,-21.92269
08/03/2018 10:34,2017,2016,B,Other Reporting Airports,EDINBURGH,KIRKWALL,45919,45919,0,45846,45818,28,0.15923
08/03/2018 10:34,2017,2016,B,Other Reporting Airports,EDINBURGH,LEEDS BRADFORD,20,20,0,0,0,0,0
08/03/2018 10:34,2017,2016,B,Other Reporting Airports,EDINBURGH,LIVERPOOL (JOHN LENNON),0,0,0,15869,15869,0,-100
08/03/2018 10:34,2017,2016,B,Other Reporting Airports,EDINBURGH,LONDON CITY,485941,485864,77,528174,528174,0,-7.99604
08/03/2018 10:34,2017,2016,B,Other Reporting Airports,EDINBURGH,LUTON,308763,308711,52,272950,272901,49,13.12072
08/03/2018 10:34,2017,2016,B,Other Reporting Airports,EDINBURGH,MANCHESTER,117376,117376,0,102259,102259,0,14.78305
08/03/2018 10:34,2017,2016,B,Other Reporting Airports,EDINBURGH,NEWCASTLE,82,82,0,129,129,0,-36.43411
08/03/2018 10:34,2017,2016,B,Other Reporting Airports,EDINBURGH,NEWQUAY,5030,5030,0,2693,2693,0,86.78054
08/03/2018 10:34,2017,2016,B,Other Reporting Airports,EDINBURGH,NORWICH,28608,28608,0,25838,25838,0,10.72064
08/03/2018 10:34,2017,2016,B,Other Reporting Airports,EDINBURGH,SOUTHAMPTON,208105,207982,123,198501,198501,0,4.83826
08/03/2018 10:34,2017,2016,B,Other Reporting Airports,EDINBURGH,STANSTED,720537,720410,127,837211,837031,180,-13.93603
08/03/2018 10:34,2017,2016,B,Other Reporting Airports,EDINBURGH,STORNOWAY,16934,16934,0,20595,20595,0,-17.77616
08/03/2018 10:34,2017,2016,B,Other Reporting Airports,EDINBURGH,SUMBURGH,47131,47131,0,43530,43530,0,8.27246
08/03/2018 10:34,2017,2016,B,Other Reporting Airports,EDINBURGH,WICK JOHN O GROATS,11142,11142,0,11607,11607,0,-4.0062
08/03/2018 10:34,2017,2016,B,Other Reporting Airports,EXETER,ABERDEEN,53,53,0,0,0,0,0
08/03/2018 10:34,2017,2016,B,Other Reporting Airports,EXETER,ALDERNEY,0,0,0,11,11,0,-100
08/03/2018 10:34,2017,2016,B,Other Reporting Airports,EXETER,BELFAST CITY (GEORGE BEST),36984,36984,0,32985,32985,0,12.12369
08/03/2018 10:34,2017,2016,B,Other Reporting Airports,EXETER,BELFAST INTERNATIONAL,366,296,70,0,0,0,0
08/03/2018 10:34,2017,2016,B,Other Reporting Airports,EXETER,BIRMINGHAM,32,32,0,0,0,0,0
08/03/2018 10:34,2017,2016,B,Other Reporting Airports,EXETER,BRISTOL,274,274,0,148,0,148,85.13514
08/03/2018 10:34,2017,2016,B,Other Reporting Airports,EXETER,CARDIFF WALES,19,19,0,102,102,0,-81.37255
08/03/2018 10:34,2017,2016,B,Other Reporting Airports,EXETER,DONCASTER SHEFFIELD,0,0,0,25,0,25,-100
08/03/2018 10:34,2017,2016,B,Other Reporting Airports,EXETER,EAST MIDLANDS INTERNATIONAL,72,72,0,0,0,0,0
08/03/2018 10:34,2017,2016,B,Other Reporting Airports,EXETER,EDINBURGH,48007,48007,0,45489,45303,186,5.5354
08/03/2018 10:34,2017,2016,B,Other Reporting Airports,EXETER,GATWICK,337,337,0,120,94,26,180.83333
08/03/2018 10:34,2017,2016,B,Other Reporting Airports,EXETER,GLASGOW,38773,38773,0,32794,32746,48,18.23199
08/03/2018 10:34,2017,2016,B,Other Reporting Airports,EXETER,GUERNSEY,31316,31144,172,29645,29645,0,5.6367
08/03/2018 10:34,2017,2016,B,Other Reporting Airports,EXETER,HAWARDEN,14,10,4,0,0,0,0
08/03/2018 10:34,2017,2016,B,Other Reporting Airports,EXETER,HEATHROW,36,36,0,0,0,0,0
08/03/2018 10:34,2017,2016,B,Other Reporting Airports,EXETER,HUMBERSIDE,0,0,0,61,0,61,-100
08/03/2018 10:34,2017,2016,B,Other Reporting Airports,EXETER,INVERNESS,138,138,0,0,0,0,0
08/03/2018 10:34,2017,2016,B,Other Reporting Airports,EXETER,ISLES OF SCILLY (ST.MARYS),13759,13759,0,15063,15063,0,-8.65697
08/03/2018 10:34,2017,2016,B,Other Reporting Airports,EXETER,JERSEY,42709,42709,0,41421,41421,0,3.10953
08/03/2018 10:34,2017,2016,B,Other Reporting Airports,EXETER,LIVERPOOL (JOHN LENNON),0,0,0,325,0,325,-100
08/03/2018 10:34,2017,2016,B,Other Reporting Airports,EXETER,LONDON CITY,33953,33953,0,38150,38150,0,-11.00131
08/03/2018 10:34,2017,2016,B,Other Reporting Airports,EXETER,LUTON,110,0,110,0,0,0,0
08/03/2018 10:34,2017,2016,B,Other Reporting Airports,EXETER,MANCHESTER,130428,130428,0,113291,113242,49,15.12653
08/03/2018 10:34,2017,2016,B,Other Reporting Airports,EXETER,NEWCASTLE,42731,42468,263,39713,39631,82,7.59953
08/03/2018 10:34,2017,2016,B,Other Reporting Airports,EXETER,NEWQUAY,53,53,0,94,94,0,-43.61702
08/03/2018 10:34,2017,2016,B,Other Reporting Airports,EXETER,NORWICH,27309,27309,0,22359,22359,0,22.13874
08/03/2018 10:34,2017,2016,B,Other Reporting Airports,EXETER,SOUTHAMPTON,596,596,0,9,9,0,6522.22222
08/03/2018 10:34,2017,2016,B,Other Reporting Airports,EXETER,SOUTHEND,245,245,0,241,241,0,1.65975
08/03/2018 10:34,2017,2016,B,Other Reporting Airports,GLASGOW,ABERDEEN,148,148,0,0,0,0,0
08/03/2018 10:34,2017,2016,B,Other Reporting Airports,GLASGOW,BARRA,15206,15206,0,11798,11798,0,28.88625
08/03/2018 10:34,2017,2016,B,Other Reporting Airports,GLASGOW,BELFAST CITY (GEORGE BEST),164574,164515,59,170836,170744,92,-3.6655
08/03/2018 10:34,2017,2016,B,Other Reporting Airports,GLASGOW,BELFAST INTERNATIONAL,260528,260329,199,282305,282221,84,-7.714
08/03/2018 10:34,2017,2016,B,Other Reporting Airports,GLASGOW,BENBECULA,24697,24697,0,22371,22371,0,10.39739
08/03/2018 10:34,2017,2016,B,Other Reporting Airports,GLASGOW,BIRMINGHAM,221669,221518,151,226234,225793,441,-2.01782
08/03/2018 10:34,2017,2016,B,Other Reporting Airports,GLASGOW,BOURNEMOUTH,0,0,0,394,394,0,-100
08/03/2018 10:34,2017,2016,B,Other Reporting Airports,GLASGOW,BRISTOL,306820,306820,0,297863,297863,0,3.00709
08/03/2018 10:34,2017,2016,B,Other Reporting Airports,GLASGOW,CAMPBELTOWN,8776,8776,0,7774,7774,0,12.88912
08/03/2018 10:34,2017,2016,B,Other Reporting Airports,GLASGOW,CARDIFF WALES,28652,28451,201,37282,37252,30,-23.1479
08/03/2018 10:34,2017,2016,B,Other Reporting Airports,GLASGOW,CITY OF DERRY (EGLINTON),84726,84726,0,80699,80699,0,4.99015
08/03/2018 10:34,2017,2016,B,Other Reporting Airports,GLASGOW,DONCASTER SHEFFIELD,0,0,0,62,0,62,-100
08/03/2018 10:34,2017,2016,B,Other Reporting Airports,GLASGOW,EAST MIDLANDS INTERNATIONAL,102236,102045,191,109392,109301,91,-6.54161
08/03/2018 10:34,2017,2016,B,Other Reporting Airports,GLASGOW,EDINBURGH,410,410,0,109,109,0,276.14679
08/03/2018 10:34,2017,2016,B,Other Reporting Airports,GLASGOW,EXETER,38225,38225,0,32673,32673,0,16.99262
08/03/2018 10:34,2017,2016,B,Other Reporting Airports,GLASGOW,GATWICK,618781,618726,55,610511,610511,0,1.3546
08/03/2018 10:34,2017,2016,B,Other Reporting Airports,GLASGOW,HEATHROW,909169,909169,0,893935,893935,0,1.70415
08/03/2018 10:34,2017,2016,B,Other Reporting Airports,GLASGOW,INVERNESS,201,201,0,524,443,81,-61.64122
08/03/2018 10:34,2017,2016,B,Other Reporting Airports,GLASGOW,ISLAY,32594,32496,98,25349,25349,0,28.58101
08/03/2018 10:34,2017,2016,B,Other Reporting Airports,GLASGOW,ISLE OF MAN,5532,5489,43,8797,8797,0,-37.11493
08/03/2018 10:34,2017,2016,B,Other Reporting Airports,GLASGOW,JERSEY,56138,56138,0,40671,40644,27,38.02955
08/03/2018 10:34,2017,2016,B,Other Reporting Airports,GLASGOW,KIRKWALL,19645,19645,0,17402,17216,186,12.88932
08/03/2018 10:34,2017,2016,B,Other Reporting Airports,GLASGOW,LEEDS BRADFORD,7011,7011,0,7636,7636,0,-8.18491
08/03/2018 10:34,2017,2016,B,Other Reporting Airports,GLASGOW,LONDON CITY,231339,231339,0,235499,235499,0,-1.76646
08/03/2018 10:34,2017,2016,B,Other Reporting Airports,GLASGOW,LUTON,234250,233880,370,215496,215416,80,8.70271
08/03/2018 10:34,2017,2016,B,Other Reporting Airports,GLASGOW,MANCHESTER,51199,51189,10,43466,42984,482,17.79092
08/03/2018 10:34,2017,2016,B,Other Reporting Airports,GLASGOW,NEWCASTLE,76,0,76,0,0,0,0
08/03/2018 10:34,2017,2016,B,Other Reporting Airports,GLASGOW,NEWQUAY,3109,3109,0,2307,2307,0,34.76376
08/03/2018 10:34,2017,2016,B,Other Reporting Airports,GLASGOW,NORWICH,2443,2443,0,0,0,0,0
08/03/2018 10:34,2017,2016,B,Other Reporting Airports,GLASGOW,PRESTWICK,72,72,0,0,0,0,0
08/03/2018 10:34,2017,2016,B,Other Reporting Airports,GLASGOW,SOUTHAMPTON,197769,197708,61,179436,179436,0,10.21701
08/03/2018 10:34,2017,2016,B,Other Reporting Airports,GLASGOW,SOUTHEND,6355,6355,0,0,0,0,0
08/03/2018 10:34,2017,2016,B,Other Reporting Airports,GLASGOW,STANSTED,528393,528236,157,653042,652939,103,-19.08744
08/03/2018 10:34,2017,2016,B,Other Reporting Airports,GLASGOW,STORNOWAY,74965,74965,0,59983,59983,0,24.97708
08/03/2018 10:34,2017,2016,B,Other Reporting Airports,GLASGOW,SUMBURGH,33009,33009,0,26768,26768,0,23.31515
08/03/2018 10:34,2017,2016,B,Other Reporting Airports,GLASGOW,TIREE,11266,11266,0,9326,9326,0,20.80206
08/03/2018 10:34,2017,2016,B,Other Reporting Airports,GLOUCESTERSHIRE,ANGLESEY (VALLEY),0,0,0,25,25,0,-100
08/03/2018 10:34,2017,2016,B,Other Reporting Airports,GLOUCESTERSHIRE,ISLE OF MAN,1394,1394,0,11824,11824,0,-88.21042
08/03/2018 10:34,2017,2016,B,Other Reporting Airports,GLOUCESTERSHIRE,JERSEY,0,0,0,472,472,0,-100
08/03/2018 10:34,2017,2016,B,Other Reporting Airports,GUERNSEY,ALDERNEY,30900,30900,0,34266,34266,0,-9.82315
08/03/2018 10:34,2017,2016,B,Other Reporting Airports,GUERNSEY,BIRMINGHAM,30410,30326,84,27816,27750,66,9.32557
08/03/2018 10:34,2017,2016,B,Other Reporting Airports,GUERNSEY,BOURNEMOUTH,0,0,0,80,80,0,-100
08/03/2018 10:34,2017,2016,B,Other Reporting Airports,GUERNSEY,BRISTOL,22744,22663,81,24888,24789,99,-8.61459
08/03/2018 10:34,2017,2016,B,Other Reporting Airports,GUERNSEY,CARDIFF WALES,3253,3253,0,0,0,0,0
08/03/2018 10:34,2017,2016,B,Other Reporting Airports,GUERNSEY,DUNDEE,3,0,3,0,0,0,0
08/03/2018 10:34,2017,2016,B,Other Reporting Airports,GUERNSEY,EAST MIDLANDS INTERNATIONAL,23922,23922,0,27007,26980,27,-11.42296
08/03/2018 10:34,2017,2016,B,Other Reporting Airports,GUERNSEY,ELSTREE,0,0,0,33,33,0,-100
08/03/2018 10:34,2017,2016,B,Other Reporting Airports,GUERNSEY,EXETER,30762,30762,0,27309,27309,0,12.64418
08/03/2018 10:34,2017,2016,B,Other Reporting Airports,GUERNSEY,GATWICK,319759,319759,0,310896,310896,0,2.85079
08/03/2018 10:34,2017,2016,B,Other Reporting Airports,GUERNSEY,JERSEY,100960,100643,317,113904,113368,536,-11.36396
08/03/2018 10:34,2017,2016,B,Other Reporting Airports,GUERNSEY,LEEDS BRADFORD,10597,10597,0,7854,7854,0,34.92488
08/03/2018 10:34,2017,2016,B,Other Reporting Airports,GUERNSEY,LONDON CITY,21446,21446,0,26394,26394,0,-18.74668
08/03/2018 10:34,2017,2016,B,Other Reporting Airports,GUERNSEY,MANCHESTER,62826,62826,0,65285,65285,0,-3.76656
08/03/2018 10:34,2017,2016,B,Other Reporting Airports,GUERNSEY,NORWICH,1218,1218,0,1362,1362,0,-10.57269
08/03/2018 10:34,2017,2016,B,Other Reporting Airports,GUERNSEY,SOUTHAMPTON,117244,117244,0,135792,135791,1,-13.65913
08/03/2018 10:34,2017,2016,B,Other Reporting Airports,GUERNSEY,SOUTHEND,0,0,0,90,90,0,-100
08/03/2018 10:34,2017,2016,B,Other Reporting Airports,GUERNSEY,STANSTED,25685,25685,0,26753,26750,3,-3.99208
08/03/2018 10:34,2017,2016,B,Other Reporting Airports,HUMBERSIDE,ABERDEEN,20365,20365,0,23387,23387,0,-12.92171
08/03/2018 10:34,2017,2016,B,Other Reporting Airports,HUMBERSIDE,BIGGIN HILL,59,0,59,36,0,36,63.88889
08/03/2018 10:34,2017,2016,B,Other Reporting Airports,HUMBERSIDE,BIRMINGHAM,0,0,0,36,0,36,-100
08/03/2018 10:34,2017,2016,B,Other Reporting Airports,HUMBERSIDE,BOURNEMOUTH,91,91,0,69,35,34,31.88406
08/03/2018 10:34,2017,2016,B,Other Reporting Airports,HUMBERSIDE,BRISTOL,84,0,84,59,28,31,42.37288
08/03/2018 10:34,2017,2016,B,Other Reporting Airports,HUMBERSIDE,CARDIFF WALES,71,0,71,78,38,40,-8.97436
08/03/2018 10:34,2017,2016,B,Other Reporting Airports,HUMBERSIDE,CONINGSBY,26,26,0,0,0,0,0
08/03/2018 10:34,2017,2016,B,Other Reporting Airports,HUMBERSIDE,DURHAM TEES VALLEY,1561,1561,0,96,96,0,1526.04167
08/03/2018 10:34,2017,2016,B,Other Reporting Airports,HUMBERSIDE,EAST MIDLANDS INTERNATIONAL,0,0,0,45,45,0,-100
08/03/2018 10:34,2017,2016,B,Other Reporting Airports,HUMBERSIDE,EXETER,0,0,0,61,0,61,-100
08/03/2018 10:34,2017,2016,B,Other Reporting Airports,HUMBERSIDE,FARNBOROUGH,61,32,29,0,0,0,0
08/03/2018 10:34,2017,2016,B,Other Reporting Airports,HUMBERSIDE,GATWICK,35,35,0,40,0,40,-12.5
08/03/2018 10:34,2017,2016,B,Other Reporting Airports,HUMBERSIDE,ISLE OF MAN,52,26,26,0,0,0,0
08/03/2018 10:34,2017,2016,B,Other Reporting Airports,HUMBERSIDE,JERSEY,2236,2236,0,2158,0,2158,3.61446
08/03/2018 10:34,2017,2016,B,Other Reporting Airports,HUMBERSIDE,LEEDS BRADFORD,66,44,22,75,40,35,-12
08/03/2018 10:34,2017,2016,B,Other Reporting Airports,HUMBERSIDE,LONDON CITY,0,0,0,38,0,38,-100
08/03/2018 10:34,2017,2016,B,Other Reporting Airports,HUMBERSIDE,LOSSIEMOUTH,0,0,0,2,2,0,-100
08/03/2018 10:34,2017,2016,B,Other Reporting Airports,HUMBERSIDE,LUTON,235,0,235,103,0,103,128.15534
08/03/2018 10:34,2017,2016,B,Other Reporting Airports,HUMBERSIDE,MARHAM(KINGS LYNN),61,61,0,99,99,0,-38.38384
08/03/2018 10:34,2017,2016,B,Other Reporting Airports,HUMBERSIDE,NEWCASTLE,54,54,0,103,35,68,-47.57282
08/03/2018 10:34,2017,2016,B,Other Reporting Airports,HUMBERSIDE,NORWICH,139,38,101,56,56,0,148.21429
08/03/2018 10:34,2017,2016,B,Other Reporting Airports,HUMBERSIDE,SOUTHAMPTON,131,95,36,105,2,103,24.7619
08/03/2018 10:34,2017,2016,B,Other Reporting Airports,HUMBERSIDE,STANSTED,0,0,0,32,0,32,-100
08/03/2018 10:34,2017,2016,B,Other Reporting Airports,HUMBERSIDE,WADDINGTON,13,13,0,32,32,0,-59.375
08/03/2018 10:34,2017,2016,B,Other Reporting Airports,HUMBERSIDE,WARTON,384,361,23,98,98,0,291.83673
08/03/2018 10:34,2017,2016,B,Other Reporting Airports,INVERNESS,ABERDEEN,253,253,0,0,0,0,0
08/03/2018 10:34,2017,2016,B,Other Reporting Airports,INVERNESS,BELFAST CITY (GEORGE BEST),32984,32984,0,30495,30495,0,8.16199
08/03/2018 10:34,2017,2016,B,Other Reporting Airports,INVERNESS,BELFAST INTERNATIONAL,73,73,0,0,0,0,0
08/03/2018 10:34,2017,2016,B,Other Reporting Airports,INVERNESS,BENBECULA,69,69,0,0,0,0,0
08/03/2018 10:34,2017,2016,B,Other Reporting Airports,INVERNESS,BIRMINGHAM,44215,44215,0,42371,42371,0,4.35203
08/03/2018 10:34,2017,2016,B,Other Reporting Airports,INVERNESS,BRISTOL,96676,96676,0,87905,87905,0,9.97782
08/03/2018 10:34,2017,2016,B,Other Reporting Airports,INVERNESS,EDINBURGH,225,225,0,113,113,0,99.11504
08/03/2018 10:34,2017,2016,B,Other Reporting Airports,INVERNESS,GATWICK,263682,263682,0,239685,239685,0,10.01189
08/03/2018 10:34,2017,2016,B,Other Reporting Airports,INVERNESS,GLASGOW,68,68,0,134,134,0,-49.25373
08/03/2018 10:34,2017,2016,B,Other Reporting Airports,INVERNESS,HEATHROW,78957,78957,0,57373,57373,0,37.62048
08/03/2018 10:34,2017,2016,B,Other Reporting Airports,INVERNESS,JERSEY,2000,2000,0,1925,1925,0,3.8961
08/03/2018 10:34,2017,2016,B,Other Reporting Airports,INVERNESS,KIRKWALL,23681,23681,0,19216,19216,0,23.23585
08/03/2018 10:34,2017,2016,B,Other Reporting Airports,INVERNESS,LUTON,136498,136498,0,133761,133761,0,2.04619
08/03/2018 10:34,2017,2016,B,Other Reporting Airports,INVERNESS,MANCHESTER,65629,65629,0,68244,68244,0,-3.83184
08/03/2018 10:34,2017,2016,B,Other Reporting Airports,INVERNESS,SCATSTA,29,29,0,0,0,0,0
08/03/2018 10:34,2017,2016,B,Other Reporting Airports,INVERNESS,STORNOWAY,29223,29223,0,31198,31198,0,-6.33053
08/03/2018 10:34,2017,2016,B,Other Reporting Airports,INVERNESS,SUMBURGH,978,978,0,3546,3546,0,-72.41963
08/03/2018 10:34,2017,2016,B,Other Reporting Airports,ISLAY,CAMPBELTOWN,17,17,0,38,38,0,-55.26316
08/03/2018 10:34,2017,2016,B,Other Reporting Airports,ISLAY,COLONSAY,58,58,0,0,0,0,0
08/03/2018 10:34,2017,2016,B,Other Reporting Airports,ISLAY,GLASGOW,31860,31860,0,27281,27281,0,16.78458
08/03/2018 10:34,2017,2016,B,Other Reporting Airports,ISLAY,OBAN (NORTH CONNEL),38,38,0,0,0,0,0
08/03/2018 10:34,2017,2016,B,Other Reporting Airports,ISLAY,TIREE,38,38,0,29,29,0,31.03448
08/03/2018 10:34,2017,2016,B,Other Reporting Airports,ISLE OF MAN,BELFAST CITY (GEORGE BEST),12220,12034,186,24811,24811,0,-50.74765
08/03/2018 10:34,2017,2016,B,Other Reporting Airports,ISLE OF MAN,BIRMINGHAM,44216,44216,0,38392,38392,0,15.16983
08/03/2018 10:34,2017,2016,B,Other Reporting Airports,ISLE OF MAN,BLACKPOOL,1849,1849,0,15004,15004,0,-87.67662
08/03/2018 10:34,2017,2016,B,Other Reporting Airports,ISLE OF MAN,BRISTOL,26797,26797,0,24641,24641,0,8.74964
08/03/2018 10:34,2017,2016,B,Other Reporting Airports,ISLE OF MAN,DURHAM TEES VALLEY,7,7,0,0,0,0,0
08/03/2018 10:34,2017,2016,B,Other Reporting Airports,ISLE OF MAN,EDINBURGH,3477,3477,0,0,0,0,0
08/03/2018 10:34,2017,2016,B,Other Reporting Airports,ISLE OF MAN,FARNBOROUGH,145,0,145,0,0,0,0
08/03/2018 10:34,2017,2016,B,Other Reporting Airports,ISLE OF MAN,GATWICK,171291,171291,0,156454,156454,0,9.4833
08/03/2018 10:34,2017,2016,B,Other Reporting Airports,ISLE OF MAN,GLASGOW,5408,5365,43,9970,9970,0,-45.75727
08/03/2018 10:34,2017,2016,B,Other Reporting Airports,ISLE OF MAN,GLOUCESTERSHIRE,1420,1420,0,11746,11746,0,-87.91078
08/03/2018 10:34,2017,2016,B,Other Reporting Airports,ISLE OF MAN,HUMBERSIDE,76,0,76,0,0,0,0
08/03/2018 10:34,2017,2016,B,Other Reporting Airports,ISLE OF MAN,LEEDS BRADFORD,63,63,0,0,0,0,0
08/03/2018 10:34,2017,2016,B,Other Reporting Airports,ISLE OF MAN,LIVERPOOL (JOHN LENNON),229510,229366,144,213190,213190,0,7.65514
08/03/2018 10:34,2017,2016,B,Other Reporting Airports,ISLE OF MAN,LONDON CITY,61995,61995,0,73793,73793,0,-15.98797
08/03/2018 10:34,2017,2016,B,Other Reporting Airports,ISLE OF MAN,LUTON,16877,16877,0,0,0,0,0
08/03/2018 10:34,2017,2016,B,Other Reporting Airports,ISLE OF MAN,MANCHESTER,166142,166142,0,159194,159194,0,4.36449
08/03/2018 10:34,2017,2016,B,Other Reporting Airports,ISLE OF MAN,NEWCASTLE,3463,3463,0,4191,4191,0,-17.37056
08/03/2018 10:34,2017,2016,B,Other Reporting Airports,ISLE OF MAN,NORWICH,49,0,49,0,0,0,0
08/03/2018 10:34,2017,2016,B,Other Reporting Airports,ISLE OF MAN,PRESTWICK,54,54,0,0,0,0,0
08/03/2018 10:34,2017,2016,B,Other Reporting Airports,ISLE OF MAN,SOUTHEND,81,81,0,23,23,0,252.17391
08/03/2018 10:34,2017,2016,B,Other Reporting Airports,ISLE OF MAN,STANSTED,0,0,0,9047,9047,0,-100
08/03/2018 10:34,2017,2016,B,Other Reporting Airports,JERSEY,ABERDEEN,2755,2755,0,2416,2416,0,14.03146
08/03/2018 10:34,2017,2016,B,Other Reporting Airports,JERSEY,ALDERNEY,210,210,0,0,0,0,0
08/03/2018 10:34,2017,2016,B,Other Reporting Airports,JERSEY,BELFAST INTERNATIONAL,20294,20294,0,19706,19706,0,2.98386
08/03/2018 10:34,2017,2016,B,Other Reporting Airports,JERSEY,BIRMINGHAM,71370,71370,0,73300,73300,0,-2.63302
08/03/2018 10:34,2017,2016,B,Other Reporting Airports,JERSEY,BLACKBUSHE,2,2,0,0,0,0,0
08/03/2018 10:34,2017,2016,B,Other Reporting Airports,JERSEY,BOURNEMOUTH,148,148,0,273,273,0,-45.78755
08/03/2018 10:34,2017,2016,B,Other Reporting Airports,JERSEY,BRISTOL,26518,26518,0,30092,30092,0,-11.87691
08/03/2018 10:34,2017,2016,B,Other Reporting Airports,JERSEY,CARDIFF WALES,16838,16838,0,16244,16244,0,3.65673
08/03/2018 10:34,2017,2016,B,Other Reporting Airports,JERSEY,DONCASTER SHEFFIELD,30268,30268,0,30162,29904,258,0.35144
08/03/2018 10:34,2017,2016,B,Other Reporting Airports,JERSEY,DUNDEE,0,0,0,1244,1244,0,-100
08/03/2018 10:34,2017,2016,B,Other Reporting Airports,JERSEY,DURHAM TEES VALLEY,2561,2561,0,2171,2171,0,17.96407
08/03/2018 10:34,2017,2016,B,Other Reporting Airports,JERSEY,EAST MIDLANDS INTERNATIONAL,35400,35400,0,26449,26449,0,33.84249
08/03/2018 10:34,2017,2016,B,Other Reporting Airports,JERSEY,EDINBURGH,5405,5405,0,6928,6928,0,-21.98326
08/03/2018 10:34,2017,2016,B,Other Reporting Airports,JERSEY,EXETER,48001,48001,0,45990,45990,0,4.37269
08/03/2018 10:34,2017,2016,B,Other Reporting Airports,JERSEY,GATWICK,659086,659086,0,655150,655150,0,0.60078
08/03/2018 10:34,2017,2016,B,Other Reporting Airports,JERSEY,GLASGOW,54824,54824,0,40060,40060,0,36.85472
08/03/2018 10:34,2017,2016,B,Other Reporting Airports,JERSEY,GLOUCESTERSHIRE,0,0,0,490,490,0,-100
08/03/2018 10:34,2017,2016,B,Other Reporting Airports,JERSEY,GUERNSEY,89711,89711,0,102982,102940,42,-12.88672
08/03/2018 10:34,2017,2016,B,Other Reporting Airports,JERSEY,HUMBERSIDE,2228,2228,0,2184,2184,0,2.01465
08/03/2018 10:34,2017,2016,B,Other Reporting Airports,JERSEY,INVERNESS,1943,1943,0,1908,1908,0,1.83438
08/03/2018 10:34,2017,2016,B,Other Reporting Airports,JERSEY,LEEDS BRADFORD,13426,13426,0,12200,12200,0,10.04918
08/03/2018 10:34,2017,2016,B,Other Reporting Airports,JERSEY,LIVERPOOL (JOHN LENNON),128627,128627,0,115485,115342,143,11.37983
08/03/2018 10:34,2017,2016,B,Other Reporting Airports,JERSEY,LONDON CITY,35531,35531,0,37031,37031,0,-4.05066
08/03/2018 10:34,2017,2016,B,Other Reporting Airports,JERSEY,LUTON,46368,46368,0,35637,35637,0,30.11196
08/03/2018 10:34,2017,2016,B,Other Reporting Airports,JERSEY,MANCHESTER,44705,44705,0,51024,51024,0,-12.38437
08/03/2018 10:34,2017,2016,B,Other Reporting Airports,JERSEY,NEWCASTLE,23804,23804,0,23674,23674,0,0.54913
08/03/2018 10:34,2017,2016,B,Other Reporting Airports,JERSEY,NEWQUAY,301,301,0,0,0,0,0
08/03/2018 10:34,2017,2016,B,Other Reporting Airports,JERSEY,NORWICH,6197,6197,0,3920,3920,0,58.08673
08/03/2018 10:34,2017,2016,B,Other Reporting Airports,JERSEY,SOUTHAMPTON,167482,167482,0,161927,161927,0,3.43056
08/03/2018 10:34,2017,2016,B,Other Reporting Airports,JERSEY,SOUTHEND,25685,25685,0,23687,23687,0,8.43501
08/03/2018 10:34,2017,2016,B,Other Reporting Airports,KIRKWALL,ABERDEEN,54464,54464,0,47668,47668,0,14.25694
08/03/2018 10:34,2017,2016,B,Other Reporting Airports,KIRKWALL,DUNDEE,23,23,0,29,29,0,-20.68966
08/03/2018 10:34,2017,2016,B,Other Reporting Airports,KIRKWALL,EDAY,578,578,0,673,673,0,-14.1159
08/03/2018 10:34,2017,2016,B,Other Reporting Airports,KIRKWALL,EDINBURGH,46482,46482,0,45591,45556,35,1.95433
08/03/2018 10:34,2017,2016,B,Other Reporting Airports,KIRKWALL,FAIR ISLE,74,74,0,0,0,0,0
08/03/2018 10:34,2017,2016,B,Other Reporting Airports,KIRKWALL,GLASGOW,19410,19410,0,18240,18140,100,6.41447
08/03/2018 10:34,2017,2016,B,Other Reporting Airports,KIRKWALL,INVERNESS,11395,11395,0,9821,9821,0,16.02688
08/03/2018 10:34,2017,2016,B,Other Reporting Airports,KIRKWALL,NORTH RONALDSAY,6285,6285,0,6423,6423,0,-2.14853
08/03/2018 10:34,2017,2016,B,Other Reporting Airports,KIRKWALL,PAPA WESTRAY,5115,5115,0,4915,4915,0,4.06918
08/03/2018 10:34,2017,2016,B,Other Reporting Airports,KIRKWALL,SANDAY,3083,3083,0,3060,3060,0,0.75163
08/03/2018 10:34,2017,2016,B,Other Reporting Airports,KIRKWALL,STRONSAY,3324,3324,0,3246,3246,0,2.40296
08/03/2018 10:34,2017,2016,B,Other Reporting Airports,KIRKWALL,SUMBURGH,9885,9885,0,8953,8953,0,10.40992
08/03/2018 10:34,2017,2016,B,Other Reporting Airports,KIRKWALL,WESTRAY,3615,3615,0,3560,3560,0,1.54494
08/03/2018 10:34,2017,2016,B,Other Reporting Airports,KIRKWALL,WICK JOHN O GROATS,10,10,0,0,0,0,0
08/03/2018 10:34,2017,2016,B,Other Reporting Airports,LEEDS BRADFORD,ABERDEEN,14658,14658,0,12853,12853,0,14.04341
08/03/2018 10:34,2017,2016,B,Other Reporting Airports,LEEDS BRADFORD,BELFAST CITY (GEORGE BEST),166267,166265,2,159201,159136,65,4.43841
08/03/2018 10:34,2017,2016,B,Other Reporting Airports,LEEDS BRADFORD,BIRMINGHAM,4,0,4,0,0,0,0
08/03/2018 10:34,2017,2016,B,Other Reporting Airports,LEEDS BRADFORD,BRISTOL,66,0,66,0,0,0,0
08/03/2018 10:34,2017,2016,B,Other Reporting Airports,LEEDS BRADFORD,CARDIFF WALES,102,0,102,66,0,66,54.54545
08/03/2018 10:34,2017,2016,B,Other Reporting Airports,LEEDS BRADFORD,DONCASTER SHEFFIELD,73,73,0,75,75,0,-2.66667
08/03/2018 10:34,2017,2016,B,Other Reporting Airports,LEEDS BRADFORD,DURHAM TEES VALLEY,0,0,0,37,37,0,-100
08/03/2018 10:34,2017,2016,B,Other Reporting Airports,LEEDS BRADFORD,EAST MIDLANDS INTERNATIONAL,0,0,0,198,198,0,-100
08/03/2018 10:34,2017,2016,B,Other Reporting Airports,LEEDS BRADFORD,EXETER,120,120,0,0,0,0,0
08/03/2018 10:34,2017,2016,B,Other Reporting Airports,LEEDS BRADFORD,GATWICK,187,0,187,126,0,126,48.4127
08/03/2018 10:34,2017,2016,B,Other Reporting Airports,LEEDS BRADFORD,GLASGOW,7013,7013,0,8283,8283,0,-15.33261
08/03/2018 10:34,2017,2016,B,Other Reporting Airports,LEEDS BRADFORD,GUERNSEY,10295,10295,0,7661,7661,0,34.38193
08/03/2018 10:34,2017,2016,B,Other Reporting Airports,LEEDS BRADFORD,HEATHROW,161238,161238,0,159693,159693,0,0.96748
08/03/2018 10:34,2017,2016,B,Other Reporting Airports,LEEDS BRADFORD,HUMBERSIDE,47,47,0,53,53,0,-11.32075
08/03/2018 10:34,2017,2016,B,Other Reporting Airports,LEEDS BRADFORD,INVERNESS,54,54,0,27,27,0,100
08/03/2018 10:34,2017,2016,B,Other Reporting Airports,LEEDS BRADFORD,ISLE OF MAN,210,210,0,68,68,0,208.82353
08/03/2018 10:34,2017,2016,B,Other Reporting Airports,LEEDS BRADFORD,JERSEY,13440,13440,0,12173,12173,0,10.40828
08/03/2018 10:34,2017,2016,B,Other Reporting Airports,LEEDS BRADFORD,LIVERPOOL (JOHN LENNON),178,178,0,0,0,0,0
08/03/2018 10:34,2017,2016,B,Other Reporting Airports,LEEDS BRADFORD,LONDON CITY,2,0,2,0,0,0,0
08/03/2018 10:34,2017,2016,B,Other Reporting Airports,LEEDS BRADFORD,LUTON,0,0,0,21,0,21,-100
08/03/2018 10:34,2017,2016,B,Other Reporting Airports,LEEDS BRADFORD,MANCHESTER,425,425,0,5,5,0,8400
08/03/2018 10:34,2017,2016,B,Other Reporting Airports,LEEDS BRADFORD,NEWCASTLE,168,168,0,21,21,0,700
08/03/2018 10:34,2017,2016,B,Other Reporting Airports,LEEDS BRADFORD,NEWQUAY,27294,27294,0,3171,3171,0,760.73794
08/03/2018 10:34,2017,2016,B,Other Reporting Airports,LEEDS BRADFORD,NORTHOLT,14,0,14,9,0,9,55.55556
08/03/2018 10:34,2017,2016,B,Other Reporting Airports,LEEDS BRADFORD,NORWICH,50,37,13,1,1,0,4900
08/03/2018 10:34,2017,2016,B,Other Reporting Airports,LEEDS BRADFORD,SOUTHAMPTON,34803,34677,126,40850,40850,0,-14.80294
08/03/2018 10:34,2017,2016,B,Other Reporting Airports,LERWICK (TINGWALL),FAIR ISLE,2774,2774,0,3150,3150,0,-11.93651
08/03/2018 10:34,2017,2016,B,Other Reporting Airports,LERWICK (TINGWALL),FOULA,1298,1298,0,1235,1235,0,5.10121
08/03/2018 10:34,2017,2016,B,Other Reporting Airports,LERWICK (TINGWALL),PAPA STOUR,65,65,0,53,53,0,22.64151
08/03/2018 10:34,2017,2016,B,Other Reporting Airports,LERWICK (TINGWALL),SUMBURGH,2,2,0,0,0,0,0
08/03/2018 10:34,2017,2016,B,Other Reporting Airports,LIVERPOOL (JOHN LENNON),ABERDEEN,0,0,0,24,0,24,-100
08/03/2018 10:34,2017,2016,B,Other Reporting Airports,LIVERPOOL (JOHN LENNON),BELFAST CITY (GEORGE BEST),34925,34925,0,97258,97258,0,-64.09036
08/03/2018 10:34,2017,2016,B,Other Reporting Airports,LIVERPOOL (JOHN LENNON),BELFAST INTERNATIONAL,486782,486782,0,462519,462519,0,5.24584
08/03/2018 10:34,2017,2016,B,Other Reporting Airports,LIVERPOOL (JOHN LENNON),BIGGIN HILL,271,0,271,199,0,199,36.1809
08/03/2018 10:34,2017,2016,B,Other Reporting Airports,LIVERPOOL (JOHN LENNON),BIRMINGHAM,106,106,0,3,3,0,3433.33333
08/03/2018 10:34,2017,2016,B,Other Reporting Airports,LIVERPOOL (JOHN LENNON),BOURNEMOUTH,595,0,595,363,0,363,63.91185
08/03/2018 10:34,2017,2016,B,Other Reporting Airports,LIVERPOOL (JOHN LENNON),BRISTOL,74,34,40,0,0,0,0
08/03/2018 10:34,2017,2016,B,Other Reporting Airports,LIVERPOOL (JOHN LENNON),CARDIFF WALES,232,0,232,325,0,325,-28.61538
08/03/2018 10:34,2017,2016,B,Other Reporting Airports,LIVERPOOL (JOHN LENNON),CITY OF DERRY (EGLINTON),51446,51446,0,80248,80248,0,-35.89124
08/03/2018 10:34,2017,2016,B,Other Reporting Airports,LIVERPOOL (JOHN LENNON),DONCASTER SHEFFIELD,163,163,0,0,0,0,0
08/03/2018 10:34,2017,2016,B,Other Reporting Airports,LIVERPOOL (JOHN LENNON),DURHAM TEES VALLEY,76,0,76,115,0,115,-33.91304
08/03/2018 10:34,2017,2016,B,Other Reporting Airports,LIVERPOOL (JOHN LENNON),EAST MIDLANDS INTERNATIONAL,211,0,211,74,0,74,185.13514
08/03/2018 10:34,2017,2016,B,Other Reporting Airports,LIVERPOOL (JOHN LENNON),EDINBURGH,2,2,0,15961,15961,0,-99.98747
08/03/2018 10:34,2017,2016,B,Other Reporting Airports,LIVERPOOL (JOHN LENNON),EXETER,80,0,80,308,0,308,-74.02597
08/03/2018 10:34,2017,2016,B,Other Reporting Airports,LIVERPOOL (JOHN LENNON),FARNBOROUGH,190,0,190,97,0,97,95.87629
08/03/2018 10:34,2017,2016,B,Other Reporting Airports,LIVERPOOL (JOHN LENNON),GATWICK,255,41,214,166,0,166,53.61446
08/03/2018 10:34,2017,2016,B,Other Reporting Airports,LIVERPOOL (JOHN LENNON),GLASGOW,2,2,0,0,0,0,0
08/03/2018 10:34,2017,2016,B,Other Reporting Airports,LIVERPOOL (JOHN LENNON),GUERNSEY,0,0,0,54,54,0,-100
08/03/2018 10:34,2017,2016,B,Other Reporting Airports,LIVERPOOL (JOHN LENNON),HEATHROW,516,516,0,40,0,40,1190
08/03/2018 10:34,2017,2016,B,Other Reporting Airports,LIVERPOOL (JOHN LENNON),HUMBERSIDE,84,0,84,0,0,0,0
08/03/2018 10:34,2017,2016,B,Other Reporting Airports,LIVERPOOL (JOHN LENNON),INVERNESS,22,2,20,0,0,0,0
08/03/2018 10:34,2017,2016,B,Other Reporting Airports,LIVERPOOL (JOHN LENNON),ISLE OF MAN,228974,228974,0,212581,212581,0,7.71141
08/03/2018 10:34,2017,2016,B,Other Reporting Airports,LIVERPOOL (JOHN LENNON),JERSEY,129877,129877,0,116406,116406,0,11.57243
08/03/2018 10:34,2017,2016,B,Other Reporting Airports,LIVERPOOL (JOHN LENNON),LEEDS BRADFORD,0,0,0,21,21,0,-100
08/03/2018 10:34,2017,2016,B,Other Reporting Airports,LIVERPOOL (JOHN LENNON),LONDON CITY,38,0,38,76,0,76,-50
08/03/2018 10:34,2017,2016,B,Other Reporting Airports,LIVERPOOL (JOHN LENNON),LUTON,867,0,867,604,0,604,43.54305
08/03/2018 10:34,2017,2016,B,Other Reporting Airports,LIVERPOOL (JOHN LENNON),MANCHESTER,0,0,0,38,38,0,-100
08/03/2018 10:34,2017,2016,B,Other Reporting Airports,LIVERPOOL (JOHN LENNON),NEWCASTLE,298,0,298,406,0,406,-26.60099
08/03/2018 10:34,2017,2016,B,Other Reporting Airports,LIVERPOOL (JOHN LENNON),NEWQUAY,1543,1543,0,1851,1851,0,-16.63965
08/03/2018 10:34,2017,2016,B,Other Reporting Airports,LIVERPOOL (JOHN LENNON),NORWICH,0,0,0,253,0,253,-100
08/03/2018 10:34,2017,2016,B,Other Reporting Airports,LIVERPOOL (JOHN LENNON),SOUTHAMPTON,505,96,409,327,0,327,54.43425
08/03/2018 10:34,2017,2016,B,Other Reporting Airports,LIVERPOOL (JOHN LENNON),SOUTHEND,28,28,0,0,0,0,0
08/03/2018 10:34,2017,2016,B,Other Reporting Airports,LIVERPOOL (JOHN LENNON),STANSTED,431,0,431,536,0,536,-19.58955
08/03/2018 10:34,2017,2016,B,Other Reporting Airports,MANCHESTER,ABERDEEN,205639,205639,0,200600,199773,827,2.51196
08/03/2018 10:34,2017,2016,B,Other Reporting Airports,MANCHESTER,BELFAST CITY (GEORGE BEST),285675,285675,0,264798,264798,0,7.88412
08/03/2018 10:34,2017,2016,B,Other Reporting Airports,MANCHESTER,BELFAST INTERNATIONAL,263221,263207,14,251315,251270,45,4.73748
08/03/2018 10:34,2017,2016,B,Other Reporting Airports,MANCHESTER,BENBECULA,211,211,0,0,0,0,0
08/03/2018 10:34,2017,2016,B,Other Reporting Airports,MANCHESTER,BIGGIN HILL,0,0,0,85,0,85,-100
08/03/2018 10:34,2017,2016,B,Other Reporting Airports,MANCHESTER,BIRMINGHAM,669,669,0,167,167,0,300.5988
08/03/2018 10:34,2017,2016,B,Other Reporting Airports,MANCHESTER,BOURNEMOUTH,49,0,49,3675,3167,508,-98.66667
08/03/2018 10:34,2017,2016,B,Other Reporting Airports,MANCHESTER,BRISTOL,297,297,0,25,0,25,1088
08/03/2018 10:34,2017,2016,B,Other Reporting Airports,MANCHESTER,CAMBRIDGE,173,173,0,33,0,33,424.24242
08/03/2018 10:34,2017,2016,B,Other Reporting Airports,MANCHESTER,CARDIFF WALES,320,138,182,326,0,326,-1.84049
08/03/2018 10:34,2017,2016,B,Other Reporting Airports,MANCHESTER,DURHAM TEES VALLEY,0,0,0,122,0,122,-100
08/03/2018 10:34,2017,2016,B,Other Reporting Airports,MANCHESTER,EAST MIDLANDS INTERNATIONAL,140,0,140,0,0,0,0
08/03/2018 10:34,2017,2016,B,Other Reporting Airports,MANCHESTER,EDINBURGH,117243,117243,0,102233,102233,0,14.68215
08/03/2018 10:34,2017,2016,B,Other Reporting Airports,MANCHESTER,EXETER,128820,128735,85,112523,112523,0,14.48326
08/03/2018 10:34,2017,2016,B,Other Reporting Airports,MANCHESTER,FARNBOROUGH,0,0,0,33,0,33,-100
08/03/2018 10:34,2017,2016,B,Other Reporting Airports,MANCHESTER,GATWICK,96,0,96,259,0,259,-62.93436
08/03/2018 10:34,2017,2016,B,Other Reporting Airports,MANCHESTER,GLASGOW,48920,48724,196,43249,42913,336,13.11244
08/03/2018 10:34,2017,2016,B,Other Reporting Airports,MANCHESTER,GUERNSEY,62893,62893,0,64784,64784,0,-2.91893
08/03/2018 10:34,2017,2016,B,Other Reporting Airports,MANCHESTER,HEATHROW,660219,660190,29,689334,689260,74,-4.22364
08/03/2018 10:34,2017,2016,B,Other Reporting Airports,MANCHESTER,INVERNESS,62299,62299,0,67698,67698,0,-7.97512
08/03/2018 10:34,2017,2016,B,Other Reporting Airports,MANCHESTER,ISLE OF MAN,165279,165279,0,158014,157996,18,4.59769
08/03/2018 10:34,2017,2016,B,Other Reporting Airports,MANCHESTER,JERSEY,44572,44572,0,51070,51070,0,-12.72371
08/03/2018 10:34,2017,2016,B,Other Reporting Airports,MANCHESTER,KIRKWALL,1066,1066,0,0,0,0,0
08/03/2018 10:34,2017,2016,B,Other Reporting Airports,MANCHESTER,LEEDS BRADFORD,226,226,0,2,2,0,11200
08/03/2018 10:34,2017,2016,B,Other Reporting Airports,MANCHESTER,LIVERPOOL (JOHN LENNON),1347,1347,0,199,38,161,576.88442
08/03/2018 10:34,2017,2016,B,Other Reporting Airports,MANCHESTER,LONDON CITY,2197,2197,0,0,0,0,0
08/03/2018 10:34,2017,2016,B,Other Reporting Airports,MANCHESTER,LUTON,141,1,140,452,0,452,-68.80531
08/03/2018 10:34,2017,2016,B,Other Reporting Airports,MANCHESTER,LYDD,59,0,59,0,0,0,0
08/03/2018 10:34,2017,2016,B,Other Reporting Airports,MANCHESTER,NEWCASTLE,232,232,0,391,3,388,-40.66496
08/03/2018 10:34,2017,2016,B,Other Reporting Airports,MANCHESTER,NEWQUAY,85012,85012,0,66480,66480,0,27.87605
08/03/2018 10:34,2017,2016,B,Other Reporting Airports,MANCHESTER,NORWICH,26450,26209,241,25847,25461,386,2.33296
08/03/2018 10:34,2017,2016,B,Other Reporting Airports,MANCHESTER,PRESTWICK,39,39,0,57,0,57,-31.57895
08/03/2018 10:34,2017,2016,B,Other Reporting Airports,MANCHESTER,SOUTHAMPTON,203162,202793,369,188597,188286,311,7.72282
08/03/2018 10:34,2017,2016,B,Other Reporting Airports,MANCHESTER,SOUTHEND,7611,7534,77,112,0,112,6695.53571
08/03/2018 10:34,2017,2016,B,Other Reporting Airports,MANCHESTER,STANSTED,92,92,0,597,0,597,-84.58961
08/03/2018 10:34,2017,2016,B,Other Reporting Airports,MANCHESTER,STORNOWAY,6613,6613,0,0,0,0,0
08/03/2018 10:34,2017,2016,B,Other Reporting Airports,MANCHESTER,SUMBURGH,414,414,0,0,0,0,0
08/03/2018 10:34,2017,2016,B,Other Reporting Airports,NEWCASTLE,ABERDEEN,19165,19165,0,19415,19368,47,-1.28766
08/03/2018 10:34,2017,2016,B,Other Reporting Airports,NEWCASTLE,BELFAST CITY (GEORGE BEST),0,0,0,9821,9821,0,-100
08/03/2018 10:34,2017,2016,B,Other Reporting Airports,NEWCASTLE,BELFAST INTERNATIONAL,258275,258275,0,247903,247903,0,4.18389
08/03/2018 10:34,2017,2016,B,Other Reporting Airports,NEWCASTLE,BIGGIN HILL,0,0,0,40,0,40,-100
08/03/2018 10:34,2017,2016,B,Other Reporting Airports,NEWCASTLE,BIRMINGHAM,412,0,412,3859,3382,477,-89.32366
08/03/2018 10:34,2017,2016,B,Other Reporting Airports,NEWCASTLE,BOURNEMOUTH,190,0,190,223,66,157,-14.79821
08/03/2018 10:34,2017,2016,B,Other Reporting Airports,NEWCASTLE,BRISTOL,169020,168640,380,162748,162586,162,3.85381
08/03/2018 10:34,2017,2016,B,Other Reporting Airports,NEWCASTLE,CARDIFF WALES,13680,13301,379,12785,12573,212,7.00039
08/03/2018 10:34,2017,2016,B,Other Reporting Airports,NEWCASTLE,DURHAM TEES VALLEY,6,0,6,0,0,0,0
08/03/2018 10:34,2017,2016,B,Other Reporting Airports,NEWCASTLE,EAST MIDLANDS INTERNATIONAL,215,0,215,308,0,308,-30.19481
08/03/2018 10:34,2017,2016,B,Other Reporting Airports,NEWCASTLE,EDINBURGH,151,0,151,233,0,233,-35.19313
08/03/2018 10:34,2017,2016,B,Other Reporting Airports,NEWCASTLE,EXETER,42177,42097,80,39215,39133,82,7.55323
08/03/2018 10:34,2017,2016,B,Other Reporting Airports,NEWCASTLE,FARNBOROUGH,80,0,80,92,0,92,-13.04348
08/03/2018 10:34,2017,2016,B,Other Reporting Airports,NEWCASTLE,GATWICK,235,0,235,238,0,238,-1.2605
08/03/2018 10:34,2017,2016,B,Other Reporting Airports,NEWCASTLE,GLASGOW,100,8,92,0,0,0,0
08/03/2018 10:34,2017,2016,B,Other Reporting Airports,NEWCASTLE,HEATHROW,489140,488882,258,497386,497301,85,-1.65787
08/03/2018 10:34,2017,2016,B,Other Reporting Airports,NEWCASTLE,HUMBERSIDE,0,0,0,298,0,298,-100
08/03/2018 10:34,2017,2016,B,Other Reporting Airports,NEWCASTLE,ISLE OF MAN,5633,5633,0,2969,2969,0,89.72718
08/03/2018 10:34,2017,2016,B,Other Reporting Airports,NEWCASTLE,JERSEY,23976,23976,0,24015,24015,0,-0.1624
08/03/2018 10:34,2017,2016,B,Other Reporting Airports,NEWCASTLE,LIVERPOOL (JOHN LENNON),348,0,348,356,0,356,-2.24719
08/03/2018 10:34,2017,2016,B,Other Reporting Airports,NEWCASTLE,LUTON,413,0,413,596,0,596,-30.7047
08/03/2018 10:34,2017,2016,B,Other Reporting Airports,NEWCASTLE,MANCHESTER,442,0,442,446,0,446,-0.89686
08/03/2018 10:34,2017,2016,B,Other Reporting Airports,NEWCASTLE,NEWQUAY,2038,2038,0,1922,1922,0,6.03538
08/03/2018 10:34,2017,2016,B,Other Reporting Airports,NEWCASTLE,NORWICH,170,0,170,255,0,255,-33.33333
08/03/2018 10:34,2017,2016,B,Other Reporting Airports,NEWCASTLE,OXFORD (KIDLINGTON),80,0,80,0,0,0,0
08/03/2018 10:34,2017,2016,B,Other Reporting Airports,NEWCASTLE,SOUTHAMPTON,130256,130054,202,117767,117462,305,10.60484
08/03/2018 10:34,2017,2016,B,Other Reporting Airports,NEWCASTLE,SOUTHEND,0,0,0,88,0,88,-100
08/03/2018 10:34,2017,2016,B,Other Reporting Airports,NEWCASTLE,STANSTED,504,0,504,2537,1788,749,-80.13402
08/03/2018 10:34,2017,2016,B,Other Reporting Airports,NEWQUAY,ABERDEEN,1556,1556,0,1534,1534,0,1.43416
08/03/2018 10:34,2017,2016,B,Other Reporting Airports,NEWQUAY,BELFAST CITY (GEORGE BEST),3642,3642,0,1778,1778,0,104.8369
08/03/2018 10:34,2017,2016,B,Other Reporting Airports,NEWQUAY,BIRMINGHAM,27230,27230,0,23641,23573,68,15.18125
08/03/2018 10:34,2017,2016,B,Other Reporting Airports,NEWQUAY,DONCASTER SHEFFIELD,6696,6696,0,10003,10003,0,-33.06008
08/03/2018 10:34,2017,2016,B,Other Reporting Airports,NEWQUAY,EDAY,0,0,0,746,746,0,-100
08/03/2018 10:34,2017,2016,B,Other Reporting Airports,NEWQUAY,EDINBURGH,5057,5057,0,1921,1921,0,163.24831
08/03/2018 10:34,2017,2016,B,Other Reporting Airports,NEWQUAY,EXETER,115,115,0,204,204,0,-43.62745
08/03/2018 10:34,2017,2016,B,Other Reporting Airports,NEWQUAY,GATWICK,162574,162574,0,149376,149376,0,8.83542
08/03/2018 10:34,2017,2016,B,Other Reporting Airports,NEWQUAY,GLASGOW,3109,3109,0,2272,2272,0,36.83979
08/03/2018 10:34,2017,2016,B,Other Reporting Airports,NEWQUAY,GUERNSEY,22,22,0,78,78,0,-71.79487
08/03/2018 10:34,2017,2016,B,Other Reporting Airports,NEWQUAY,ISLES OF SCILLY (ST.MARYS),20046,20046,0,19253,19253,0,4.11884
08/03/2018 10:34,2017,2016,B,Other Reporting Airports,NEWQUAY,JERSEY,12,12,0,61,61,0,-80.32787
08/03/2018 10:34,2017,2016,B,Other Reporting Airports,NEWQUAY,LANDS END (ST JUST),54,54,0,17,17,0,217.64706
08/03/2018 10:34,2017,2016,B,Other Reporting Airports,NEWQUAY,LEEDS BRADFORD,27741,27741,0,3213,3213,0,763.39869
08/03/2018 10:34,2017,2016,B,Other Reporting Airports,NEWQUAY,LIVERPOOL (JOHN LENNON),1570,1570,0,1911,1911,0,-17.84406
08/03/2018 10:34,2017,2016,B,Other Reporting Airports,NEWQUAY,MANCHESTER,86526,86526,0,66994,66994,0,29.15485
08/03/2018 10:34,2017,2016,B,Other Reporting Airports,NEWQUAY,NEWCASTLE,2163,2163,0,1936,1936,0,11.72521
08/03/2018 10:34,2017,2016,B,Other Reporting Airports,NEWQUAY,NORWICH,0,0,0,48,48,0,-100
08/03/2018 10:34,2017,2016,B,Other Reporting Airports,NEWQUAY,STANSTED,21495,21495,0,21124,21124,0,1.7563
08/03/2018 10:34,2017,2016,B,Other Reporting Airports,NORWICH,ABERDEEN,42998,41171,1827,42600,42600,0,0.93427
08/03/2018 10:34,2017,2016,B,Other Reporting Airports,NORWICH,BIRMINGHAM,40,0,40,0,0,0,0
08/03/2018 10:34,2017,2016,B,Other Reporting Airports,NORWICH,BRISTOL,0,0,0,119,113,6,-100
08/03/2018 10:34,2017,2016,B,Other Reporting Airports,NORWICH,CARDIFF WALES,39,0,39,36,0,36,8.33333
08/03/2018 10:34,2017,2016,B,Other Reporting Airports,NORWICH,DURHAM TEES VALLEY,110,76,34,39,39,0,182.05128
08/03/2018 10:34,2017,2016,B,Other Reporting Airports,NORWICH,EDINBURGH,28350,28350,0,25569,25569,0,10.87645
08/03/2018 10:34,2017,2016,B,Other Reporting Airports,NORWICH,EXETER,26957,26824,133,22113,22113,0,21.90567
08/03/2018 10:34,2017,2016,B,Other Reporting Airports,NORWICH,FARNBOROUGH,82,32,50,0,0,0,0
08/03/2018 10:34,2017,2016,B,Other Reporting Airports,NORWICH,GAMSTON,2,2,0,0,0,0,0
08/03/2018 10:34,2017,2016,B,Other Reporting Airports,NORWICH,GATWICK,0,0,0,40,0,40,-100
08/03/2018 10:34,2017,2016,B,Other Reporting Airports,NORWICH,GLASGOW,1638,1638,0,0,0,0,0
08/03/2018 10:34,2017,2016,B,Other Reporting Airports,NORWICH,GUERNSEY,1214,1214,0,1223,1223,0,-0.7359
08/03/2018 10:34,2017,2016,B,Other Reporting Airports,NORWICH,HUMBERSIDE,79,79,0,39,39,0,102.5641
08/03/2018 10:34,2017,2016,B,Other Reporting Airports,NORWICH,JERSEY,6132,6132,0,3990,3990,0,53.68421
08/03/2018 10:34,2017,2016,B,Other Reporting Airports,NORWICH,LEEDS BRADFORD,36,36,0,32,32,0,12.5
08/03/2018 10:34,2017,2016,B,Other Reporting Airports,NORWICH,MANCHESTER,24634,24600,34,25712,25545,167,-4.19259
08/03/2018 10:34,2017,2016,B,Other Reporting Airports,NORWICH,NEWCASTLE,64,64,0,51,51,0,25.4902
08/03/2018 10:34,2017,2016,B,Other Reporting Airports,NORWICH,SOUTHAMPTON,0,0,0,87,0,87,-100
08/03/2018 10:34,2017,2016,B,Other Reporting Airports,NORWICH,WARTON,0,0,0,6,6,0,-100
08/03/2018 10:34,2017,2016,B,Other Reporting Airports,OXFORD (KIDLINGTON),NEWCASTLE,90,90,0,0,0,0,0
08/03/2018 10:34,2017,2016,B,Other Reporting Airports,OXFORD (KIDLINGTON),SOUTHAMPTON,0,0,0,48,48,0,-100
08/03/2018 10:34,2017,2016,B,Other Reporting Airports,PRESTWICK,ABERDEEN,0,0,0,49,0,49,-100
08/03/2018 10:34,2017,2016,B,Other Reporting Airports,PRESTWICK,BELFAST INTERNATIONAL,50,0,50,48,0,48,4.16667
08/03/2018 10:34,2017,2016,B,Other Reporting Airports,PRESTWICK,BIRMINGHAM,0,0,0,77,0,77,-100
08/03/2018 10:34,2017,2016,B,Other Reporting Airports,PRESTWICK,BRISTOL,293,0,293,0,0,0,0
08/03/2018 10:34,2017,2016,B,Other Reporting Airports,PRESTWICK,CARDIFF WALES,308,0,308,0,0,0,0
08/03/2018 10:34,2017,2016,B,Other Reporting Airports,PRESTWICK,EAST MIDLANDS INTERNATIONAL,66,0,66,54,0,54,22.22222
08/03/2018 10:34,2017,2016,B,Other Reporting Airports,PRESTWICK,FARNBOROUGH,56,0,56,0,0,0,0
08/03/2018 10:34,2017,2016,B,Other Reporting Airports,PRESTWICK,GATWICK,139,0,139,0,0,0,0
08/03/2018 10:34,2017,2016,B,Other Reporting Airports,PRESTWICK,KIRKWALL,16,0,16,0,0,0,0
08/03/2018 10:34,2017,2016,B,Other Reporting Airports,PRESTWICK,LONDON CITY,69,0,69,0,0,0,0
08/03/2018 10:34,2017,2016,B,Other Reporting Airports,PRESTWICK,LUTON,156,0,156,0,0,0,0
08/03/2018 10:34,2017,2016,B,Other Reporting Airports,PRESTWICK,MANCHESTER,0,0,0,93,0,93,-100
08/03/2018 10:34,2017,2016,B,Other Reporting Airports,PRESTWICK,STANSTED,494,0,494,0,0,0,0
08/03/2018 10:34,2017,2016,B,Other Reporting Airports,SCATSTA,ABERDEEN,0,0,0,22744,0,22744,-100
08/03/2018 10:34,2017,2016,B,Other Reporting Airports,SOUTHAMPTON,ABERDEEN,27800,27800,0,27743,27743,0,0.20546
08/03/2018 10:34,2017,2016,B,Other Reporting Airports,SOUTHAMPTON,ALDERNEY,24553,24553,0,19964,19964,0,22.98638
08/03/2018 10:34,2017,2016,B,Other Reporting Airports,SOUTHAMPTON,BELFAST CITY (GEORGE BEST),120078,120043,35,118526,118526,0,1.30942
08/03/2018 10:34,2017,2016,B,Other Reporting Airports,SOUTHAMPTON,BIRMINGHAM,145,108,37,146,46,100,-0.68493
08/03/2018 10:34,2017,2016,B,Other Reporting Airports,SOUTHAMPTON,BOURNEMOUTH,0,0,0,198,198,0,-100
08/03/2018 10:34,2017,2016,B,Other Reporting Airports,SOUTHAMPTON,CARDIFF WALES,90,0,90,93,22,71,-3.22581
08/03/2018 10:34,2017,2016,B,Other Reporting Airports,SOUTHAMPTON,CITY OF DERRY (EGLINTON),6,0,6,0,0,0,0
08/03/2018 10:34,2017,2016,B,Other Reporting Airports,SOUTHAMPTON,DONCASTER SHEFFIELD,87,87,0,0,0,0,0
08/03/2018 10:34,2017,2016,B,Other Reporting Airports,SOUTHAMPTON,DURHAM TEES VALLEY,131,0,131,66,0,66,98.48485
08/03/2018 10:34,2017,2016,B,Other Reporting Airports,SOUTHAMPTON,EAST MIDLANDS INTERNATIONAL,596,535,61,0,0,0,0
08/03/2018 10:34,2017,2016,B,Other Reporting Airports,SOUTHAMPTON,EDINBURGH,209098,208959,139,199283,199283,0,4.92516
08/03/2018 10:34,2017,2016,B,Other Reporting Airports,SOUTHAMPTON,EXETER,627,627,0,11,11,0,5600
08/03/2018 10:34,2017,2016,B,Other Reporting Airports,SOUTHAMPTON,GLASGOW,197100,197100,0,179447,179399,48,9.83745
08/03/2018 10:34,2017,2016,B,Other Reporting Airports,SOUTHAMPTON,GUERNSEY,117947,117947,0,137211,137211,0,-14.03969
08/03/2018 10:34,2017,2016,B,Other Reporting Airports,SOUTHAMPTON,HUMBERSIDE,86,11,75,80,0,80,7.5
08/03/2018 10:34,2017,2016,B,Other Reporting Airports,SOUTHAMPTON,JERSEY,169718,169586,132,163295,163270,25,3.93337
08/03/2018 10:34,2017,2016,B,Other Reporting Airports,SOUTHAMPTON,LEEDS BRADFORD,10758,10596,162,13796,13782,14,-22.02088
08/03/2018 10:34,2017,2016,B,Other Reporting Airports,SOUTHAMPTON,LIVERPOOL (JOHN LENNON),410,0,410,317,0,317,29.33754
08/03/2018 10:34,2017,2016,B,Other Reporting Airports,SOUTHAMPTON,LONDON CITY,124,124,0,84,84,0,47.61905
08/03/2018 10:34,2017,2016,B,Other Reporting Airports,SOUTHAMPTON,MANCHESTER,206126,205403,723,190774,190475,299,8.04722
08/03/2018 10:34,2017,2016,B,Other Reporting Airports,SOUTHAMPTON,NEWCASTLE,131144,130939,205,118388,118264,124,10.77474
08/03/2018 10:34,2017,2016,B,Other Reporting Airports,SOUTHAMPTON,NEWQUAY,0,0,0,117,117,0,-100
08/03/2018 10:34,2017,2016,B,Other Reporting Airports,SOUTHAMPTON,NORWICH,152,0,152,136,52,84,11.76471
08/03/2018 10:34,2017,2016,B,Other Reporting Airports,SOUTHAMPTON,SOUTHEND,53,0,53,0,0,0,0
08/03/2018 10:34,2017,2016,B,Other Reporting Airports,STORNOWAY,ABERDEEN,4852,4852,0,5133,5133,0,-5.47438
08/03/2018 10:34,2017,2016,B,Other Reporting Airports,STORNOWAY,BENBECULA,6886,6886,0,6131,6131,0,12.31447
08/03/2018 10:34,2017,2016,B,Other Reporting Airports,STORNOWAY,EDINBURGH,17571,17571,0,18450,18450,0,-4.76423
08/03/2018 10:34,2017,2016,B,Other Reporting Airports,STORNOWAY,GLASGOW,74626,74626,0,64281,64281,0,16.0934
08/03/2018 10:34,2017,2016,B,Other Reporting Airports,STORNOWAY,INVERNESS,28045,28045,0,30110,30110,0,-6.85819
08/03/2018 10:34,2017,2016,B,Other Reporting Airports,STORNOWAY,TIREE,0,0,0,28,28,0,-100
08/03/2018 10:34,2017,2016,B,Other Reporting Airports,STORNOWAY,WICK JOHN O GROATS,24,24,0,21,21,0,14.28571
08/03/2018 10:34,2017,2016,B,Other Reporting Airports,SUMBURGH,ABERDEEN,83390,83390,0,75045,73071,1974,11.11999
08/03/2018 10:34,2017,2016,B,Other Reporting Airports,SUMBURGH,DUNDEE,17,17,0,0,0,0,0
08/03/2018 10:34,2017,2016,B,Other Reporting Airports,SUMBURGH,EDINBURGH,47674,47674,0,42959,42959,0,10.97558
08/03/2018 10:34,2017,2016,B,Other Reporting Airports,SUMBURGH,FAIR ISLE,96,96,0,126,126,0,-23.80952
08/03/2018 10:34,2017,2016,B,Other Reporting Airports,SUMBURGH,GLASGOW,32977,32977,0,28878,28878,0,14.1942
08/03/2018 10:34,2017,2016,B,Other Reporting Airports,SUMBURGH,INVERNESS,920,920,0,3476,3476,0,-73.5328
08/03/2018 10:34,2017,2016,B,Other Reporting Airports,SUMBURGH,KIRKWALL,22662,22662,0,18486,18486,0,22.59007
08/03/2018 10:34,2017,2016,B,Other Reporting Airports,SUMBURGH,LERWICK (TINGWALL),7,7,0,2,2,0,250
08/03/2018 10:34,2017,2016,B,Other Reporting Airports,SUMBURGH,SCATSTA,0,0,0,68,0,68,-100
08/03/2018 10:34,2017,2016,B,Other Reporting Airports,TIREE,CAMPBELTOWN,63,63,0,18,18,0,250
08/03/2018 10:34,2017,2016,B,Other Reporting Airports,TIREE,COLL,155,155,0,0,0,0,0
08/03/2018 10:34,2017,2016,B,Other Reporting Airports,TIREE,GLASGOW,11031,11031,0,10082,10082,0,9.41281
08/03/2018 10:34,2017,2016,B,Other Reporting Airports,TIREE,ISLAY,54,54,0,23,23,0,134.78261
08/03/2018 10:34,2017,2016,B,Other Reporting Airports,TIREE,OBAN (NORTH CONNEL),138,138,0,0,0,0,0
08/03/2018 10:34,2017,2016,B,Other Reporting Airports,WICK JOHN O GROATS,ABERDEEN,6642,6642,0,8280,8280,0,-19.78261
08/03/2018 10:34,2017,2016,B,Other Reporting Airports,WICK JOHN O GROATS,EDINBURGH,11011,11011,0,11510,11510,0,-4.33536
08/03/2018 10:34,2017,2016,B,Other Reporting Airports,WICK JOHN O GROATS,FARNBOROUGH,0,0,0,12,0,12,-100
08/03/2018 10:34,2017,2016,B,Other Reporting Airports,WICK JOHN O GROATS,KIRKWALL,7,7,0,0,0,0,0
08/03/2018 10:34,2017,2016,B,Other Reporting Airports,WICK JOHN O GROATS,STORNOWAY,7,7,0,0,0,0,0
08/03/2018 10:34,2017,2016,B,Other Reporting Airports,WICK JOHN O GROATS,SUMBURGH,1,1,0,0,0,0,0

