rundate,this_period,last_period,grp_cd,grp_name,apt1_apt_name,apt2_apt_name,total_pax_tp,total_pax_shd_tp,total_pax_cht_tp,total_pax_lp,total_pax_shd_lp,total_pax_cht_lp,total_pax_pc
03/03/2019 11:10,2018,2017,A,London Area Airports,GATWICK,ABERDEEN,150106,150106,0,156446,156446,0,-4.05252
03/03/2019 11:10,2018,2017,A,London Area Airports,GATWICK,BELFAST INTERNATIONAL,595943,595180,763,982928,982925,3,-39.37064
03/03/2019 11:10,2018,2017,A,London Area Airports,GATWICK,BIRMINGHAM,290,155,135,203,55,148,42.85714
03/03/2019 11:10,2018,2017,A,London Area Airports,GATWICK,BOURNEMOUTH,4,0,4,177,176,1,-97.74011
03/03/2019 11:10,2018,2017,A,London Area Airports,GATWICK,BRISTOL,158,158,0,1,0,1,15700
03/03/2019 11:10,2018,2017,A,London Area Airports,GATWICK,CARDIFF WALES,162,0,162,86,0,86,88.37209
03/03/2019 11:10,2018,2017,A,London Area Airports,GATWICK,DONCASTER SHEFFIELD,44,44,0,169,0,169,-73.9645
03/03/2019 11:10,2018,2017,A,London Area Airports,GATWICK,DURHAM TEES VALLEY,116,0,116,0,0,0,0
03/03/2019 11:10,2018,2017,A,London Area Airports,GATWICK,EAST MIDLANDS INTERNATIONAL,443,201,242,106,0,106,317.92453
03/03/2019 11:10,2018,2017,A,London Area Airports,GATWICK,EDINBURGH,740904,739985,919,737285,737285,0,0.49085
03/03/2019 11:10,2018,2017,A,London Area Airports,GATWICK,EXETER,0,0,0,189,189,0,-100
03/03/2019 11:10,2018,2017,A,London Area Airports,GATWICK,FARNBOROUGH,220,0,220,0,0,0,0
03/03/2019 11:10,2018,2017,A,London Area Airports,GATWICK,GLASGOW,620383,620337,46,618673,618423,250,0.2764
03/03/2019 11:10,2018,2017,A,London Area Airports,GATWICK,GUERNSEY,330263,330263,0,319573,319573,0,3.34509
03/03/2019 11:10,2018,2017,A,London Area Airports,GATWICK,HEATHROW,628,611,17,735,670,65,-14.55782
03/03/2019 11:10,2018,2017,A,London Area Airports,GATWICK,HUMBERSIDE,4,4,0,99,0,99,-95.9596
03/03/2019 11:10,2018,2017,A,London Area Airports,GATWICK,INVERNESS,262197,262197,0,263411,263411,0,-0.46088
03/03/2019 11:10,2018,2017,A,London Area Airports,GATWICK,ISLE OF MAN,176235,176137,98,171386,171386,0,2.82929
03/03/2019 11:10,2018,2017,A,London Area Airports,GATWICK,JERSEY,670763,670763,0,664879,664877,2,0.88497
03/03/2019 11:10,2018,2017,A,London Area Airports,GATWICK,LEEDS BRADFORD,122,0,122,190,1,189,-35.78947
03/03/2019 11:10,2018,2017,A,London Area Airports,GATWICK,LIVERPOOL (JOHN LENNON),430,7,423,219,0,219,96.34703
03/03/2019 11:10,2018,2017,A,London Area Airports,GATWICK,LONDON CITY,0,0,0,39,39,0,-100
03/03/2019 11:10,2018,2017,A,London Area Airports,GATWICK,LUTON,875,875,0,521,290,231,67.94626
03/03/2019 11:10,2018,2017,A,London Area Airports,GATWICK,MANCHESTER,2882,1156,1726,1190,239,951,142.18487
03/03/2019 11:10,2018,2017,A,London Area Airports,GATWICK,NEWCASTLE,275,0,275,232,0,232,18.53448
03/03/2019 11:10,2018,2017,A,London Area Airports,GATWICK,NEWQUAY,173446,173446,0,161614,161614,0,7.32115
03/03/2019 11:10,2018,2017,A,London Area Airports,GATWICK,NORWICH,37,0,37,107,0,107,-65.42056
03/03/2019 11:10,2018,2017,A,London Area Airports,GATWICK,PRESTWICK,0,0,0,13,0,13,-100
03/03/2019 11:10,2018,2017,A,London Area Airports,GATWICK,SOUTHEND,129,0,129,1,0,1,12800
03/03/2019 11:10,2018,2017,A,London Area Airports,GATWICK,STANSTED,320,320,0,790,643,147,-59.49367
03/03/2019 11:10,2018,2017,A,London Area Airports,HEATHROW,ABERDEEN,675816,675816,0,622034,622034,0,8.64615
03/03/2019 11:10,2018,2017,A,London Area Airports,HEATHROW,BELFAST CITY (GEORGE BEST),655338,655338,0,691552,691552,0,-5.23663
03/03/2019 11:10,2018,2017,A,London Area Airports,HEATHROW,BELFAST INTERNATIONAL,118,118,0,78,78,0,51.28205
03/03/2019 11:10,2018,2017,A,London Area Airports,HEATHROW,BIRMINGHAM,0,0,0,168,168,0,-100
03/03/2019 11:10,2018,2017,A,London Area Airports,HEATHROW,EDINBURGH,1198848,1198848,0,1179758,1179758,0,1.61813
03/03/2019 11:10,2018,2017,A,London Area Airports,HEATHROW,EXETER,0,0,0,71,0,71,-100
03/03/2019 11:10,2018,2017,A,London Area Airports,HEATHROW,GATWICK,405,405,0,60,0,60,575
03/03/2019 11:10,2018,2017,A,London Area Airports,HEATHROW,GLASGOW,911191,911191,0,909117,909117,0,0.22813
03/03/2019 11:10,2018,2017,A,London Area Airports,HEATHROW,INVERNESS,97591,97591,0,79065,79065,0,23.43135
03/03/2019 11:10,2018,2017,A,London Area Airports,HEATHROW,LEEDS BRADFORD,103706,103706,0,162042,162042,0,-36.00054
03/03/2019 11:10,2018,2017,A,London Area Airports,HEATHROW,LIVERPOOL (JOHN LENNON),0,0,0,72,72,0,-100
03/03/2019 11:10,2018,2017,A,London Area Airports,HEATHROW,LONDON CITY,66,66,0,0,0,0,0
03/03/2019 11:10,2018,2017,A,London Area Airports,HEATHROW,MANCHESTER,654071,654071,0,665203,665203,0,-1.67347
03/03/2019 11:10,2018,2017,A,London Area Airports,HEATHROW,NEWCASTLE,496193,496193,0,491597,491597,0,0.93491
03/03/2019 11:10,2018,2017,A,London Area Airports,LONDON CITY,ABERDEEN,42249,42249,0,54350,54350,0,-22.26495
03/03/2019 11:10,2018,2017,A,London Area Airports,LONDON CITY,BELFAST CITY (GEORGE BEST),184881,184881,0,121019,121019,0,52.77023
03/03/2019 11:10,2018,2017,A,London Area Airports,LONDON CITY,BIRMINGHAM,70,70,0,55,55,0,27.27273
03/03/2019 11:10,2018,2017,A,London Area Airports,LONDON CITY,CARDIFF WALES,0,0,0,21273,21195,78,-100
03/03/2019 11:10,2018,2017,A,London Area Airports,LONDON CITY,EDINBURGH,496961,496961,0,484892,484892,0,2.48901
03/03/2019 11:10,2018,2017,A,London Area Airports,LONDON CITY,EXETER,38103,38103,0,33616,33616,0,13.34781
03/03/2019 11:10,2018,2017,A,London Area Airports,LONDON CITY,GLASGOW,230223,230223,0,231092,231092,0,-0.37604
03/03/2019 11:10,2018,2017,A,London Area Airports,LONDON CITY,GUERNSEY,0,0,0,21694,21694,0,-100
03/03/2019 11:10,2018,2017,A,London Area Airports,LONDON CITY,HEATHROW,0,0,0,12,12,0,-100
03/03/2019 11:10,2018,2017,A,London Area Airports,LONDON CITY,ISLE OF MAN,62036,62036,0,62061,62061,0,-0.04028
03/03/2019 11:10,2018,2017,A,London Area Airports,LONDON CITY,JERSEY,34995,34995,0,35150,35150,0,-0.44097
03/03/2019 11:10,2018,2017,A,London Area Airports,LONDON CITY,MANCHESTER,3891,3891,0,2266,2266,0,71.71227
03/03/2019 11:10,2018,2017,A,London Area Airports,LONDON CITY,NEWCASTLE,31,31,0,0,0,0,0
03/03/2019 11:10,2018,2017,A,London Area Airports,LONDON CITY,SOUTHAMPTON,0,0,0,203,203,0,-100
03/03/2019 11:10,2018,2017,A,London Area Airports,LONDON CITY,SOUTHEND,52,52,0,0,0,0,0
03/03/2019 11:10,2018,2017,A,London Area Airports,LUTON,ABERDEEN,72570,72570,0,75148,75148,0,-3.43056
03/03/2019 11:10,2018,2017,A,London Area Airports,LUTON,BELFAST CITY (GEORGE BEST),53,0,53,55,0,55,-3.63636
03/03/2019 11:10,2018,2017,A,London Area Airports,LUTON,BELFAST INTERNATIONAL,344372,344372,0,340072,340020,52,1.26444
03/03/2019 11:10,2018,2017,A,London Area Airports,LUTON,BIGGIN HILL,167,167,0,0,0,0,0
03/03/2019 11:10,2018,2017,A,London Area Airports,LUTON,BIRMINGHAM,0,0,0,525,525,0,-100
03/03/2019 11:10,2018,2017,A,London Area Airports,LUTON,BOURNEMOUTH,0,0,0,78,0,78,-100
03/03/2019 11:10,2018,2017,A,London Area Airports,LUTON,CARDIFF WALES,0,0,0,85,0,85,-100
03/03/2019 11:10,2018,2017,A,London Area Airports,LUTON,DONCASTER SHEFFIELD,179,179,0,0,0,0,0
03/03/2019 11:10,2018,2017,A,London Area Airports,LUTON,DURHAM TEES VALLEY,34,0,34,0,0,0,0
03/03/2019 11:10,2018,2017,A,London Area Airports,LUTON,EAST MIDLANDS INTERNATIONAL,0,0,0,181,181,0,-100
03/03/2019 11:10,2018,2017,A,London Area Airports,LUTON,EDINBURGH,315116,315116,0,309124,309124,0,1.93838
03/03/2019 11:10,2018,2017,A,London Area Airports,LUTON,FARNBOROUGH,0,0,0,8,0,8,-100
03/03/2019 11:10,2018,2017,A,London Area Airports,LUTON,GATWICK,329,329,0,145,145,0,126.89655
03/03/2019 11:10,2018,2017,A,London Area Airports,LUTON,GLASGOW,243728,243636,92,234768,234398,370,3.81653
03/03/2019 11:10,2018,2017,A,London Area Airports,LUTON,GUERNSEY,0,0,0,108,108,0,-100
03/03/2019 11:10,2018,2017,A,London Area Airports,LUTON,INVERNESS,147205,147030,175,136364,136282,82,7.95005
03/03/2019 11:10,2018,2017,A,London Area Airports,LUTON,ISLE OF MAN,23370,23370,0,16975,16969,6,37.67305
03/03/2019 11:10,2018,2017,A,London Area Airports,LUTON,JERSEY,49626,49626,0,46574,46574,0,6.55301
03/03/2019 11:10,2018,2017,A,London Area Airports,LUTON,LEEDS BRADFORD,0,0,0,113,113,0,-100
03/03/2019 11:10,2018,2017,A,London Area Airports,LUTON,LIVERPOOL (JOHN LENNON),0,0,0,112,0,112,-100
03/03/2019 11:10,2018,2017,A,London Area Airports,LUTON,MANCHESTER,680,442,238,372,155,217,82.7957
03/03/2019 11:10,2018,2017,A,London Area Airports,LUTON,SOUTHEND,0,0,0,134,134,0,-100
03/03/2019 11:10,2018,2017,A,London Area Airports,LUTON,STANSTED,0,0,0,777,777,0,-100
03/03/2019 11:10,2018,2017,A,London Area Airports,SOUTHEND,ABERDEEN,80,80,0,320,320,0,-75
03/03/2019 11:10,2018,2017,A,London Area Airports,SOUTHEND,BELFAST CITY (GEORGE BEST),0,0,0,506,506,0,-100
03/03/2019 11:10,2018,2017,A,London Area Airports,SOUTHEND,CARDIFF WALES,0,0,0,180,180,0,-100
03/03/2019 11:10,2018,2017,A,London Area Airports,SOUTHEND,EDINBURGH,69,69,0,671,671,0,-89.71684
03/03/2019 11:10,2018,2017,A,London Area Airports,SOUTHEND,EXETER,0,0,0,336,336,0,-100
03/03/2019 11:10,2018,2017,A,London Area Airports,SOUTHEND,GLASGOW,41979,41979,0,6360,6360,0,560.04717
03/03/2019 11:10,2018,2017,A,London Area Airports,SOUTHEND,GUERNSEY,0,0,0,18,18,0,-100
03/03/2019 11:10,2018,2017,A,London Area Airports,SOUTHEND,ISLE OF MAN,0,0,0,180,180,0,-100
03/03/2019 11:10,2018,2017,A,London Area Airports,SOUTHEND,JERSEY,30505,30505,0,25701,25701,0,18.69188
03/03/2019 11:10,2018,2017,A,London Area Airports,SOUTHEND,LIVERPOOL (JOHN LENNON),0,0,0,60,60,0,-100
03/03/2019 11:10,2018,2017,A,London Area Airports,SOUTHEND,LONDON CITY,82,82,0,0,0,0,0
03/03/2019 11:10,2018,2017,A,London Area Airports,SOUTHEND,MANCHESTER,51772,51772,0,7557,7557,0,585.08667
03/03/2019 11:10,2018,2017,A,London Area Airports,STANSTED,BELFAST INTERNATIONAL,677155,677001,154,375785,375785,0,80.19745
03/03/2019 11:10,2018,2017,A,London Area Airports,STANSTED,BIRMINGHAM,316,316,0,0,0,0,0
03/03/2019 11:10,2018,2017,A,London Area Airports,STANSTED,CITY OF DERRY (EGLINTON),47375,47375,0,54696,54696,0,-13.38489
03/03/2019 11:10,2018,2017,A,London Area Airports,STANSTED,DUNDEE,20534,20534,0,20652,20652,0,-0.57137
03/03/2019 11:10,2018,2017,A,London Area Airports,STANSTED,DURHAM TEES VALLEY,0,0,0,68,0,68,-100
03/03/2019 11:10,2018,2017,A,London Area Airports,STANSTED,EAST MIDLANDS INTERNATIONAL,235,235,0,0,0,0,0
03/03/2019 11:10,2018,2017,A,London Area Airports,STANSTED,EDINBURGH,732022,731885,137,720271,720271,0,1.63147
03/03/2019 11:10,2018,2017,A,London Area Airports,STANSTED,GATWICK,340,340,0,582,582,0,-41.58076
03/03/2019 11:10,2018,2017,A,London Area Airports,STANSTED,GLASGOW,432349,431914,435,527139,527139,0,-17.98197
03/03/2019 11:10,2018,2017,A,London Area Airports,STANSTED,GUERNSEY,27429,27429,0,25739,25739,0,6.56591
03/03/2019 11:10,2018,2017,A,London Area Airports,STANSTED,INVERNESS,92,0,92,410,150,260,-77.56098
03/03/2019 11:10,2018,2017,A,London Area Airports,STANSTED,LUTON,167,167,0,185,185,0,-9.72973
03/03/2019 11:10,2018,2017,A,London Area Airports,STANSTED,MANCHESTER,299,238,61,24,0,24,1145.83333
03/03/2019 11:10,2018,2017,A,London Area Airports,STANSTED,NEWQUAY,5535,5535,0,21350,21350,0,-74.07494
03/03/2019 11:10,2018,2017,A,London Area Airports,STANSTED,NORWICH,20,20,0,0,0,0,0
03/03/2019 11:10,2018,2017,A,London Area Airports,STANSTED,PRESTWICK,0,0,0,112,112,0,-100
03/03/2019 11:10,2018,2017,A,London Area Airports,STANSTED,TOLLERTON NOTTINGHAM,177,177,0,0,0,0,0
03/03/2019 11:10,2018,2017,B,Other Reporting Airports,ABERDEEN,BELFAST CITY (GEORGE BEST),41903,41903,0,42806,42806,0,-2.10952
03/03/2019 11:10,2018,2017,B,Other Reporting Airports,ABERDEEN,BIRMINGHAM,112560,112505,55,131075,131020,55,-14.1255
03/03/2019 11:10,2018,2017,B,Other Reporting Airports,ABERDEEN,BRISTOL,13161,13161,0,16664,16664,0,-21.02136
03/03/2019 11:10,2018,2017,B,Other Reporting Airports,ABERDEEN,CARDIFF WALES,6782,6726,56,8363,8363,0,-18.9047
03/03/2019 11:10,2018,2017,B,Other Reporting Airports,ABERDEEN,CONINGSBY,3,3,0,0,0,0,0
03/03/2019 11:10,2018,2017,B,Other Reporting Airports,ABERDEEN,DONCASTER SHEFFIELD,0,0,0,12,12,0,-100
03/03/2019 11:10,2018,2017,B,Other Reporting Airports,ABERDEEN,DURHAM TEES VALLEY,21496,21428,68,17508,17493,15,22.77816
03/03/2019 11:10,2018,2017,B,Other Reporting Airports,ABERDEEN,EDINBURGH,42,42,0,119,119,0,-64.70588
03/03/2019 11:10,2018,2017,B,Other Reporting Airports,ABERDEEN,FARNBOROUGH,22,0,22,0,0,0,0
03/03/2019 11:10,2018,2017,B,Other Reporting Airports,ABERDEEN,GATWICK,149435,149435,0,156424,156424,0,-4.46798
03/03/2019 11:10,2018,2017,B,Other Reporting Airports,ABERDEEN,GLASGOW,49,17,32,313,313,0,-84.34505
03/03/2019 11:10,2018,2017,B,Other Reporting Airports,ABERDEEN,HEATHROW,675940,675816,124,622437,622437,0,8.59573
03/03/2019 11:10,2018,2017,B,Other Reporting Airports,ABERDEEN,HUMBERSIDE,23143,23143,0,23615,23615,0,-1.99873
03/03/2019 11:10,2018,2017,B,Other Reporting Airports,ABERDEEN,INVERNESS,122,122,0,86,86,0,41.86047
03/03/2019 11:10,2018,2017,B,Other Reporting Airports,ABERDEEN,JERSEY,2529,2529,0,2759,2759,0,-8.33635
03/03/2019 11:10,2018,2017,B,Other Reporting Airports,ABERDEEN,KIRKWALL,57620,57212,408,54861,54753,108,5.02907
03/03/2019 11:10,2018,2017,B,Other Reporting Airports,ABERDEEN,LEEDS BRADFORD,2222,2222,0,5076,5063,13,-56.22537
03/03/2019 11:10,2018,2017,B,Other Reporting Airports,ABERDEEN,LIVERPOOL (JOHN LENNON),0,0,0,40,40,0,-100
03/03/2019 11:10,2018,2017,B,Other Reporting Airports,ABERDEEN,LONDON CITY,41481,41481,0,55090,55090,0,-24.70321
03/03/2019 11:10,2018,2017,B,Other Reporting Airports,ABERDEEN,LOSSIEMOUTH,3,3,0,0,0,0,0
03/03/2019 11:10,2018,2017,B,Other Reporting Airports,ABERDEEN,LUTON,72177,72177,0,75034,75034,0,-3.80761
03/03/2019 11:10,2018,2017,B,Other Reporting Airports,ABERDEEN,MANCHESTER,218630,218289,341,208112,208112,0,5.05401
03/03/2019 11:10,2018,2017,B,Other Reporting Airports,ABERDEEN,NEWCASTLE,10923,10923,0,11410,11410,0,-4.26819
03/03/2019 11:10,2018,2017,B,Other Reporting Airports,ABERDEEN,NEWQUAY,1790,1790,0,1554,1554,0,15.18662
03/03/2019 11:10,2018,2017,B,Other Reporting Airports,ABERDEEN,NORWICH,41932,41932,0,45386,45386,0,-7.61028
03/03/2019 11:10,2018,2017,B,Other Reporting Airports,ABERDEEN,SCATSTA,94066,757,93309,94611,828,93783,-0.57604
03/03/2019 11:10,2018,2017,B,Other Reporting Airports,ABERDEEN,SOUTHAMPTON,7662,7662,0,14217,14217,0,-46.10677
03/03/2019 11:10,2018,2017,B,Other Reporting Airports,ABERDEEN,SOUTHEND,105,105,0,84,84,0,25
03/03/2019 11:10,2018,2017,B,Other Reporting Airports,ABERDEEN,STORNOWAY,5961,5961,0,4806,4806,0,24.03246
03/03/2019 11:10,2018,2017,B,Other Reporting Airports,ABERDEEN,SUMBURGH,140667,99025,41642,155459,117200,38259,-9.51505
03/03/2019 11:10,2018,2017,B,Other Reporting Airports,ABERDEEN,WICK JOHN O GROATS,7775,7775,0,6883,6883,0,12.95947
03/03/2019 11:10,2018,2017,B,Other Reporting Airports,ALDERNEY,BOURNEMOUTH,17,17,0,0,0,0,0
03/03/2019 11:10,2018,2017,B,Other Reporting Airports,ALDERNEY,GUERNSEY,29746,29746,0,30870,30870,0,-3.64108
03/03/2019 11:10,2018,2017,B,Other Reporting Airports,ALDERNEY,JERSEY,0,0,0,198,198,0,-100
03/03/2019 11:10,2018,2017,B,Other Reporting Airports,ALDERNEY,SOUTHAMPTON,23580,23580,0,23692,23692,0,-0.47273
03/03/2019 11:10,2018,2017,B,Other Reporting Airports,BARRA,BENBECULA,6,6,0,12,12,0,-50
03/03/2019 11:10,2018,2017,B,Other Reporting Airports,BARRA,GLASGOW,14700,14700,0,14890,14890,0,-1.27602
03/03/2019 11:10,2018,2017,B,Other Reporting Airports,BARRA,TIREE,0,0,0,11,11,0,-100
03/03/2019 11:10,2018,2017,B,Other Reporting Airports,BELFAST CITY (GEORGE BEST),ABERDEEN,41291,41291,0,42261,42261,0,-2.29526
03/03/2019 11:10,2018,2017,B,Other Reporting Airports,BELFAST CITY (GEORGE BEST),BELFAST INTERNATIONAL,33,33,0,152,152,0,-78.28947
03/03/2019 11:10,2018,2017,B,Other Reporting Airports,BELFAST CITY (GEORGE BEST),BIRMINGHAM,275477,275260,217,269110,268715,395,2.36595
03/03/2019 11:10,2018,2017,B,Other Reporting Airports,BELFAST CITY (GEORGE BEST),CARDIFF WALES,70784,70746,38,50909,50909,0,39.04025
03/03/2019 11:10,2018,2017,B,Other Reporting Airports,BELFAST CITY (GEORGE BEST),DONCASTER SHEFFIELD,16766,16766,0,0,0,0,0
03/03/2019 11:10,2018,2017,B,Other Reporting Airports,BELFAST CITY (GEORGE BEST),EAST MIDLANDS INTERNATIONAL,150497,150371,126,148988,148988,0,1.01283
03/03/2019 11:10,2018,2017,B,Other Reporting Airports,BELFAST CITY (GEORGE BEST),EDINBURGH,151147,150988,159,172135,171973,162,-12.19276
03/03/2019 11:10,2018,2017,B,Other Reporting Airports,BELFAST CITY (GEORGE BEST),EXETER,36722,36722,0,36249,36249,0,1.30486
03/03/2019 11:10,2018,2017,B,Other Reporting Airports,BELFAST CITY (GEORGE BEST),GLASGOW,148985,148907,78,163559,163371,188,-8.91055
03/03/2019 11:10,2018,2017,B,Other Reporting Airports,BELFAST CITY (GEORGE BEST),HEATHROW,650212,649848,364,686703,686085,618,-5.31394
03/03/2019 11:10,2018,2017,B,Other Reporting Airports,BELFAST CITY (GEORGE BEST),INVERNESS,35999,35999,0,33097,33019,78,8.76817
03/03/2019 11:10,2018,2017,B,Other Reporting Airports,BELFAST CITY (GEORGE BEST),ISLE OF MAN,3769,3769,0,10864,10864,0,-65.30744
03/03/2019 11:10,2018,2017,B,Other Reporting Airports,BELFAST CITY (GEORGE BEST),LEEDS BRADFORD,165858,165808,50,166872,166816,56,-0.60765
03/03/2019 11:10,2018,2017,B,Other Reporting Airports,BELFAST CITY (GEORGE BEST),LIVERPOOL (JOHN LENNON),28784,28784,0,35170,35170,0,-18.15752
03/03/2019 11:10,2018,2017,B,Other Reporting Airports,BELFAST CITY (GEORGE BEST),LONDON CITY,185004,185004,0,121661,121661,0,52.06516
03/03/2019 11:10,2018,2017,B,Other Reporting Airports,BELFAST CITY (GEORGE BEST),LUTON,0,0,0,104,0,104,-100
03/03/2019 11:10,2018,2017,B,Other Reporting Airports,BELFAST CITY (GEORGE BEST),MANCHESTER,280250,280106,144,287251,287251,0,-2.43724
03/03/2019 11:10,2018,2017,B,Other Reporting Airports,BELFAST CITY (GEORGE BEST),NEWCASTLE,3021,3021,0,3633,3633,0,-16.84558
03/03/2019 11:10,2018,2017,B,Other Reporting Airports,BELFAST CITY (GEORGE BEST),NEWQUAY,3217,3217,0,3534,3534,0,-8.97001
03/03/2019 11:10,2018,2017,B,Other Reporting Airports,BELFAST CITY (GEORGE BEST),PRESTWICK,77,77,0,75,75,0,2.66667
03/03/2019 11:10,2018,2017,B,Other Reporting Airports,BELFAST CITY (GEORGE BEST),SOUTHAMPTON,128209,128138,71,118840,118840,0,7.88371
03/03/2019 11:10,2018,2017,B,Other Reporting Airports,BELFAST CITY (GEORGE BEST),SOUTHEND,49,49,0,61,61,0,-19.67213
03/03/2019 11:10,2018,2017,B,Other Reporting Airports,BELFAST CITY (GEORGE BEST),STANSTED,105,66,39,0,0,0,0
03/03/2019 11:10,2018,2017,B,Other Reporting Airports,BELFAST INTERNATIONAL,BELFAST CITY (GEORGE BEST),49,0,49,127,0,127,-61.41732
03/03/2019 11:10,2018,2017,B,Other Reporting Airports,BELFAST INTERNATIONAL,BIRMINGHAM,252079,251539,540,224393,224393,0,12.33817
03/03/2019 11:10,2018,2017,B,Other Reporting Airports,BELFAST INTERNATIONAL,BRISTOL,258128,258128,0,261739,261739,0,-1.37962
03/03/2019 11:10,2018,2017,B,Other Reporting Airports,BELFAST INTERNATIONAL,CARDIFF WALES,94,0,94,302,0,302,-68.87417
03/03/2019 11:10,2018,2017,B,Other Reporting Airports,BELFAST INTERNATIONAL,DONCASTER SHEFFIELD,0,0,0,133,0,133,-100
03/03/2019 11:10,2018,2017,B,Other Reporting Airports,BELFAST INTERNATIONAL,EAST MIDLANDS INTERNATIONAL,144,0,144,263,0,263,-45.24715
03/03/2019 11:10,2018,2017,B,Other Reporting Airports,BELFAST INTERNATIONAL,EDINBURGH,328320,328320,0,284833,284833,0,15.26754
03/03/2019 11:10,2018,2017,B,Other Reporting Airports,BELFAST INTERNATIONAL,GATWICK,594111,593486,625,982790,982622,168,-39.54853
03/03/2019 11:10,2018,2017,B,Other Reporting Airports,BELFAST INTERNATIONAL,GLASGOW,291253,291253,0,261020,260749,271,11.58264
03/03/2019 11:10,2018,2017,B,Other Reporting Airports,BELFAST INTERNATIONAL,HEATHROW,250,0,250,244,0,244,2.45902
03/03/2019 11:10,2018,2017,B,Other Reporting Airports,BELFAST INTERNATIONAL,ISLE OF MAN,12924,12924,0,0,0,0,0
03/03/2019 11:10,2018,2017,B,Other Reporting Airports,BELFAST INTERNATIONAL,JERSEY,21308,21308,0,20793,20793,0,2.4768
03/03/2019 11:10,2018,2017,B,Other Reporting Airports,BELFAST INTERNATIONAL,LEEDS BRADFORD,0,0,0,75,0,75,-100
03/03/2019 11:10,2018,2017,B,Other Reporting Airports,BELFAST INTERNATIONAL,LIVERPOOL (JOHN LENNON),498603,498603,0,490613,490576,37,1.62857
03/03/2019 11:10,2018,2017,B,Other Reporting Airports,BELFAST INTERNATIONAL,LUTON,342065,342065,0,340034,340034,0,0.59729
03/03/2019 11:10,2018,2017,B,Other Reporting Airports,BELFAST INTERNATIONAL,MANCHESTER,370731,370731,0,265670,265615,55,39.54568
03/03/2019 11:10,2018,2017,B,Other Reporting Airports,BELFAST INTERNATIONAL,NEWCASTLE,269945,269945,0,259775,259775,0,3.91493
03/03/2019 11:10,2018,2017,B,Other Reporting Airports,BELFAST INTERNATIONAL,STANSTED,677445,677060,385,376429,376270,159,79.96621
03/03/2019 11:10,2018,2017,B,Other Reporting Airports,BENBECULA,BARRA,6,6,0,11,11,0,-45.45455
03/03/2019 11:10,2018,2017,B,Other Reporting Airports,BENBECULA,EDINBURGH,2,2,0,20,20,0,-90
03/03/2019 11:10,2018,2017,B,Other Reporting Airports,BENBECULA,GLASGOW,26054,26054,0,24143,24143,0,7.91534
03/03/2019 11:10,2018,2017,B,Other Reporting Airports,BENBECULA,INVERNESS,41,41,0,36,36,0,13.88889
03/03/2019 11:10,2018,2017,B,Other Reporting Airports,BENBECULA,ISLAY,9,9,0,0,0,0,0
03/03/2019 11:10,2018,2017,B,Other Reporting Airports,BENBECULA,PRESTWICK,33,33,0,0,0,0,0
03/03/2019 11:10,2018,2017,B,Other Reporting Airports,BENBECULA,STORNOWAY,9259,9259,0,9048,9048,0,2.33201
03/03/2019 11:10,2018,2017,B,Other Reporting Airports,BIRMINGHAM,ABERDEEN,111952,111897,55,130399,130399,0,-14.14658
03/03/2019 11:10,2018,2017,B,Other Reporting Airports,BIRMINGHAM,BELFAST CITY (GEORGE BEST),275314,275314,0,269018,269018,0,2.34036
03/03/2019 11:10,2018,2017,B,Other Reporting Airports,BIRMINGHAM,BELFAST INTERNATIONAL,251131,250711,420,222666,222666,0,12.78372
03/03/2019 11:10,2018,2017,B,Other Reporting Airports,BIRMINGHAM,BRISTOL,67,67,0,37,37,0,81.08108
03/03/2019 11:10,2018,2017,B,Other Reporting Airports,BIRMINGHAM,DONCASTER SHEFFIELD,0,0,0,89,89,0,-100
03/03/2019 11:10,2018,2017,B,Other Reporting Airports,BIRMINGHAM,DURHAM TEES VALLEY,0,0,0,46,0,46,-100
03/03/2019 11:10,2018,2017,B,Other Reporting Airports,BIRMINGHAM,EAST MIDLANDS INTERNATIONAL,359,359,0,150,150,0,139.33333
03/03/2019 11:10,2018,2017,B,Other Reporting Airports,BIRMINGHAM,EDINBURGH,267695,266985,710,255142,254974,168,4.92001
03/03/2019 11:10,2018,2017,B,Other Reporting Airports,BIRMINGHAM,GLASGOW,234522,233965,557,221667,221471,196,5.79924
03/03/2019 11:10,2018,2017,B,Other Reporting Airports,BIRMINGHAM,GUERNSEY,29625,29546,79,34851,34851,0,-14.99527
03/03/2019 11:10,2018,2017,B,Other Reporting Airports,BIRMINGHAM,HEATHROW,75,75,0,0,0,0,0
03/03/2019 11:10,2018,2017,B,Other Reporting Airports,BIRMINGHAM,INVERNESS,45084,45084,0,44071,44071,0,2.29856
03/03/2019 11:10,2018,2017,B,Other Reporting Airports,BIRMINGHAM,ISLE OF MAN,42418,42418,0,44064,44064,0,-3.73548
03/03/2019 11:10,2018,2017,B,Other Reporting Airports,BIRMINGHAM,JERSEY,72126,72126,0,60251,60251,0,19.70922
03/03/2019 11:10,2018,2017,B,Other Reporting Airports,BIRMINGHAM,LEEDS BRADFORD,0,0,0,35,35,0,-100
03/03/2019 11:10,2018,2017,B,Other Reporting Airports,BIRMINGHAM,LIVERPOOL (JOHN LENNON),185,185,0,0,0,0,0
03/03/2019 11:10,2018,2017,B,Other Reporting Airports,BIRMINGHAM,LONDON CITY,0,0,0,4,4,0,-100
03/03/2019 11:10,2018,2017,B,Other Reporting Airports,BIRMINGHAM,MANCHESTER,188,188,0,351,351,0,-46.43875
03/03/2019 11:10,2018,2017,B,Other Reporting Airports,BIRMINGHAM,NEWCASTLE,104,72,32,191,29,162,-45.54974
03/03/2019 11:10,2018,2017,B,Other Reporting Airports,BIRMINGHAM,NEWQUAY,23521,23521,0,27041,27041,0,-13.01727
03/03/2019 11:10,2018,2017,B,Other Reporting Airports,BIRMINGHAM,NORWICH,120,0,120,0,0,0,0
03/03/2019 11:10,2018,2017,B,Other Reporting Airports,BIRMINGHAM,SOUTHAMPTON,112,112,0,179,179,0,-37.43017
03/03/2019 11:10,2018,2017,B,Other Reporting Airports,BIRMINGHAM,STANSTED,294,294,0,0,0,0,0
03/03/2019 11:10,2018,2017,B,Other Reporting Airports,BLACKPOOL,ISLE OF MAN,0,0,0,1906,1906,0,-100
03/03/2019 11:10,2018,2017,B,Other Reporting Airports,BOURNEMOUTH,BELFAST CITY (GEORGE BEST),0,0,0,56,56,0,-100
03/03/2019 11:10,2018,2017,B,Other Reporting Airports,BOURNEMOUTH,BIRMINGHAM,193,0,193,83,0,83,132.53012
03/03/2019 11:10,2018,2017,B,Other Reporting Airports,BOURNEMOUTH,CARDIFF WALES,194,0,194,47,0,47,312.76596
03/03/2019 11:10,2018,2017,B,Other Reporting Airports,BOURNEMOUTH,DONCASTER SHEFFIELD,43,0,43,0,0,0,0
03/03/2019 11:10,2018,2017,B,Other Reporting Airports,BOURNEMOUTH,DURHAM TEES VALLEY,0,0,0,146,0,146,-100
03/03/2019 11:10,2018,2017,B,Other Reporting Airports,BOURNEMOUTH,EAST MIDLANDS INTERNATIONAL,80,0,80,38,0,38,110.52632
03/03/2019 11:10,2018,2017,B,Other Reporting Airports,BOURNEMOUTH,EDINBURGH,69,69,0,0,0,0,0
03/03/2019 11:10,2018,2017,B,Other Reporting Airports,BOURNEMOUTH,GATWICK,100,100,0,1144,1144,0,-91.25874
03/03/2019 11:10,2018,2017,B,Other Reporting Airports,BOURNEMOUTH,GLASGOW,0,0,0,25,25,0,-100
03/03/2019 11:10,2018,2017,B,Other Reporting Airports,BOURNEMOUTH,GUERNSEY,122,0,122,0,0,0,0
03/03/2019 11:10,2018,2017,B,Other Reporting Airports,BOURNEMOUTH,HUMBERSIDE,0,0,0,96,0,96,-100
03/03/2019 11:10,2018,2017,B,Other Reporting Airports,BOURNEMOUTH,JERSEY,232,232,0,9,9,0,2477.77778
03/03/2019 11:10,2018,2017,B,Other Reporting Airports,BOURNEMOUTH,LEEDS BRADFORD,83,0,83,267,193,74,-68.91386
03/03/2019 11:10,2018,2017,B,Other Reporting Airports,BOURNEMOUTH,LIVERPOOL (JOHN LENNON),206,0,206,556,0,556,-62.94964
03/03/2019 11:10,2018,2017,B,Other Reporting Airports,BOURNEMOUTH,LUTON,32,0,32,0,0,0,0
03/03/2019 11:10,2018,2017,B,Other Reporting Airports,BOURNEMOUTH,MANCHESTER,498,0,498,849,42,807,-41.34276
03/03/2019 11:10,2018,2017,B,Other Reporting Airports,BOURNEMOUTH,NEWCASTLE,171,0,171,241,65,176,-29.04564
03/03/2019 11:10,2018,2017,B,Other Reporting Airports,BOURNEMOUTH,NORWICH,30,0,30,0,0,0,0
03/03/2019 11:10,2018,2017,B,Other Reporting Airports,BOURNEMOUTH,SOUTHAMPTON,35,35,0,0,0,0,0
03/03/2019 11:10,2018,2017,B,Other Reporting Airports,BOURNEMOUTH,SOUTHEND,129,0,129,0,0,0,0
03/03/2019 11:10,2018,2017,B,Other Reporting Airports,BOURNEMOUTH,STANSTED,152,0,152,5,4,1,2940
03/03/2019 11:10,2018,2017,B,Other Reporting Airports,BRISTOL,ABERDEEN,13187,13187,0,16733,16730,3,-21.19166
03/03/2019 11:10,2018,2017,B,Other Reporting Airports,BRISTOL,ALDERNEY,5,5,0,0,0,0,0
03/03/2019 11:10,2018,2017,B,Other Reporting Airports,BRISTOL,BELFAST INTERNATIONAL,258044,258044,0,261249,261249,0,-1.2268
03/03/2019 11:10,2018,2017,B,Other Reporting Airports,BRISTOL,BIRMINGHAM,544,544,0,259,259,0,110.03861
03/03/2019 11:10,2018,2017,B,Other Reporting Airports,BRISTOL,CARDIFF WALES,798,798,0,808,808,0,-1.23762
03/03/2019 11:10,2018,2017,B,Other Reporting Airports,BRISTOL,DONCASTER SHEFFIELD,47,47,0,0,0,0,0
03/03/2019 11:10,2018,2017,B,Other Reporting Airports,BRISTOL,DURHAM TEES VALLEY,155,0,155,26,0,26,496.15385
03/03/2019 11:10,2018,2017,B,Other Reporting Airports,BRISTOL,EDINBURGH,400014,399971,43,393853,393808,45,1.56429
03/03/2019 11:10,2018,2017,B,Other Reporting Airports,BRISTOL,EXETER,0,0,0,425,425,0,-100
03/03/2019 11:10,2018,2017,B,Other Reporting Airports,BRISTOL,FARNBOROUGH,0,0,0,4,4,0,-100
03/03/2019 11:10,2018,2017,B,Other Reporting Airports,BRISTOL,GATWICK,158,158,0,8,8,0,1875
03/03/2019 11:10,2018,2017,B,Other Reporting Airports,BRISTOL,GLASGOW,312051,311933,118,307010,306936,74,1.64197
03/03/2019 11:10,2018,2017,B,Other Reporting Airports,BRISTOL,GUERNSEY,27678,27678,0,24959,24959,0,10.89387
03/03/2019 11:10,2018,2017,B,Other Reporting Airports,BRISTOL,HAWARDEN,2877,73,2804,3235,45,3190,-11.06646
03/03/2019 11:10,2018,2017,B,Other Reporting Airports,BRISTOL,HEATHROW,0,0,0,3,3,0,-100
03/03/2019 11:10,2018,2017,B,Other Reporting Airports,BRISTOL,HUMBERSIDE,59,0,59,87,0,87,-32.18391
03/03/2019 11:10,2018,2017,B,Other Reporting Airports,BRISTOL,INVERNESS,92842,92842,0,96659,96659,0,-3.94893
03/03/2019 11:10,2018,2017,B,Other Reporting Airports,BRISTOL,ISLE OF MAN,29241,29241,0,26758,26758,0,9.27947
03/03/2019 11:10,2018,2017,B,Other Reporting Airports,BRISTOL,JERSEY,24447,24447,0,26579,26579,0,-8.02137
03/03/2019 11:10,2018,2017,B,Other Reporting Airports,BRISTOL,LEEDS BRADFORD,0,0,0,95,0,95,-100
03/03/2019 11:10,2018,2017,B,Other Reporting Airports,BRISTOL,LIVERPOOL (JOHN LENNON),149,149,0,219,219,0,-31.96347
03/03/2019 11:10,2018,2017,B,Other Reporting Airports,BRISTOL,LONDON CITY,0,0,0,53,35,18,-100
03/03/2019 11:10,2018,2017,B,Other Reporting Airports,BRISTOL,LUTON,4,4,0,4,4,0,0
03/03/2019 11:10,2018,2017,B,Other Reporting Airports,BRISTOL,MANCHESTER,376,35,341,811,612,199,-53.63748
03/03/2019 11:10,2018,2017,B,Other Reporting Airports,BRISTOL,NEWCASTLE,189534,189228,306,169962,169634,328,11.51552
03/03/2019 11:10,2018,2017,B,Other Reporting Airports,BRISTOL,NEWQUAY,5,5,0,2,2,0,150
03/03/2019 11:10,2018,2017,B,Other Reporting Airports,BRISTOL,NORWICH,0,0,0,121,23,98,-100
03/03/2019 11:10,2018,2017,B,Other Reporting Airports,BRISTOL,SOUTHAMPTON,5,5,0,0,0,0,0
03/03/2019 11:10,2018,2017,B,Other Reporting Airports,BRISTOL,SOUTHEND,0,0,0,4,4,0,-100
03/03/2019 11:10,2018,2017,B,Other Reporting Airports,BRISTOL,STANSTED,0,0,0,66,0,66,-100
03/03/2019 11:10,2018,2017,B,Other Reporting Airports,CAMBRIDGE,MANCHESTER,4,4,0,0,0,0,0
03/03/2019 11:10,2018,2017,B,Other Reporting Airports,CAMPBELTOWN,FARNBOROUGH,0,0,0,4,4,0,-100
03/03/2019 11:10,2018,2017,B,Other Reporting Airports,CAMPBELTOWN,GLASGOW,8414,8414,0,8620,8620,0,-2.38979
03/03/2019 11:10,2018,2017,B,Other Reporting Airports,CAMPBELTOWN,ISLAY,14,14,0,15,15,0,-6.66667
03/03/2019 11:10,2018,2017,B,Other Reporting Airports,CAMPBELTOWN,TIREE,44,44,0,87,87,0,-49.42529
03/03/2019 11:10,2018,2017,B,Other Reporting Airports,CARDIFF WALES,ABERDEEN,539,487,52,679,679,0,-20.61856
03/03/2019 11:10,2018,2017,B,Other Reporting Airports,CARDIFF WALES,ANGLESEY (VALLEY),14617,14617,0,13045,13045,0,12.05059
03/03/2019 11:10,2018,2017,B,Other Reporting Airports,CARDIFF WALES,BELFAST CITY (GEORGE BEST),71439,71313,126,51303,51303,0,39.24917
03/03/2019 11:10,2018,2017,B,Other Reporting Airports,CARDIFF WALES,BELFAST INTERNATIONAL,207,111,96,627,295,332,-66.98565
03/03/2019 11:10,2018,2017,B,Other Reporting Airports,CARDIFF WALES,BIRMINGHAM,53,53,0,0,0,0,0
03/03/2019 11:10,2018,2017,B,Other Reporting Airports,CARDIFF WALES,BLACKPOOL,36,0,36,81,0,81,-55.55556
03/03/2019 11:10,2018,2017,B,Other Reporting Airports,CARDIFF WALES,BOURNEMOUTH,190,0,190,127,0,127,49.6063
03/03/2019 11:10,2018,2017,B,Other Reporting Airports,CARDIFF WALES,DONCASTER SHEFFIELD,273,0,273,34,34,0,702.94118
03/03/2019 11:10,2018,2017,B,Other Reporting Airports,CARDIFF WALES,DURHAM TEES VALLEY,137,0,137,163,0,163,-15.95092
03/03/2019 11:10,2018,2017,B,Other Reporting Airports,CARDIFF WALES,EAST MIDLANDS INTERNATIONAL,154,0,154,139,0,139,10.79137
03/03/2019 11:10,2018,2017,B,Other Reporting Airports,CARDIFF WALES,EDINBURGH,102102,101671,431,99369,98597,772,2.75035
03/03/2019 11:10,2018,2017,B,Other Reporting Airports,CARDIFF WALES,FARNBOROUGH,41,0,41,0,0,0,0
03/03/2019 11:10,2018,2017,B,Other Reporting Airports,CARDIFF WALES,GATWICK,338,179,159,86,0,86,293.02326
03/03/2019 11:10,2018,2017,B,Other Reporting Airports,CARDIFF WALES,GLASGOW,33261,33097,164,28919,28787,132,15.01435
03/03/2019 11:10,2018,2017,B,Other Reporting Airports,CARDIFF WALES,GUERNSEY,2035,2035,0,3264,3264,0,-37.65319
03/03/2019 11:10,2018,2017,B,Other Reporting Airports,CARDIFF WALES,HUMBERSIDE,114,0,114,233,0,233,-51.07296
03/03/2019 11:10,2018,2017,B,Other Reporting Airports,CARDIFF WALES,JERSEY,20095,20095,0,17134,17134,0,17.28143
03/03/2019 11:10,2018,2017,B,Other Reporting Airports,CARDIFF WALES,LEEDS BRADFORD,243,3,240,136,0,136,78.67647
03/03/2019 11:10,2018,2017,B,Other Reporting Airports,CARDIFF WALES,LIVERPOOL (JOHN LENNON),322,0,322,195,0,195,65.12821
03/03/2019 11:10,2018,2017,B,Other Reporting Airports,CARDIFF WALES,LONDON CITY,0,0,0,21500,21464,36,-100
03/03/2019 11:10,2018,2017,B,Other Reporting Airports,CARDIFF WALES,LUTON,183,0,183,259,0,259,-29.34363
03/03/2019 11:10,2018,2017,B,Other Reporting Airports,CARDIFF WALES,MANCHESTER,651,69,582,733,0,733,-11.1869
03/03/2019 11:10,2018,2017,B,Other Reporting Airports,CARDIFF WALES,NEWCASTLE,11522,11284,238,13855,13541,314,-16.83869
03/03/2019 11:10,2018,2017,B,Other Reporting Airports,CARDIFF WALES,NORWICH,153,0,153,163,0,163,-6.13497
03/03/2019 11:10,2018,2017,B,Other Reporting Airports,CARDIFF WALES,PRESTWICK,0,0,0,143,143,0,-100
03/03/2019 11:10,2018,2017,B,Other Reporting Airports,CARDIFF WALES,SOUTHAMPTON,75,0,75,76,0,76,-1.31579
03/03/2019 11:10,2018,2017,B,Other Reporting Airports,CARDIFF WALES,STANSTED,340,0,340,121,0,121,180.99174
03/03/2019 11:10,2018,2017,B,Other Reporting Airports,CITY OF DERRY (EGLINTON),DUNDEE,0,0,0,16,0,16,-100
03/03/2019 11:10,2018,2017,B,Other Reporting Airports,CITY OF DERRY (EGLINTON),EDINBURGH,13402,13366,36,0,0,0,0
03/03/2019 11:10,2018,2017,B,Other Reporting Airports,CITY OF DERRY (EGLINTON),FARNBOROUGH,0,0,0,1,0,1,-100
03/03/2019 11:10,2018,2017,B,Other Reporting Airports,CITY OF DERRY (EGLINTON),GLASGOW,64736,64735,1,84968,84626,342,-23.81132
03/03/2019 11:10,2018,2017,B,Other Reporting Airports,CITY OF DERRY (EGLINTON),LIVERPOOL (JOHN LENNON),57792,57792,0,52354,52353,1,10.38698
03/03/2019 11:10,2018,2017,B,Other Reporting Airports,CITY OF DERRY (EGLINTON),NORWICH,61,61,0,0,0,0,0
03/03/2019 11:10,2018,2017,B,Other Reporting Airports,CITY OF DERRY (EGLINTON),STANSTED,47206,47176,30,54559,54476,83,-13.47715
03/03/2019 11:10,2018,2017,B,Other Reporting Airports,DONCASTER SHEFFIELD,ABERDEEN,26,26,0,50,50,0,-48
03/03/2019 11:10,2018,2017,B,Other Reporting Airports,DONCASTER SHEFFIELD,BELFAST CITY (GEORGE BEST),18228,18228,0,265,265,0,6778.49057
03/03/2019 11:10,2018,2017,B,Other Reporting Airports,DONCASTER SHEFFIELD,BELFAST INTERNATIONAL,0,0,0,135,0,135,-100
03/03/2019 11:10,2018,2017,B,Other Reporting Airports,DONCASTER SHEFFIELD,BIRMINGHAM,23,23,0,33,33,0,-30.30303
03/03/2019 11:10,2018,2017,B,Other Reporting Airports,DONCASTER SHEFFIELD,BOURNEMOUTH,43,0,43,0,0,0,0
03/03/2019 11:10,2018,2017,B,Other Reporting Airports,DONCASTER SHEFFIELD,CARDIFF WALES,160,0,160,74,74,0,116.21622
03/03/2019 11:10,2018,2017,B,Other Reporting Airports,DONCASTER SHEFFIELD,CITY OF DERRY (EGLINTON),6,6,0,0,0,0,0
03/03/2019 11:10,2018,2017,B,Other Reporting Airports,DONCASTER SHEFFIELD,EAST MIDLANDS INTERNATIONAL,79,0,79,0,0,0,0
03/03/2019 11:10,2018,2017,B,Other Reporting Airports,DONCASTER SHEFFIELD,FARNBOROUGH,32,0,32,55,0,55,-41.81818
03/03/2019 11:10,2018,2017,B,Other Reporting Airports,DONCASTER SHEFFIELD,GATWICK,10,10,0,203,0,203,-95.07389
03/03/2019 11:10,2018,2017,B,Other Reporting Airports,DONCASTER SHEFFIELD,HEATHROW,32,0,32,0,0,0,0
03/03/2019 11:10,2018,2017,B,Other Reporting Airports,DONCASTER SHEFFIELD,JERSEY,33032,33032,0,33096,33096,0,-0.19338
03/03/2019 11:10,2018,2017,B,Other Reporting Airports,DONCASTER SHEFFIELD,LEEDS BRADFORD,7,7,0,146,3,143,-95.20548
03/03/2019 11:10,2018,2017,B,Other Reporting Airports,DONCASTER SHEFFIELD,LIVERPOOL (JOHN LENNON),109,0,109,184,184,0,-40.76087
03/03/2019 11:10,2018,2017,B,Other Reporting Airports,DONCASTER SHEFFIELD,LUTON,6,6,0,0,0,0,0
03/03/2019 11:10,2018,2017,B,Other Reporting Airports,DONCASTER SHEFFIELD,MANCHESTER,6,6,0,4,4,0,50
03/03/2019 11:10,2018,2017,B,Other Reporting Airports,DONCASTER SHEFFIELD,NEWQUAY,7502,7502,0,7101,7101,0,5.64709
03/03/2019 11:10,2018,2017,B,Other Reporting Airports,DONCASTER SHEFFIELD,SOUTHAMPTON,85,85,0,106,106,0,-19.81132
03/03/2019 11:10,2018,2017,B,Other Reporting Airports,DONCASTER SHEFFIELD,SOUTHEND,0,0,0,2,2,0,-100
03/03/2019 11:10,2018,2017,B,Other Reporting Airports,DONCASTER SHEFFIELD,STANSTED,0,0,0,42,0,42,-100
03/03/2019 11:10,2018,2017,B,Other Reporting Airports,DUNDEE,KIRKWALL,0,0,0,29,29,0,-100
03/03/2019 11:10,2018,2017,B,Other Reporting Airports,DUNDEE,NORWICH,32,32,0,0,0,0,0
03/03/2019 11:10,2018,2017,B,Other Reporting Airports,DUNDEE,STANSTED,20426,20426,0,20699,20699,0,-1.3189
03/03/2019 11:10,2018,2017,B,Other Reporting Airports,DUNDEE,SUMBURGH,0,0,0,17,17,0,-100
03/03/2019 11:10,2018,2017,B,Other Reporting Airports,DURHAM TEES VALLEY,ABERDEEN,22956,22888,68,22036,22036,0,4.17499
03/03/2019 11:10,2018,2017,B,Other Reporting Airports,DURHAM TEES VALLEY,BIGGIN HILL,0,0,0,34,0,34,-100
03/03/2019 11:10,2018,2017,B,Other Reporting Airports,DURHAM TEES VALLEY,BIRMINGHAM,159,34,125,69,0,69,130.43478
03/03/2019 11:10,2018,2017,B,Other Reporting Airports,DURHAM TEES VALLEY,BOURNEMOUTH,0,0,0,107,72,35,-100
03/03/2019 11:10,2018,2017,B,Other Reporting Airports,DURHAM TEES VALLEY,BRISTOL,83,0,83,36,4,32,130.55556
03/03/2019 11:10,2018,2017,B,Other Reporting Airports,DURHAM TEES VALLEY,CAMBRIDGE,80,0,80,0,0,0,0
03/03/2019 11:10,2018,2017,B,Other Reporting Airports,DURHAM TEES VALLEY,CARDIFF WALES,105,34,71,83,39,44,26.50602
03/03/2019 11:10,2018,2017,B,Other Reporting Airports,DURHAM TEES VALLEY,EAST MIDLANDS INTERNATIONAL,0,0,0,104,39,65,-100
03/03/2019 11:10,2018,2017,B,Other Reporting Airports,DURHAM TEES VALLEY,FARNBOROUGH,129,63,66,65,65,0,98.46154
03/03/2019 11:10,2018,2017,B,Other Reporting Airports,DURHAM TEES VALLEY,GATWICK,200,0,200,0,0,0,0
03/03/2019 11:10,2018,2017,B,Other Reporting Airports,DURHAM TEES VALLEY,HUMBERSIDE,189,189,0,941,941,0,-79.91498
03/03/2019 11:10,2018,2017,B,Other Reporting Airports,DURHAM TEES VALLEY,JERSEY,2556,2556,0,2558,2558,0,-0.07819
03/03/2019 11:10,2018,2017,B,Other Reporting Airports,DURHAM TEES VALLEY,LEEDS BRADFORD,6,6,0,17,17,0,-64.70588
03/03/2019 11:10,2018,2017,B,Other Reporting Airports,DURHAM TEES VALLEY,LIVERPOOL (JOHN LENNON),0,0,0,85,0,85,-100
03/03/2019 11:10,2018,2017,B,Other Reporting Airports,DURHAM TEES VALLEY,LUTON,34,0,34,182,81,101,-81.31868
03/03/2019 11:10,2018,2017,B,Other Reporting Airports,DURHAM TEES VALLEY,NEWCASTLE,72,72,0,41,41,0,75.60976
03/03/2019 11:10,2018,2017,B,Other Reporting Airports,DURHAM TEES VALLEY,NORWICH,122,50,72,678,606,72,-82.0059
03/03/2019 11:10,2018,2017,B,Other Reporting Airports,DURHAM TEES VALLEY,SOUTHAMPTON,9,9,0,151,0,151,-94.03974
03/03/2019 11:10,2018,2017,B,Other Reporting Airports,DURHAM TEES VALLEY,STANSTED,145,0,145,101,23,78,43.56436
03/03/2019 11:10,2018,2017,B,Other Reporting Airports,EAST MIDLANDS INTERNATIONAL,ABERDEEN,22,22,0,44,44,0,-50
03/03/2019 11:10,2018,2017,B,Other Reporting Airports,EAST MIDLANDS INTERNATIONAL,BELFAST CITY (GEORGE BEST),150607,150607,0,149091,149091,0,1.01683
03/03/2019 11:10,2018,2017,B,Other Reporting Airports,EAST MIDLANDS INTERNATIONAL,BELFAST INTERNATIONAL,248,75,173,211,0,211,17.53555
03/03/2019 11:10,2018,2017,B,Other Reporting Airports,EAST MIDLANDS INTERNATIONAL,BIGGIN HILL,39,0,39,34,0,34,14.70588
03/03/2019 11:10,2018,2017,B,Other Reporting Airports,EAST MIDLANDS INTERNATIONAL,BIRMINGHAM,117,117,0,1089,1085,4,-89.2562
03/03/2019 11:10,2018,2017,B,Other Reporting Airports,EAST MIDLANDS INTERNATIONAL,BLACKPOOL,1,0,1,0,0,0,0
03/03/2019 11:10,2018,2017,B,Other Reporting Airports,EAST MIDLANDS INTERNATIONAL,BOURNEMOUTH,0,0,0,37,0,37,-100
03/03/2019 11:10,2018,2017,B,Other Reporting Airports,EAST MIDLANDS INTERNATIONAL,CARDIFF WALES,76,76,0,140,0,140,-45.71429
03/03/2019 11:10,2018,2017,B,Other Reporting Airports,EAST MIDLANDS INTERNATIONAL,DURHAM TEES VALLEY,0,0,0,68,0,68,-100
03/03/2019 11:10,2018,2017,B,Other Reporting Airports,EAST MIDLANDS INTERNATIONAL,EDINBURGH,93215,93215,0,92883,92883,0,0.35744
03/03/2019 11:10,2018,2017,B,Other Reporting Airports,EAST MIDLANDS INTERNATIONAL,GATWICK,145,33,112,66,0,66,119.69697
03/03/2019 11:10,2018,2017,B,Other Reporting Airports,EAST MIDLANDS INTERNATIONAL,GLASGOW,97143,97143,0,102712,102617,95,-5.42196
03/03/2019 11:10,2018,2017,B,Other Reporting Airports,EAST MIDLANDS INTERNATIONAL,GUERNSEY,19618,19553,65,23981,23981,0,-18.19357
03/03/2019 11:10,2018,2017,B,Other Reporting Airports,EAST MIDLANDS INTERNATIONAL,INVERNESS,77,77,0,0,0,0,0
03/03/2019 11:10,2018,2017,B,Other Reporting Airports,EAST MIDLANDS INTERNATIONAL,JERSEY,36225,36225,0,35646,35646,0,1.62431
03/03/2019 11:10,2018,2017,B,Other Reporting Airports,EAST MIDLANDS INTERNATIONAL,LIVERPOOL (JOHN LENNON),0,0,0,256,179,77,-100
03/03/2019 11:10,2018,2017,B,Other Reporting Airports,EAST MIDLANDS INTERNATIONAL,LUTON,0,0,0,151,151,0,-100
03/03/2019 11:10,2018,2017,B,Other Reporting Airports,EAST MIDLANDS INTERNATIONAL,MANCHESTER,544,544,0,694,319,375,-21.61383
03/03/2019 11:10,2018,2017,B,Other Reporting Airports,EAST MIDLANDS INTERNATIONAL,NEWCASTLE,167,94,73,119,119,0,40.33613
03/03/2019 11:10,2018,2017,B,Other Reporting Airports,EAST MIDLANDS INTERNATIONAL,NEWQUAY,180,180,0,0,0,0,0
03/03/2019 11:10,2018,2017,B,Other Reporting Airports,EAST MIDLANDS INTERNATIONAL,NORWICH,0,0,0,135,0,135,-100
03/03/2019 11:10,2018,2017,B,Other Reporting Airports,EAST MIDLANDS INTERNATIONAL,SOUTHAMPTON,1,0,1,652,579,73,-99.84663
03/03/2019 11:10,2018,2017,B,Other Reporting Airports,EAST MIDLANDS INTERNATIONAL,STANSTED,313,313,0,496,496,0,-36.89516
03/03/2019 11:10,2018,2017,B,Other Reporting Airports,EDINBURGH,ABERDEEN,199,199,0,410,224,186,-51.46341
03/03/2019 11:10,2018,2017,B,Other Reporting Airports,EDINBURGH,BELFAST CITY (GEORGE BEST),152176,152176,0,172684,172507,177,-11.87603
03/03/2019 11:10,2018,2017,B,Other Reporting Airports,EDINBURGH,BELFAST INTERNATIONAL,327576,327576,0,284522,284522,0,15.13205
03/03/2019 11:10,2018,2017,B,Other Reporting Airports,EDINBURGH,BENBECULA,744,744,0,1153,1153,0,-35.47268
03/03/2019 11:10,2018,2017,B,Other Reporting Airports,EDINBURGH,BIRMINGHAM,267787,267419,368,254815,254647,168,5.09075
03/03/2019 11:10,2018,2017,B,Other Reporting Airports,EDINBURGH,BRISTOL,400855,400771,84,392795,392753,42,2.05196
03/03/2019 11:10,2018,2017,B,Other Reporting Airports,EDINBURGH,CARDIFF WALES,102069,101655,414,99099,98299,800,2.997
03/03/2019 11:10,2018,2017,B,Other Reporting Airports,EDINBURGH,CITY OF DERRY (EGLINTON),13377,13341,36,0,0,0,0
03/03/2019 11:10,2018,2017,B,Other Reporting Airports,EDINBURGH,DUNDEE,9,9,0,0,0,0,0
03/03/2019 11:10,2018,2017,B,Other Reporting Airports,EDINBURGH,EAST MIDLANDS INTERNATIONAL,93160,93160,0,93149,93149,0,0.01181
03/03/2019 11:10,2018,2017,B,Other Reporting Airports,EDINBURGH,EXETER,48076,48076,0,47587,47587,0,1.02759
03/03/2019 11:10,2018,2017,B,Other Reporting Airports,EDINBURGH,GATWICK,740347,739430,917,736896,736896,0,0.46832
03/03/2019 11:10,2018,2017,B,Other Reporting Airports,EDINBURGH,GLASGOW,277,277,0,741,741,0,-62.61808
03/03/2019 11:10,2018,2017,B,Other Reporting Airports,EDINBURGH,HEATHROW,1198637,1198637,0,1179255,1179255,0,1.64358
03/03/2019 11:10,2018,2017,B,Other Reporting Airports,EDINBURGH,INVERNESS,0,0,0,168,168,0,-100
03/03/2019 11:10,2018,2017,B,Other Reporting Airports,EDINBURGH,ISLE OF MAN,6193,6193,0,3483,3483,0,77.80649
03/03/2019 11:10,2018,2017,B,Other Reporting Airports,EDINBURGH,JERSEY,20317,20317,0,5474,5474,0,271.15455
03/03/2019 11:10,2018,2017,B,Other Reporting Airports,EDINBURGH,KIRKWALL,46232,46232,0,45919,45919,0,0.68164
03/03/2019 11:10,2018,2017,B,Other Reporting Airports,EDINBURGH,LEEDS BRADFORD,0,0,0,20,20,0,-100
03/03/2019 11:10,2018,2017,B,Other Reporting Airports,EDINBURGH,LONDON CITY,497495,497495,0,485941,485864,77,2.37765
03/03/2019 11:10,2018,2017,B,Other Reporting Airports,EDINBURGH,LUTON,314784,314784,0,308763,308711,52,1.95004
03/03/2019 11:10,2018,2017,B,Other Reporting Airports,EDINBURGH,MANCHESTER,116953,116953,0,117376,117376,0,-0.36038
03/03/2019 11:10,2018,2017,B,Other Reporting Airports,EDINBURGH,NEWCASTLE,140,140,0,82,82,0,70.73171
03/03/2019 11:10,2018,2017,B,Other Reporting Airports,EDINBURGH,NEWQUAY,4435,4435,0,5030,5030,0,-11.82903
03/03/2019 11:10,2018,2017,B,Other Reporting Airports,EDINBURGH,NORWICH,29840,29840,0,28608,28608,0,4.30649
03/03/2019 11:10,2018,2017,B,Other Reporting Airports,EDINBURGH,SOUTHAMPTON,183236,183236,0,208105,207982,123,-11.95022
03/03/2019 11:10,2018,2017,B,Other Reporting Airports,EDINBURGH,SOUTHEND,65,65,0,0,0,0,0
03/03/2019 11:10,2018,2017,B,Other Reporting Airports,EDINBURGH,STANSTED,731989,731989,0,720537,720410,127,1.58937
03/03/2019 11:10,2018,2017,B,Other Reporting Airports,EDINBURGH,STORNOWAY,17861,17861,0,16934,16934,0,5.47419
03/03/2019 11:10,2018,2017,B,Other Reporting Airports,EDINBURGH,SUMBURGH,47554,47554,0,47131,47131,0,0.8975
03/03/2019 11:10,2018,2017,B,Other Reporting Airports,EDINBURGH,WICK JOHN O GROATS,9341,9341,0,11142,11142,0,-16.16406
03/03/2019 11:10,2018,2017,B,Other Reporting Airports,EXETER,ABERDEEN,0,0,0,53,53,0,-100
03/03/2019 11:10,2018,2017,B,Other Reporting Airports,EXETER,BELFAST CITY (GEORGE BEST),37345,37345,0,36984,36984,0,0.9761
03/03/2019 11:10,2018,2017,B,Other Reporting Airports,EXETER,BELFAST INTERNATIONAL,0,0,0,366,296,70,-100
03/03/2019 11:10,2018,2017,B,Other Reporting Airports,EXETER,BIRMINGHAM,70,70,0,32,32,0,118.75
03/03/2019 11:10,2018,2017,B,Other Reporting Airports,EXETER,BRISTOL,25,25,0,274,274,0,-90.87591
03/03/2019 11:10,2018,2017,B,Other Reporting Airports,EXETER,CARDIFF WALES,0,0,0,19,19,0,-100
03/03/2019 11:10,2018,2017,B,Other Reporting Airports,EXETER,EAST MIDLANDS INTERNATIONAL,0,0,0,72,72,0,-100
03/03/2019 11:10,2018,2017,B,Other Reporting Airports,EXETER,EDINBURGH,48608,48608,0,48007,48007,0,1.2519
03/03/2019 11:10,2018,2017,B,Other Reporting Airports,EXETER,GATWICK,112,112,0,337,337,0,-66.76558
03/03/2019 11:10,2018,2017,B,Other Reporting Airports,EXETER,GLASGOW,39905,39838,67,38773,38773,0,2.91956
03/03/2019 11:10,2018,2017,B,Other Reporting Airports,EXETER,GUERNSEY,29722,29722,0,31316,31144,172,-5.09005
03/03/2019 11:10,2018,2017,B,Other Reporting Airports,EXETER,HAWARDEN,0,0,0,14,10,4,-100
03/03/2019 11:10,2018,2017,B,Other Reporting Airports,EXETER,HEATHROW,0,0,0,36,36,0,-100
03/03/2019 11:10,2018,2017,B,Other Reporting Airports,EXETER,HUMBERSIDE,68,0,68,0,0,0,0
03/03/2019 11:10,2018,2017,B,Other Reporting Airports,EXETER,INVERNESS,0,0,0,138,138,0,-100
03/03/2019 11:10,2018,2017,B,Other Reporting Airports,EXETER,ISLES OF SCILLY (ST.MARYS),13445,13445,0,13759,13759,0,-2.28214
03/03/2019 11:10,2018,2017,B,Other Reporting Airports,EXETER,JERSEY,41240,41240,0,42709,42709,0,-3.43956
03/03/2019 11:10,2018,2017,B,Other Reporting Airports,EXETER,LONDON CITY,38255,38255,0,33953,33953,0,12.67046
03/03/2019 11:10,2018,2017,B,Other Reporting Airports,EXETER,LUTON,39,0,39,110,0,110,-64.54545
03/03/2019 11:10,2018,2017,B,Other Reporting Airports,EXETER,MANCHESTER,129947,129947,0,130428,130428,0,-0.36879
03/03/2019 11:10,2018,2017,B,Other Reporting Airports,EXETER,NEWCASTLE,45493,45140,353,42731,42468,263,6.46369
03/03/2019 11:10,2018,2017,B,Other Reporting Airports,EXETER,NEWQUAY,0,0,0,53,53,0,-100
03/03/2019 11:10,2018,2017,B,Other Reporting Airports,EXETER,NORWICH,30761,30761,0,27309,27309,0,12.64052
03/03/2019 11:10,2018,2017,B,Other Reporting Airports,EXETER,PRESTWICK,122,122,0,0,0,0,0
03/03/2019 11:10,2018,2017,B,Other Reporting Airports,EXETER,SOUTHAMPTON,0,0,0,596,596,0,-100
03/03/2019 11:10,2018,2017,B,Other Reporting Airports,EXETER,SOUTHEND,68,68,0,245,245,0,-72.2449
03/03/2019 11:10,2018,2017,B,Other Reporting Airports,EXETER,STANSTED,34,0,34,0,0,0,0
03/03/2019 11:10,2018,2017,B,Other Reporting Airports,GLASGOW,ABERDEEN,25,25,0,148,148,0,-83.10811
03/03/2019 11:10,2018,2017,B,Other Reporting Airports,GLASGOW,BARRA,15045,15045,0,15206,15206,0,-1.05879
03/03/2019 11:10,2018,2017,B,Other Reporting Airports,GLASGOW,BELFAST CITY (GEORGE BEST),149924,149924,0,164574,164515,59,-8.90177
03/03/2019 11:10,2018,2017,B,Other Reporting Airports,GLASGOW,BELFAST INTERNATIONAL,291771,291771,0,260528,260329,199,11.99219
03/03/2019 11:10,2018,2017,B,Other Reporting Airports,GLASGOW,BENBECULA,26620,26620,0,24697,24697,0,7.78637
03/03/2019 11:10,2018,2017,B,Other Reporting Airports,GLASGOW,BIRMINGHAM,234808,234252,556,221669,221518,151,5.92731
03/03/2019 11:10,2018,2017,B,Other Reporting Airports,GLASGOW,BOURNEMOUTH,54,0,54,0,0,0,0
03/03/2019 11:10,2018,2017,B,Other Reporting Airports,GLASGOW,BRISTOL,312334,312115,219,306820,306820,0,1.79714
03/03/2019 11:10,2018,2017,B,Other Reporting Airports,GLASGOW,CAMPBELTOWN,8618,8618,0,8776,8776,0,-1.80036
03/03/2019 11:10,2018,2017,B,Other Reporting Airports,GLASGOW,CARDIFF WALES,33229,33005,224,28652,28451,201,15.97445
03/03/2019 11:10,2018,2017,B,Other Reporting Airports,GLASGOW,CITY OF DERRY (EGLINTON),64940,64940,0,84726,84726,0,-23.35293
03/03/2019 11:10,2018,2017,B,Other Reporting Airports,GLASGOW,DUNDEE,12,12,0,0,0,0,0
03/03/2019 11:10,2018,2017,B,Other Reporting Airports,GLASGOW,EAST MIDLANDS INTERNATIONAL,96683,96683,0,102236,102045,191,-5.43155
03/03/2019 11:10,2018,2017,B,Other Reporting Airports,GLASGOW,EDINBURGH,134,134,0,410,410,0,-67.31707
03/03/2019 11:10,2018,2017,B,Other Reporting Airports,GLASGOW,EXETER,39995,39928,67,38225,38225,0,4.63048
03/03/2019 11:10,2018,2017,B,Other Reporting Airports,GLASGOW,GATWICK,620785,620785,0,618781,618726,55,0.32386
03/03/2019 11:10,2018,2017,B,Other Reporting Airports,GLASGOW,GUERNSEY,1295,1295,0,0,0,0,0
03/03/2019 11:10,2018,2017,B,Other Reporting Airports,GLASGOW,HEATHROW,911152,911152,0,909169,909169,0,0.21811
03/03/2019 11:10,2018,2017,B,Other Reporting Airports,GLASGOW,INVERNESS,186,186,0,201,201,0,-7.46269
03/03/2019 11:10,2018,2017,B,Other Reporting Airports,GLASGOW,ISLAY,32763,32719,44,32594,32496,98,0.5185
03/03/2019 11:10,2018,2017,B,Other Reporting Airports,GLASGOW,ISLE OF MAN,1991,1991,0,5532,5489,43,-64.0094
03/03/2019 11:10,2018,2017,B,Other Reporting Airports,GLASGOW,JERSEY,54419,54419,0,56138,56138,0,-3.0621
03/03/2019 11:10,2018,2017,B,Other Reporting Airports,GLASGOW,KIRKWALL,22450,22429,21,19645,19645,0,14.27844
03/03/2019 11:10,2018,2017,B,Other Reporting Airports,GLASGOW,LEEDS BRADFORD,0,0,0,7011,7011,0,-100
03/03/2019 11:10,2018,2017,B,Other Reporting Airports,GLASGOW,LONDON CITY,230068,230068,0,231339,231339,0,-0.54941
03/03/2019 11:10,2018,2017,B,Other Reporting Airports,GLASGOW,LUTON,243473,243396,77,234250,233880,370,3.93725
03/03/2019 11:10,2018,2017,B,Other Reporting Airports,GLASGOW,MANCHESTER,62533,62289,244,51199,51189,10,22.13715
03/03/2019 11:10,2018,2017,B,Other Reporting Airports,GLASGOW,NEWCASTLE,0,0,0,76,0,76,-100
03/03/2019 11:10,2018,2017,B,Other Reporting Airports,GLASGOW,NEWQUAY,2042,2042,0,3109,3109,0,-34.31972
03/03/2019 11:10,2018,2017,B,Other Reporting Airports,GLASGOW,NORWICH,624,624,0,2443,2443,0,-74.45763
03/03/2019 11:10,2018,2017,B,Other Reporting Airports,GLASGOW,PRESTWICK,172,172,0,72,72,0,138.88889
03/03/2019 11:10,2018,2017,B,Other Reporting Airports,GLASGOW,SOUTHAMPTON,186325,186325,0,197769,197708,61,-5.78655
03/03/2019 11:10,2018,2017,B,Other Reporting Airports,GLASGOW,SOUTHEND,42732,42622,110,6355,6355,0,572.41542
03/03/2019 11:10,2018,2017,B,Other Reporting Airports,GLASGOW,STANSTED,432557,431871,686,528393,528236,157,-18.13726
03/03/2019 11:10,2018,2017,B,Other Reporting Airports,GLASGOW,STORNOWAY,75862,75837,25,74965,74965,0,1.19656
03/03/2019 11:10,2018,2017,B,Other Reporting Airports,GLASGOW,SUMBURGH,29237,29210,27,33009,33009,0,-11.42719
03/03/2019 11:10,2018,2017,B,Other Reporting Airports,GLASGOW,TIREE,11716,11716,0,11266,11266,0,3.99432
03/03/2019 11:10,2018,2017,B,Other Reporting Airports,GLOUCESTERSHIRE,ISLE OF MAN,0,0,0,1394,1394,0,-100
03/03/2019 11:10,2018,2017,B,Other Reporting Airports,GUERNSEY,ALDERNEY,29740,29740,0,30900,30900,0,-3.75405
03/03/2019 11:10,2018,2017,B,Other Reporting Airports,GUERNSEY,BIRMINGHAM,35019,34940,79,30410,30326,84,15.1562
03/03/2019 11:10,2018,2017,B,Other Reporting Airports,GUERNSEY,BOURNEMOUTH,146,0,146,0,0,0,0
03/03/2019 11:10,2018,2017,B,Other Reporting Airports,GUERNSEY,BRISTOL,24676,24676,0,22744,22663,81,8.49455
03/03/2019 11:10,2018,2017,B,Other Reporting Airports,GUERNSEY,CARDIFF WALES,2022,2022,0,3253,3253,0,-37.84199
03/03/2019 11:10,2018,2017,B,Other Reporting Airports,GUERNSEY,DUNDEE,0,0,0,3,0,3,-100
03/03/2019 11:10,2018,2017,B,Other Reporting Airports,GUERNSEY,EAST MIDLANDS INTERNATIONAL,19646,19646,0,23922,23922,0,-17.87476
03/03/2019 11:10,2018,2017,B,Other Reporting Airports,GUERNSEY,EXETER,29449,29449,0,30762,30762,0,-4.26825
03/03/2019 11:10,2018,2017,B,Other Reporting Airports,GUERNSEY,GATWICK,331221,331221,0,319759,319759,0,3.58457
03/03/2019 11:10,2018,2017,B,Other Reporting Airports,GUERNSEY,GLASGOW,1370,1370,0,0,0,0,0
03/03/2019 11:10,2018,2017,B,Other Reporting Airports,GUERNSEY,JERSEY,101837,100950,887,100960,100643,317,0.86866
03/03/2019 11:10,2018,2017,B,Other Reporting Airports,GUERNSEY,LEEDS BRADFORD,5951,5951,0,10597,10597,0,-43.8426
03/03/2019 11:10,2018,2017,B,Other Reporting Airports,GUERNSEY,LONDON CITY,0,0,0,21446,21446,0,-100
03/03/2019 11:10,2018,2017,B,Other Reporting Airports,GUERNSEY,MANCHESTER,66760,66760,0,62826,62826,0,6.26174
03/03/2019 11:10,2018,2017,B,Other Reporting Airports,GUERNSEY,NORWICH,1133,1133,0,1218,1218,0,-6.97865
03/03/2019 11:10,2018,2017,B,Other Reporting Airports,GUERNSEY,SOUTHAMPTON,119533,119533,0,117244,117244,0,1.95234
03/03/2019 11:10,2018,2017,B,Other Reporting Airports,GUERNSEY,STANSTED,27692,27692,0,25685,25685,0,7.8139
03/03/2019 11:10,2018,2017,B,Other Reporting Airports,HAWARDEN,ANGLESEY (VALLEY),12,12,0,0,0,0,0
03/03/2019 11:10,2018,2017,B,Other Reporting Airports,HUMBERSIDE,ABERDEEN,19742,19723,19,20365,20365,0,-3.05917
03/03/2019 11:10,2018,2017,B,Other Reporting Airports,HUMBERSIDE,BIGGIN HILL,0,0,0,59,0,59,-100
03/03/2019 11:10,2018,2017,B,Other Reporting Airports,HUMBERSIDE,BIRMINGHAM,66,0,66,0,0,0,0
03/03/2019 11:10,2018,2017,B,Other Reporting Airports,HUMBERSIDE,BOURNEMOUTH,0,0,0,91,91,0,-100
03/03/2019 11:10,2018,2017,B,Other Reporting Airports,HUMBERSIDE,BRISTOL,113,0,113,84,0,84,34.52381
03/03/2019 11:10,2018,2017,B,Other Reporting Airports,HUMBERSIDE,CARDIFF WALES,114,0,114,71,0,71,60.56338
03/03/2019 11:10,2018,2017,B,Other Reporting Airports,HUMBERSIDE,CONINGSBY,0,0,0,26,26,0,-100
03/03/2019 11:10,2018,2017,B,Other Reporting Airports,HUMBERSIDE,DURHAM TEES VALLEY,1359,1359,0,1561,1561,0,-12.94042
03/03/2019 11:10,2018,2017,B,Other Reporting Airports,HUMBERSIDE,EXETER,68,0,68,0,0,0,0
03/03/2019 11:10,2018,2017,B,Other Reporting Airports,HUMBERSIDE,FARNBOROUGH,53,0,53,61,32,29,-13.11475
03/03/2019 11:10,2018,2017,B,Other Reporting Airports,HUMBERSIDE,GATWICK,0,0,0,35,35,0,-100
03/03/2019 11:10,2018,2017,B,Other Reporting Airports,HUMBERSIDE,ISLE OF MAN,0,0,0,52,26,26,-100
03/03/2019 11:10,2018,2017,B,Other Reporting Airports,HUMBERSIDE,JERSEY,2263,337,1926,2236,2236,0,1.20751
03/03/2019 11:10,2018,2017,B,Other Reporting Airports,HUMBERSIDE,LEEDS BRADFORD,67,67,0,66,44,22,1.51515
03/03/2019 11:10,2018,2017,B,Other Reporting Airports,HUMBERSIDE,LUTON,0,0,0,235,0,235,-100
03/03/2019 11:10,2018,2017,B,Other Reporting Airports,HUMBERSIDE,MARHAM(KINGS LYNN),63,63,0,61,61,0,3.27869
03/03/2019 11:10,2018,2017,B,Other Reporting Airports,HUMBERSIDE,NEWCASTLE,10,10,0,54,54,0,-81.48148
03/03/2019 11:10,2018,2017,B,Other Reporting Airports,HUMBERSIDE,NORWICH,28,28,0,139,38,101,-79.85612
03/03/2019 11:10,2018,2017,B,Other Reporting Airports,HUMBERSIDE,SOUTHAMPTON,123,58,65,131,95,36,-6.10687
03/03/2019 11:10,2018,2017,B,Other Reporting Airports,HUMBERSIDE,WADDINGTON,0,0,0,13,13,0,-100
03/03/2019 11:10,2018,2017,B,Other Reporting Airports,HUMBERSIDE,WARTON,229,229,0,384,361,23,-40.36458
03/03/2019 11:10,2018,2017,B,Other Reporting Airports,INVERNESS,ABERDEEN,160,160,0,253,253,0,-36.75889
03/03/2019 11:10,2018,2017,B,Other Reporting Airports,INVERNESS,BELFAST CITY (GEORGE BEST),36166,36166,0,32984,32984,0,9.6471
03/03/2019 11:10,2018,2017,B,Other Reporting Airports,INVERNESS,BELFAST INTERNATIONAL,0,0,0,73,73,0,-100
03/03/2019 11:10,2018,2017,B,Other Reporting Airports,INVERNESS,BENBECULA,71,71,0,69,69,0,2.89855
03/03/2019 11:10,2018,2017,B,Other Reporting Airports,INVERNESS,BIRMINGHAM,45155,45155,0,44215,44215,0,2.12598
03/03/2019 11:10,2018,2017,B,Other Reporting Airports,INVERNESS,BRISTOL,93306,93306,0,96676,96676,0,-3.48587
03/03/2019 11:10,2018,2017,B,Other Reporting Airports,INVERNESS,EDINBURGH,23,23,0,225,225,0,-89.77778
03/03/2019 11:10,2018,2017,B,Other Reporting Airports,INVERNESS,GATWICK,261838,261838,0,263682,263682,0,-0.69933
03/03/2019 11:10,2018,2017,B,Other Reporting Airports,INVERNESS,GLASGOW,11,11,0,68,68,0,-83.82353
03/03/2019 11:10,2018,2017,B,Other Reporting Airports,INVERNESS,HEATHROW,97321,97321,0,78957,78957,0,23.25823
03/03/2019 11:10,2018,2017,B,Other Reporting Airports,INVERNESS,JERSEY,1811,1811,0,2000,2000,0,-9.45
03/03/2019 11:10,2018,2017,B,Other Reporting Airports,INVERNESS,KIRKWALL,22634,22634,0,23681,23681,0,-4.42127
03/03/2019 11:10,2018,2017,B,Other Reporting Airports,INVERNESS,LUTON,146894,146894,0,136498,136498,0,7.61623
03/03/2019 11:10,2018,2017,B,Other Reporting Airports,INVERNESS,MANCHESTER,56693,56693,0,65629,65629,0,-13.61593
03/03/2019 11:10,2018,2017,B,Other Reporting Airports,INVERNESS,SCATSTA,0,0,0,29,29,0,-100
03/03/2019 11:10,2018,2017,B,Other Reporting Airports,INVERNESS,STORNOWAY,27574,27574,0,29223,29223,0,-5.64282
03/03/2019 11:10,2018,2017,B,Other Reporting Airports,INVERNESS,SUMBURGH,63,63,0,978,978,0,-93.55828
03/03/2019 11:10,2018,2017,B,Other Reporting Airports,ISLAY,BENBECULA,9,9,0,0,0,0,0
03/03/2019 11:10,2018,2017,B,Other Reporting Airports,ISLAY,CAMPBELTOWN,13,13,0,17,17,0,-23.52941
03/03/2019 11:10,2018,2017,B,Other Reporting Airports,ISLAY,COLONSAY,364,364,0,58,58,0,527.58621
03/03/2019 11:10,2018,2017,B,Other Reporting Airports,ISLAY,GLASGOW,31889,31889,0,31860,31860,0,0.09102
03/03/2019 11:10,2018,2017,B,Other Reporting Airports,ISLAY,OBAN (NORTH CONNEL),208,208,0,38,38,0,447.36842
03/03/2019 11:10,2018,2017,B,Other Reporting Airports,ISLAY,TIREE,25,25,0,38,38,0,-34.21053
03/03/2019 11:10,2018,2017,B,Other Reporting Airports,ISLE OF MAN,BELFAST CITY (GEORGE BEST),4152,4152,0,12220,12034,186,-66.02291
03/03/2019 11:10,2018,2017,B,Other Reporting Airports,ISLE OF MAN,BELFAST INTERNATIONAL,12977,12977,0,0,0,0,0
03/03/2019 11:10,2018,2017,B,Other Reporting Airports,ISLE OF MAN,BIRMINGHAM,42800,42708,92,44216,44216,0,-3.20246
03/03/2019 11:10,2018,2017,B,Other Reporting Airports,ISLE OF MAN,BLACKPOOL,0,0,0,1849,1849,0,-100
03/03/2019 11:10,2018,2017,B,Other Reporting Airports,ISLE OF MAN,BRISTOL,29657,29657,0,26797,26797,0,10.67284
03/03/2019 11:10,2018,2017,B,Other Reporting Airports,ISLE OF MAN,DURHAM TEES VALLEY,0,0,0,7,7,0,-100
03/03/2019 11:10,2018,2017,B,Other Reporting Airports,ISLE OF MAN,EDINBURGH,6183,6110,73,3477,3477,0,77.82571
03/03/2019 11:10,2018,2017,B,Other Reporting Airports,ISLE OF MAN,FARNBOROUGH,0,0,0,145,0,145,-100
03/03/2019 11:10,2018,2017,B,Other Reporting Airports,ISLE OF MAN,GATWICK,175844,175844,0,171291,171291,0,2.65805
03/03/2019 11:10,2018,2017,B,Other Reporting Airports,ISLE OF MAN,GLASGOW,2003,2003,0,5408,5365,43,-62.96228
03/03/2019 11:10,2018,2017,B,Other Reporting Airports,ISLE OF MAN,GLOUCESTERSHIRE,0,0,0,1420,1420,0,-100
03/03/2019 11:10,2018,2017,B,Other Reporting Airports,ISLE OF MAN,HUMBERSIDE,0,0,0,76,0,76,-100
03/03/2019 11:10,2018,2017,B,Other Reporting Airports,ISLE OF MAN,INVERNESS,91,0,91,0,0,0,0
03/03/2019 11:10,2018,2017,B,Other Reporting Airports,ISLE OF MAN,LEEDS BRADFORD,0,0,0,63,63,0,-100
03/03/2019 11:10,2018,2017,B,Other Reporting Airports,ISLE OF MAN,LIVERPOOL (JOHN LENNON),255659,255659,0,229510,229366,144,11.3934
03/03/2019 11:10,2018,2017,B,Other Reporting Airports,ISLE OF MAN,LONDON CITY,61430,61430,0,61995,61995,0,-0.91136
03/03/2019 11:10,2018,2017,B,Other Reporting Airports,ISLE OF MAN,LUTON,23260,23260,0,16877,16877,0,37.8207
03/03/2019 11:10,2018,2017,B,Other Reporting Airports,ISLE OF MAN,MANCHESTER,172822,172379,443,166142,166142,0,4.02066
03/03/2019 11:10,2018,2017,B,Other Reporting Airports,ISLE OF MAN,NEWCASTLE,227,227,0,3463,3463,0,-93.44499
03/03/2019 11:10,2018,2017,B,Other Reporting Airports,ISLE OF MAN,NORWICH,134,134,0,49,0,49,173.46939
03/03/2019 11:10,2018,2017,B,Other Reporting Airports,ISLE OF MAN,PRESTWICK,18,18,0,54,54,0,-66.66667
03/03/2019 11:10,2018,2017,B,Other Reporting Airports,ISLE OF MAN,SOUTHEND,0,0,0,81,81,0,-100
03/03/2019 11:10,2018,2017,B,Other Reporting Airports,JERSEY,ABERDEEN,2525,2525,0,2755,2755,0,-8.34846
03/03/2019 11:10,2018,2017,B,Other Reporting Airports,JERSEY,ALDERNEY,0,0,0,210,210,0,-100
03/03/2019 11:10,2018,2017,B,Other Reporting Airports,JERSEY,BELFAST INTERNATIONAL,20461,20461,0,20294,20294,0,0.8229
03/03/2019 11:10,2018,2017,B,Other Reporting Airports,JERSEY,BIGGIN HILL,78,0,78,0,0,0,0
03/03/2019 11:10,2018,2017,B,Other Reporting Airports,JERSEY,BIRMINGHAM,67756,67756,0,71370,71370,0,-5.06375
03/03/2019 11:10,2018,2017,B,Other Reporting Airports,JERSEY,BLACKBUSHE,0,0,0,2,2,0,-100
03/03/2019 11:10,2018,2017,B,Other Reporting Airports,JERSEY,BOURNEMOUTH,0,0,0,148,148,0,-100
03/03/2019 11:10,2018,2017,B,Other Reporting Airports,JERSEY,BRISTOL,26167,26167,0,26518,26518,0,-1.32363
03/03/2019 11:10,2018,2017,B,Other Reporting Airports,JERSEY,CARDIFF WALES,19705,19705,0,16838,16838,0,17.02696
03/03/2019 11:10,2018,2017,B,Other Reporting Airports,JERSEY,DONCASTER SHEFFIELD,30674,30674,0,30268,30268,0,1.34135
03/03/2019 11:10,2018,2017,B,Other Reporting Airports,JERSEY,DURHAM TEES VALLEY,2539,2539,0,2561,2561,0,-0.85904
03/03/2019 11:10,2018,2017,B,Other Reporting Airports,JERSEY,EAST MIDLANDS INTERNATIONAL,35861,35861,0,35400,35400,0,1.30226
03/03/2019 11:10,2018,2017,B,Other Reporting Airports,JERSEY,EDINBURGH,19579,19579,0,5405,5405,0,262.23867
03/03/2019 11:10,2018,2017,B,Other Reporting Airports,JERSEY,EXETER,34250,34250,0,48001,48001,0,-28.64732
03/03/2019 11:10,2018,2017,B,Other Reporting Airports,JERSEY,GATWICK,659986,659986,0,659086,659086,0,0.13655
03/03/2019 11:10,2018,2017,B,Other Reporting Airports,JERSEY,GLASGOW,54086,54086,0,54824,54824,0,-1.34613
03/03/2019 11:10,2018,2017,B,Other Reporting Airports,JERSEY,GUERNSEY,106202,106021,181,89711,89711,0,18.38236
03/03/2019 11:10,2018,2017,B,Other Reporting Airports,JERSEY,HUMBERSIDE,2268,2268,0,2228,2228,0,1.79533
03/03/2019 11:10,2018,2017,B,Other Reporting Airports,JERSEY,INVERNESS,1807,1807,0,1943,1943,0,-6.99949
03/03/2019 11:10,2018,2017,B,Other Reporting Airports,JERSEY,LEEDS BRADFORD,13897,13897,0,13426,13426,0,3.50812
03/03/2019 11:10,2018,2017,B,Other Reporting Airports,JERSEY,LIVERPOOL (JOHN LENNON),135030,135030,0,128627,128627,0,4.97796
03/03/2019 11:10,2018,2017,B,Other Reporting Airports,JERSEY,LONDON CITY,34799,34799,0,35531,35531,0,-2.06017
03/03/2019 11:10,2018,2017,B,Other Reporting Airports,JERSEY,LUTON,47700,47700,0,46368,46368,0,2.87267
03/03/2019 11:10,2018,2017,B,Other Reporting Airports,JERSEY,MANCHESTER,46744,46744,0,44705,44705,0,4.56101
03/03/2019 11:10,2018,2017,B,Other Reporting Airports,JERSEY,NEWCASTLE,26019,26019,0,23804,23804,0,9.30516
03/03/2019 11:10,2018,2017,B,Other Reporting Airports,JERSEY,NEWQUAY,0,0,0,301,301,0,-100
03/03/2019 11:10,2018,2017,B,Other Reporting Airports,JERSEY,NORWICH,6185,6185,0,6197,6197,0,-0.19364
03/03/2019 11:10,2018,2017,B,Other Reporting Airports,JERSEY,SOUTHAMPTON,169369,169369,0,167482,167482,0,1.12669
03/03/2019 11:10,2018,2017,B,Other Reporting Airports,JERSEY,SOUTHEND,30613,30613,0,25685,25685,0,19.1863
03/03/2019 11:10,2018,2017,B,Other Reporting Airports,KIRKWALL,ABERDEEN,56807,56807,0,54464,54464,0,4.30192
03/03/2019 11:10,2018,2017,B,Other Reporting Airports,KIRKWALL,DUNDEE,0,0,0,23,23,0,-100
03/03/2019 11:10,2018,2017,B,Other Reporting Airports,KIRKWALL,EDAY,523,523,0,578,578,0,-9.51557
03/03/2019 11:10,2018,2017,B,Other Reporting Airports,KIRKWALL,EDINBURGH,45955,45955,0,46482,46482,0,-1.13377
03/03/2019 11:10,2018,2017,B,Other Reporting Airports,KIRKWALL,FAIR ISLE,179,179,0,74,74,0,141.89189
03/03/2019 11:10,2018,2017,B,Other Reporting Airports,KIRKWALL,GLASGOW,22239,22239,0,19410,19410,0,14.57496
03/03/2019 11:10,2018,2017,B,Other Reporting Airports,KIRKWALL,INVERNESS,11436,11436,0,11395,11395,0,0.35981
03/03/2019 11:10,2018,2017,B,Other Reporting Airports,KIRKWALL,MANCHESTER,1097,1097,0,0,0,0,0
03/03/2019 11:10,2018,2017,B,Other Reporting Airports,KIRKWALL,NORTH RONALDSAY,5953,5953,0,6285,6285,0,-5.28242
03/03/2019 11:10,2018,2017,B,Other Reporting Airports,KIRKWALL,PAPA WESTRAY,4885,4885,0,5115,5115,0,-4.49658
03/03/2019 11:10,2018,2017,B,Other Reporting Airports,KIRKWALL,PRESTWICK,13,13,0,0,0,0,0
03/03/2019 11:10,2018,2017,B,Other Reporting Airports,KIRKWALL,SANDAY,2994,2994,0,3083,3083,0,-2.8868
03/03/2019 11:10,2018,2017,B,Other Reporting Airports,KIRKWALL,STRONSAY,3527,3527,0,3324,3324,0,6.1071
03/03/2019 11:10,2018,2017,B,Other Reporting Airports,KIRKWALL,SUMBURGH,9611,9611,0,9885,9885,0,-2.77188
03/03/2019 11:10,2018,2017,B,Other Reporting Airports,KIRKWALL,WESTRAY,3542,3542,0,3615,3615,0,-2.01936
03/03/2019 11:10,2018,2017,B,Other Reporting Airports,KIRKWALL,WICK JOHN O GROATS,0,0,0,10,10,0,-100
03/03/2019 11:10,2018,2017,B,Other Reporting Airports,LEEDS BRADFORD,ABERDEEN,5749,5696,53,14658,14658,0,-60.7791
03/03/2019 11:10,2018,2017,B,Other Reporting Airports,LEEDS BRADFORD,BELFAST CITY (GEORGE BEST),165491,165491,0,166267,166265,2,-0.46672
03/03/2019 11:10,2018,2017,B,Other Reporting Airports,LEEDS BRADFORD,BIRMINGHAM,0,0,0,4,0,4,-100
03/03/2019 11:10,2018,2017,B,Other Reporting Airports,LEEDS BRADFORD,BRISTOL,0,0,0,66,0,66,-100
03/03/2019 11:10,2018,2017,B,Other Reporting Airports,LEEDS BRADFORD,CARDIFF WALES,0,0,0,102,0,102,-100
03/03/2019 11:10,2018,2017,B,Other Reporting Airports,LEEDS BRADFORD,DONCASTER SHEFFIELD,0,0,0,73,73,0,-100
03/03/2019 11:10,2018,2017,B,Other Reporting Airports,LEEDS BRADFORD,DURHAM TEES VALLEY,35,35,0,0,0,0,0
03/03/2019 11:10,2018,2017,B,Other Reporting Airports,LEEDS BRADFORD,EDINBURGH,147,147,0,0,0,0,0
03/03/2019 11:10,2018,2017,B,Other Reporting Airports,LEEDS BRADFORD,EXETER,0,0,0,120,120,0,-100
03/03/2019 11:10,2018,2017,B,Other Reporting Airports,LEEDS BRADFORD,GATWICK,0,0,0,187,0,187,-100
03/03/2019 11:10,2018,2017,B,Other Reporting Airports,LEEDS BRADFORD,GLASGOW,0,0,0,7013,7013,0,-100
03/03/2019 11:10,2018,2017,B,Other Reporting Airports,LEEDS BRADFORD,GUERNSEY,5909,5909,0,10295,10295,0,-42.60321
03/03/2019 11:10,2018,2017,B,Other Reporting Airports,LEEDS BRADFORD,HEATHROW,103038,103038,0,161238,161238,0,-36.09571
03/03/2019 11:10,2018,2017,B,Other Reporting Airports,LEEDS BRADFORD,HUMBERSIDE,23,23,0,47,47,0,-51.06383
03/03/2019 11:10,2018,2017,B,Other Reporting Airports,LEEDS BRADFORD,INVERNESS,0,0,0,54,54,0,-100
03/03/2019 11:10,2018,2017,B,Other Reporting Airports,LEEDS BRADFORD,ISLE OF MAN,0,0,0,210,210,0,-100
03/03/2019 11:10,2018,2017,B,Other Reporting Airports,LEEDS BRADFORD,JERSEY,13778,13778,0,13440,13440,0,2.51488
03/03/2019 11:10,2018,2017,B,Other Reporting Airports,LEEDS BRADFORD,LIVERPOOL (JOHN LENNON),0,0,0,178,178,0,-100
03/03/2019 11:10,2018,2017,B,Other Reporting Airports,LEEDS BRADFORD,LONDON CITY,46,46,0,2,0,2,2200
03/03/2019 11:10,2018,2017,B,Other Reporting Airports,LEEDS BRADFORD,MANCHESTER,45,45,0,425,425,0,-89.41176
03/03/2019 11:10,2018,2017,B,Other Reporting Airports,LEEDS BRADFORD,NEWCASTLE,10,10,0,168,168,0,-94.04762
03/03/2019 11:10,2018,2017,B,Other Reporting Airports,LEEDS BRADFORD,NEWQUAY,23034,23034,0,27294,27294,0,-15.60783
03/03/2019 11:10,2018,2017,B,Other Reporting Airports,LEEDS BRADFORD,NORTHOLT,0,0,0,14,0,14,-100
03/03/2019 11:10,2018,2017,B,Other Reporting Airports,LEEDS BRADFORD,NORWICH,46,26,20,50,37,13,-8
03/03/2019 11:10,2018,2017,B,Other Reporting Airports,LEEDS BRADFORD,SOUTHAMPTON,34354,34331,23,34803,34677,126,-1.29012
03/03/2019 11:10,2018,2017,B,Other Reporting Airports,LERWICK (TINGWALL),CUMBERNAULD,1,1,0,0,0,0,0
03/03/2019 11:10,2018,2017,B,Other Reporting Airports,LERWICK (TINGWALL),FAIR ISLE,2670,2670,0,2774,2774,0,-3.7491
03/03/2019 11:10,2018,2017,B,Other Reporting Airports,LERWICK (TINGWALL),FOULA,1176,1176,0,1298,1298,0,-9.39908
03/03/2019 11:10,2018,2017,B,Other Reporting Airports,LERWICK (TINGWALL),PAPA STOUR,30,30,0,65,65,0,-53.84615
03/03/2019 11:10,2018,2017,B,Other Reporting Airports,LERWICK (TINGWALL),SUMBURGH,4,4,0,2,2,0,100
03/03/2019 11:10,2018,2017,B,Other Reporting Airports,LIVERPOOL (JOHN LENNON),BELFAST CITY (GEORGE BEST),28805,28805,0,34925,34925,0,-17.52326
03/03/2019 11:10,2018,2017,B,Other Reporting Airports,LIVERPOOL (JOHN LENNON),BELFAST INTERNATIONAL,496483,496483,0,486782,486782,0,1.99288
03/03/2019 11:10,2018,2017,B,Other Reporting Airports,LIVERPOOL (JOHN LENNON),BIGGIN HILL,70,0,70,271,0,271,-74.16974
03/03/2019 11:10,2018,2017,B,Other Reporting Airports,LIVERPOOL (JOHN LENNON),BIRMINGHAM,0,0,0,106,106,0,-100
03/03/2019 11:10,2018,2017,B,Other Reporting Airports,LIVERPOOL (JOHN LENNON),BOURNEMOUTH,421,0,421,595,0,595,-29.2437
03/03/2019 11:10,2018,2017,B,Other Reporting Airports,LIVERPOOL (JOHN LENNON),BRISTOL,0,0,0,74,34,40,-100
03/03/2019 11:10,2018,2017,B,Other Reporting Airports,LIVERPOOL (JOHN LENNON),CARDIFF WALES,308,0,308,232,0,232,32.75862
03/03/2019 11:10,2018,2017,B,Other Reporting Airports,LIVERPOOL (JOHN LENNON),CITY OF DERRY (EGLINTON),57052,57052,0,51446,51446,0,10.89686
03/03/2019 11:10,2018,2017,B,Other Reporting Airports,LIVERPOOL (JOHN LENNON),DONCASTER SHEFFIELD,103,103,0,163,163,0,-36.80982
03/03/2019 11:10,2018,2017,B,Other Reporting Airports,LIVERPOOL (JOHN LENNON),DURHAM TEES VALLEY,0,0,0,76,0,76,-100
03/03/2019 11:10,2018,2017,B,Other Reporting Airports,LIVERPOOL (JOHN LENNON),EAST MIDLANDS INTERNATIONAL,80,0,80,211,0,211,-62.08531
03/03/2019 11:10,2018,2017,B,Other Reporting Airports,LIVERPOOL (JOHN LENNON),EDINBURGH,172,172,0,2,2,0,8500
03/03/2019 11:10,2018,2017,B,Other Reporting Airports,LIVERPOOL (JOHN LENNON),EXETER,0,0,0,80,0,80,-100
03/03/2019 11:10,2018,2017,B,Other Reporting Airports,LIVERPOOL (JOHN LENNON),FARNBOROUGH,101,0,101,190,0,190,-46.84211
03/03/2019 11:10,2018,2017,B,Other Reporting Airports,LIVERPOOL (JOHN LENNON),GATWICK,632,168,464,255,41,214,147.84314
03/03/2019 11:10,2018,2017,B,Other Reporting Airports,LIVERPOOL (JOHN LENNON),GLASGOW,0,0,0,2,2,0,-100
03/03/2019 11:10,2018,2017,B,Other Reporting Airports,LIVERPOOL (JOHN LENNON),HEATHROW,3,3,0,516,516,0,-99.4186
03/03/2019 11:10,2018,2017,B,Other Reporting Airports,LIVERPOOL (JOHN LENNON),HUMBERSIDE,0,0,0,84,0,84,-100
03/03/2019 11:10,2018,2017,B,Other Reporting Airports,LIVERPOOL (JOHN LENNON),INVERNESS,0,0,0,22,2,20,-100
03/03/2019 11:10,2018,2017,B,Other Reporting Airports,LIVERPOOL (JOHN LENNON),ISLE OF MAN,255416,255416,0,228974,228974,0,11.54804
03/03/2019 11:10,2018,2017,B,Other Reporting Airports,LIVERPOOL (JOHN LENNON),JERSEY,137338,137338,0,129877,129877,0,5.74467
03/03/2019 11:10,2018,2017,B,Other Reporting Airports,LIVERPOOL (JOHN LENNON),LONDON CITY,8,8,0,38,0,38,-78.94737
03/03/2019 11:10,2018,2017,B,Other Reporting Airports,LIVERPOOL (JOHN LENNON),LUTON,619,0,619,867,0,867,-28.60438
03/03/2019 11:10,2018,2017,B,Other Reporting Airports,LIVERPOOL (JOHN LENNON),MANCHESTER,1,1,0,0,0,0,0
03/03/2019 11:10,2018,2017,B,Other Reporting Airports,LIVERPOOL (JOHN LENNON),NEWCASTLE,218,0,218,298,0,298,-26.84564
03/03/2019 11:10,2018,2017,B,Other Reporting Airports,LIVERPOOL (JOHN LENNON),NEWQUAY,1837,1837,0,1543,1543,0,19.05379
03/03/2019 11:10,2018,2017,B,Other Reporting Airports,LIVERPOOL (JOHN LENNON),NORWICH,71,0,71,0,0,0,0
03/03/2019 11:10,2018,2017,B,Other Reporting Airports,LIVERPOOL (JOHN LENNON),SOUTHAMPTON,226,0,226,505,96,409,-55.24752
03/03/2019 11:10,2018,2017,B,Other Reporting Airports,LIVERPOOL (JOHN LENNON),SOUTHEND,230,0,230,28,28,0,721.42857
03/03/2019 11:10,2018,2017,B,Other Reporting Airports,LIVERPOOL (JOHN LENNON),STANSTED,289,1,288,431,0,431,-32.94664
03/03/2019 11:10,2018,2017,B,Other Reporting Airports,MANCHESTER,ABERDEEN,216176,215869,307,205639,205639,0,5.12403
03/03/2019 11:10,2018,2017,B,Other Reporting Airports,MANCHESTER,BELFAST CITY (GEORGE BEST),278716,278716,0,285675,285675,0,-2.43598
03/03/2019 11:10,2018,2017,B,Other Reporting Airports,MANCHESTER,BELFAST INTERNATIONAL,368944,368923,21,263221,263207,14,40.16511
03/03/2019 11:10,2018,2017,B,Other Reporting Airports,MANCHESTER,BENBECULA,0,0,0,211,211,0,-100
03/03/2019 11:10,2018,2017,B,Other Reporting Airports,MANCHESTER,BIRMINGHAM,181,143,38,669,669,0,-72.94469
03/03/2019 11:10,2018,2017,B,Other Reporting Airports,MANCHESTER,BOURNEMOUTH,0,0,0,49,0,49,-100
03/03/2019 11:10,2018,2017,B,Other Reporting Airports,MANCHESTER,BRISTOL,828,502,326,297,297,0,178.78788
03/03/2019 11:10,2018,2017,B,Other Reporting Airports,MANCHESTER,CAMBRIDGE,1950,1950,0,173,173,0,1027.16763
03/03/2019 11:10,2018,2017,B,Other Reporting Airports,MANCHESTER,CARDIFF WALES,81,0,81,320,138,182,-74.6875
03/03/2019 11:10,2018,2017,B,Other Reporting Airports,MANCHESTER,COTSWOLD APT - KEMBLE,320,320,0,0,0,0,0
03/03/2019 11:10,2018,2017,B,Other Reporting Airports,MANCHESTER,EAST MIDLANDS INTERNATIONAL,409,409,0,140,0,140,192.14286
03/03/2019 11:10,2018,2017,B,Other Reporting Airports,MANCHESTER,EDINBURGH,116373,116326,47,117243,117243,0,-0.74205
03/03/2019 11:10,2018,2017,B,Other Reporting Airports,MANCHESTER,EXETER,128748,128748,0,128820,128735,85,-0.05589
03/03/2019 11:10,2018,2017,B,Other Reporting Airports,MANCHESTER,FARNBOROUGH,39,0,39,0,0,0,0
03/03/2019 11:10,2018,2017,B,Other Reporting Airports,MANCHESTER,GATWICK,490,256,234,96,0,96,410.41667
03/03/2019 11:10,2018,2017,B,Other Reporting Airports,MANCHESTER,GLASGOW,62609,62346,263,48920,48724,196,27.98242
03/03/2019 11:10,2018,2017,B,Other Reporting Airports,MANCHESTER,GUERNSEY,66612,66610,2,62893,62893,0,5.91322
03/03/2019 11:10,2018,2017,B,Other Reporting Airports,MANCHESTER,HEATHROW,651256,651256,0,660219,660190,29,-1.35758
03/03/2019 11:10,2018,2017,B,Other Reporting Airports,MANCHESTER,INVERNESS,50563,50563,0,62299,62299,0,-18.83818
03/03/2019 11:10,2018,2017,B,Other Reporting Airports,MANCHESTER,ISLE OF MAN,172197,171760,437,165279,165279,0,4.18565
03/03/2019 11:10,2018,2017,B,Other Reporting Airports,MANCHESTER,JERSEY,47163,47163,0,44572,44572,0,5.81307
03/03/2019 11:10,2018,2017,B,Other Reporting Airports,MANCHESTER,KIRKWALL,1070,1070,0,1066,1066,0,0.37523
03/03/2019 11:10,2018,2017,B,Other Reporting Airports,MANCHESTER,LEEDS BRADFORD,499,499,0,226,226,0,120.79646
03/03/2019 11:10,2018,2017,B,Other Reporting Airports,MANCHESTER,LIVERPOOL (JOHN LENNON),531,531,0,1347,1347,0,-60.57906
03/03/2019 11:10,2018,2017,B,Other Reporting Airports,MANCHESTER,LONDON CITY,3818,3818,0,2197,2197,0,73.78243
03/03/2019 11:10,2018,2017,B,Other Reporting Airports,MANCHESTER,LUTON,755,379,376,141,1,140,435.46099
03/03/2019 11:10,2018,2017,B,Other Reporting Airports,MANCHESTER,LYDD,0,0,0,59,0,59,-100
03/03/2019 11:10,2018,2017,B,Other Reporting Airports,MANCHESTER,NEWCASTLE,37,37,0,232,232,0,-84.05172
03/03/2019 11:10,2018,2017,B,Other Reporting Airports,MANCHESTER,NEWQUAY,83413,83413,0,85012,85012,0,-1.88091
03/03/2019 11:10,2018,2017,B,Other Reporting Airports,MANCHESTER,NORWICH,19940,19940,0,26450,26209,241,-24.61248
03/03/2019 11:10,2018,2017,B,Other Reporting Airports,MANCHESTER,PRESTWICK,101,41,60,39,39,0,158.97436
03/03/2019 11:10,2018,2017,B,Other Reporting Airports,MANCHESTER,SOUTHAMPTON,220742,220599,143,203162,202793,369,8.65319
03/03/2019 11:10,2018,2017,B,Other Reporting Airports,MANCHESTER,SOUTHEND,52263,52123,140,7611,7534,77,586.67718
03/03/2019 11:10,2018,2017,B,Other Reporting Airports,MANCHESTER,STANSTED,873,545,328,92,92,0,848.91304
03/03/2019 11:10,2018,2017,B,Other Reporting Airports,MANCHESTER,STORNOWAY,778,778,0,6613,6613,0,-88.23529
03/03/2019 11:10,2018,2017,B,Other Reporting Airports,MANCHESTER,SUMBURGH,802,802,0,414,414,0,93.71981
03/03/2019 11:10,2018,2017,B,Other Reporting Airports,NEWCASTLE,ABERDEEN,16357,16261,96,19165,19165,0,-14.65171
03/03/2019 11:10,2018,2017,B,Other Reporting Airports,NEWCASTLE,BELFAST CITY (GEORGE BEST),3143,3143,0,0,0,0,0
03/03/2019 11:10,2018,2017,B,Other Reporting Airports,NEWCASTLE,BELFAST INTERNATIONAL,267753,267753,0,258275,258275,0,3.66973
03/03/2019 11:10,2018,2017,B,Other Reporting Airports,NEWCASTLE,BIGGIN HILL,41,0,41,0,0,0,0
03/03/2019 11:10,2018,2017,B,Other Reporting Airports,NEWCASTLE,BIRMINGHAM,259,0,259,412,0,412,-37.13592
03/03/2019 11:10,2018,2017,B,Other Reporting Airports,NEWCASTLE,BOURNEMOUTH,80,0,80,190,0,190,-57.89474
03/03/2019 11:10,2018,2017,B,Other Reporting Airports,NEWCASTLE,BRISTOL,188809,188596,213,169020,168640,380,11.70808
03/03/2019 11:10,2018,2017,B,Other Reporting Airports,NEWCASTLE,CARDIFF WALES,11167,10909,258,13680,13301,379,-18.36988
03/03/2019 11:10,2018,2017,B,Other Reporting Airports,NEWCASTLE,DURHAM TEES VALLEY,2,2,0,6,0,6,-66.66667
03/03/2019 11:10,2018,2017,B,Other Reporting Airports,NEWCASTLE,EAST MIDLANDS INTERNATIONAL,158,0,158,215,0,215,-26.51163
03/03/2019 11:10,2018,2017,B,Other Reporting Airports,NEWCASTLE,EDINBURGH,0,0,0,151,0,151,-100
03/03/2019 11:10,2018,2017,B,Other Reporting Airports,NEWCASTLE,EXETER,45076,45076,0,42177,42097,80,6.87341
03/03/2019 11:10,2018,2017,B,Other Reporting Airports,NEWCASTLE,FARNBOROUGH,45,0,45,80,0,80,-43.75
03/03/2019 11:10,2018,2017,B,Other Reporting Airports,NEWCASTLE,GATWICK,172,0,172,235,0,235,-26.80851
03/03/2019 11:10,2018,2017,B,Other Reporting Airports,NEWCASTLE,GLASGOW,0,0,0,100,8,92,-100
03/03/2019 11:10,2018,2017,B,Other Reporting Airports,NEWCASTLE,HEATHROW,493845,493800,45,489140,488882,258,0.96189
03/03/2019 11:10,2018,2017,B,Other Reporting Airports,NEWCASTLE,ISLE OF MAN,664,664,0,5633,5633,0,-88.21232
03/03/2019 11:10,2018,2017,B,Other Reporting Airports,NEWCASTLE,JERSEY,26493,26493,0,23976,23976,0,10.498
03/03/2019 11:10,2018,2017,B,Other Reporting Airports,NEWCASTLE,LEEDS BRADFORD,81,0,81,0,0,0,0
03/03/2019 11:10,2018,2017,B,Other Reporting Airports,NEWCASTLE,LIVERPOOL (JOHN LENNON),150,0,150,348,0,348,-56.89655
03/03/2019 11:10,2018,2017,B,Other Reporting Airports,NEWCASTLE,LUTON,291,0,291,413,0,413,-29.53995
03/03/2019 11:10,2018,2017,B,Other Reporting Airports,NEWCASTLE,MANCHESTER,208,0,208,442,0,442,-52.94118
03/03/2019 11:10,2018,2017,B,Other Reporting Airports,NEWCASTLE,NEWQUAY,1976,1976,0,2038,2038,0,-3.0422
03/03/2019 11:10,2018,2017,B,Other Reporting Airports,NEWCASTLE,NORWICH,0,0,0,170,0,170,-100
03/03/2019 11:10,2018,2017,B,Other Reporting Airports,NEWCASTLE,OXFORD (KIDLINGTON),80,0,80,80,0,80,0
03/03/2019 11:10,2018,2017,B,Other Reporting Airports,NEWCASTLE,SOUTHAMPTON,116613,116513,100,130256,130054,202,-10.47399
03/03/2019 11:10,2018,2017,B,Other Reporting Airports,NEWCASTLE,SOUTHEND,40,0,40,0,0,0,0
03/03/2019 11:10,2018,2017,B,Other Reporting Airports,NEWCASTLE,STANSTED,40,0,40,504,0,504,-92.06349
03/03/2019 11:10,2018,2017,B,Other Reporting Airports,NEWQUAY,ABERDEEN,1790,1790,0,1556,1556,0,15.03856
03/03/2019 11:10,2018,2017,B,Other Reporting Airports,NEWQUAY,BELFAST CITY (GEORGE BEST),3311,3311,0,3642,3642,0,-9.08841
03/03/2019 11:10,2018,2017,B,Other Reporting Airports,NEWQUAY,BIRMINGHAM,23682,23682,0,27230,27230,0,-13.02975
03/03/2019 11:10,2018,2017,B,Other Reporting Airports,NEWQUAY,DONCASTER SHEFFIELD,7099,7099,0,6696,6696,0,6.01852
03/03/2019 11:10,2018,2017,B,Other Reporting Airports,NEWQUAY,EDINBURGH,4453,4453,0,5057,5057,0,-11.94384
03/03/2019 11:10,2018,2017,B,Other Reporting Airports,NEWQUAY,EXETER,17,17,0,115,115,0,-85.21739
03/03/2019 11:10,2018,2017,B,Other Reporting Airports,NEWQUAY,GATWICK,173662,173662,0,162574,162574,0,6.82028
03/03/2019 11:10,2018,2017,B,Other Reporting Airports,NEWQUAY,GLASGOW,2042,2042,0,3109,3109,0,-34.31972
03/03/2019 11:10,2018,2017,B,Other Reporting Airports,NEWQUAY,GUERNSEY,0,0,0,22,22,0,-100
03/03/2019 11:10,2018,2017,B,Other Reporting Airports,NEWQUAY,ISLES OF SCILLY (ST.MARYS),18431,18431,0,20046,20046,0,-8.05647
03/03/2019 11:10,2018,2017,B,Other Reporting Airports,NEWQUAY,JERSEY,0,0,0,12,12,0,-100
03/03/2019 11:10,2018,2017,B,Other Reporting Airports,NEWQUAY,LANDS END (ST JUST),45,45,0,54,54,0,-16.66667
03/03/2019 11:10,2018,2017,B,Other Reporting Airports,NEWQUAY,LEEDS BRADFORD,23477,23477,0,27741,27741,0,-15.37075
03/03/2019 11:10,2018,2017,B,Other Reporting Airports,NEWQUAY,LIVERPOOL (JOHN LENNON),1866,1866,0,1570,1570,0,18.8535
03/03/2019 11:10,2018,2017,B,Other Reporting Airports,NEWQUAY,MANCHESTER,84582,84582,0,86526,86526,0,-2.24672
03/03/2019 11:10,2018,2017,B,Other Reporting Airports,NEWQUAY,NEWCASTLE,2021,2021,0,2163,2163,0,-6.56496
03/03/2019 11:10,2018,2017,B,Other Reporting Airports,NEWQUAY,STANSTED,5645,5645,0,21495,21495,0,-73.73808
03/03/2019 11:10,2018,2017,B,Other Reporting Airports,NORWICH,ABERDEEN,41603,41603,0,42998,41171,1827,-3.24434
03/03/2019 11:10,2018,2017,B,Other Reporting Airports,NORWICH,BIRMINGHAM,250,0,250,40,0,40,525
03/03/2019 11:10,2018,2017,B,Other Reporting Airports,NORWICH,BOURNEMOUTH,29,29,0,0,0,0,0
03/03/2019 11:10,2018,2017,B,Other Reporting Airports,NORWICH,BRISTOL,84,0,84,0,0,0,0
03/03/2019 11:10,2018,2017,B,Other Reporting Airports,NORWICH,CARDIFF WALES,151,0,151,39,0,39,287.17949
03/03/2019 11:10,2018,2017,B,Other Reporting Airports,NORWICH,CITY OF DERRY (EGLINTON),26,0,26,0,0,0,0
03/03/2019 11:10,2018,2017,B,Other Reporting Airports,NORWICH,CONINGSBY,7,7,0,0,0,0,0
03/03/2019 11:10,2018,2017,B,Other Reporting Airports,NORWICH,DURHAM TEES VALLEY,72,0,72,110,76,34,-34.54545
03/03/2019 11:10,2018,2017,B,Other Reporting Airports,NORWICH,EDINBURGH,29665,29665,0,28350,28350,0,4.63845
03/03/2019 11:10,2018,2017,B,Other Reporting Airports,NORWICH,EXETER,30121,30121,0,26957,26824,133,11.73721
03/03/2019 11:10,2018,2017,B,Other Reporting Airports,NORWICH,FARNBOROUGH,0,0,0,82,32,50,-100
03/03/2019 11:10,2018,2017,B,Other Reporting Airports,NORWICH,GAMSTON,0,0,0,2,2,0,-100
03/03/2019 11:10,2018,2017,B,Other Reporting Airports,NORWICH,GLASGOW,578,578,0,1638,1638,0,-64.71306
03/03/2019 11:10,2018,2017,B,Other Reporting Airports,NORWICH,GUERNSEY,1083,0,1083,1214,1214,0,-10.79077
03/03/2019 11:10,2018,2017,B,Other Reporting Airports,NORWICH,HUMBERSIDE,59,59,0,79,79,0,-25.31646
03/03/2019 11:10,2018,2017,B,Other Reporting Airports,NORWICH,ISLE OF MAN,101,101,0,0,0,0,0
03/03/2019 11:10,2018,2017,B,Other Reporting Airports,NORWICH,JERSEY,6131,6131,0,6132,6132,0,-0.01631
03/03/2019 11:10,2018,2017,B,Other Reporting Airports,NORWICH,LEEDS BRADFORD,0,0,0,36,36,0,-100
03/03/2019 11:10,2018,2017,B,Other Reporting Airports,NORWICH,MANCHESTER,19348,19291,57,24634,24600,34,-21.45815
03/03/2019 11:10,2018,2017,B,Other Reporting Airports,NORWICH,NEWCASTLE,0,0,0,64,64,0,-100
03/03/2019 11:10,2018,2017,B,Other Reporting Airports,NORWICH,WARTON,10,10,0,0,0,0,0
03/03/2019 11:10,2018,2017,B,Other Reporting Airports,OXFORD (KIDLINGTON),NEWCASTLE,0,0,0,90,90,0,-100
03/03/2019 11:10,2018,2017,B,Other Reporting Airports,PRESTWICK,BELFAST CITY (GEORGE BEST),77,0,77,0,0,0,0
03/03/2019 11:10,2018,2017,B,Other Reporting Airports,PRESTWICK,BELFAST INTERNATIONAL,0,0,0,50,0,50,-100
03/03/2019 11:10,2018,2017,B,Other Reporting Airports,PRESTWICK,BIRMINGHAM,58,0,58,0,0,0,0
03/03/2019 11:10,2018,2017,B,Other Reporting Airports,PRESTWICK,BRISTOL,0,0,0,293,0,293,-100
03/03/2019 11:10,2018,2017,B,Other Reporting Airports,PRESTWICK,CARDIFF WALES,0,0,0,308,0,308,-100
03/03/2019 11:10,2018,2017,B,Other Reporting Airports,PRESTWICK,EAST MIDLANDS INTERNATIONAL,0,0,0,66,0,66,-100
03/03/2019 11:10,2018,2017,B,Other Reporting Airports,PRESTWICK,EXETER,126,0,126,0,0,0,0
03/03/2019 11:10,2018,2017,B,Other Reporting Airports,PRESTWICK,FARNBOROUGH,0,0,0,56,0,56,-100
03/03/2019 11:10,2018,2017,B,Other Reporting Airports,PRESTWICK,GATWICK,0,0,0,139,0,139,-100
03/03/2019 11:10,2018,2017,B,Other Reporting Airports,PRESTWICK,KIRKWALL,0,0,0,16,0,16,-100
03/03/2019 11:10,2018,2017,B,Other Reporting Airports,PRESTWICK,LONDON CITY,0,0,0,69,0,69,-100
03/03/2019 11:10,2018,2017,B,Other Reporting Airports,PRESTWICK,LUTON,0,0,0,156,0,156,-100
03/03/2019 11:10,2018,2017,B,Other Reporting Airports,PRESTWICK,STANSTED,0,0,0,494,0,494,-100
03/03/2019 11:10,2018,2017,B,Other Reporting Airports,PRESTWICK,STORNOWAY,148,0,148,0,0,0,0
03/03/2019 11:10,2018,2017,B,Other Reporting Airports,PRESTWICK,SUMBURGH,43,0,43,0,0,0,0
03/03/2019 11:10,2018,2017,B,Other Reporting Airports,SOUTHAMPTON,ABERDEEN,12810,12810,0,27800,27800,0,-53.92086
03/03/2019 11:10,2018,2017,B,Other Reporting Airports,SOUTHAMPTON,ALDERNEY,23928,23928,0,24553,24553,0,-2.54551
03/03/2019 11:10,2018,2017,B,Other Reporting Airports,SOUTHAMPTON,BELFAST CITY (GEORGE BEST),129961,129961,0,120078,120043,35,8.23048
03/03/2019 11:10,2018,2017,B,Other Reporting Airports,SOUTHAMPTON,BIRMINGHAM,125,125,0,145,108,37,-13.7931
03/03/2019 11:10,2018,2017,B,Other Reporting Airports,SOUTHAMPTON,BRISTOL,6,6,0,0,0,0,0
03/03/2019 11:10,2018,2017,B,Other Reporting Airports,SOUTHAMPTON,CARDIFF WALES,75,0,75,90,0,90,-16.66667
03/03/2019 11:10,2018,2017,B,Other Reporting Airports,SOUTHAMPTON,CITY OF DERRY (EGLINTON),0,0,0,6,0,6,-100
03/03/2019 11:10,2018,2017,B,Other Reporting Airports,SOUTHAMPTON,DONCASTER SHEFFIELD,22,22,0,87,87,0,-74.71264
03/03/2019 11:10,2018,2017,B,Other Reporting Airports,SOUTHAMPTON,DURHAM TEES VALLEY,0,0,0,131,0,131,-100
03/03/2019 11:10,2018,2017,B,Other Reporting Airports,SOUTHAMPTON,EAST MIDLANDS INTERNATIONAL,115,55,60,596,535,61,-80.7047
03/03/2019 11:10,2018,2017,B,Other Reporting Airports,SOUTHAMPTON,EDINBURGH,183140,183140,0,209098,208959,139,-12.41427
03/03/2019 11:10,2018,2017,B,Other Reporting Airports,SOUTHAMPTON,EXETER,0,0,0,627,627,0,-100
03/03/2019 11:10,2018,2017,B,Other Reporting Airports,SOUTHAMPTON,GLASGOW,186513,186513,0,197100,197100,0,-5.37139
03/03/2019 11:10,2018,2017,B,Other Reporting Airports,SOUTHAMPTON,GUERNSEY,119907,119907,0,117947,117947,0,1.66176
03/03/2019 11:10,2018,2017,B,Other Reporting Airports,SOUTHAMPTON,HUMBERSIDE,0,0,0,86,11,75,-100
03/03/2019 11:10,2018,2017,B,Other Reporting Airports,SOUTHAMPTON,JERSEY,172883,172846,37,169718,169586,132,1.86486
03/03/2019 11:10,2018,2017,B,Other Reporting Airports,SOUTHAMPTON,LEEDS BRADFORD,24620,24532,88,10758,10596,162,128.85295
03/03/2019 11:10,2018,2017,B,Other Reporting Airports,SOUTHAMPTON,LIVERPOOL (JOHN LENNON),321,20,301,410,0,410,-21.70732
03/03/2019 11:10,2018,2017,B,Other Reporting Airports,SOUTHAMPTON,LONDON CITY,120,120,0,124,124,0,-3.22581
03/03/2019 11:10,2018,2017,B,Other Reporting Airports,SOUTHAMPTON,MANCHESTER,224004,223453,551,206126,205403,723,8.67334
03/03/2019 11:10,2018,2017,B,Other Reporting Airports,SOUTHAMPTON,NEWCASTLE,117410,117292,118,131144,130939,205,-10.47246
03/03/2019 11:10,2018,2017,B,Other Reporting Airports,SOUTHAMPTON,NEWQUAY,50,50,0,0,0,0,0
03/03/2019 11:10,2018,2017,B,Other Reporting Airports,SOUTHAMPTON,NORWICH,0,0,0,152,0,152,-100
03/03/2019 11:10,2018,2017,B,Other Reporting Airports,SOUTHAMPTON,SOUTHEND,84,0,84,53,0,53,58.49057
03/03/2019 11:10,2018,2017,B,Other Reporting Airports,STORNOWAY,ABERDEEN,5999,5999,0,4852,4852,0,23.63974
03/03/2019 11:10,2018,2017,B,Other Reporting Airports,STORNOWAY,BENBECULA,7024,7024,0,6886,6886,0,2.00407
03/03/2019 11:10,2018,2017,B,Other Reporting Airports,STORNOWAY,EDINBURGH,18406,18406,0,17571,17571,0,4.75215
03/03/2019 11:10,2018,2017,B,Other Reporting Airports,STORNOWAY,GLASGOW,75449,75449,0,74626,74626,0,1.10283
03/03/2019 11:10,2018,2017,B,Other Reporting Airports,STORNOWAY,INVERNESS,25913,25913,0,28045,28045,0,-7.60207
03/03/2019 11:10,2018,2017,B,Other Reporting Airports,STORNOWAY,MANCHESTER,518,518,0,0,0,0,0
03/03/2019 11:10,2018,2017,B,Other Reporting Airports,STORNOWAY,WICK JOHN O GROATS,0,0,0,24,24,0,-100
03/03/2019 11:10,2018,2017,B,Other Reporting Airports,SUMBURGH,ABERDEEN,73294,73294,0,83390,83390,0,-12.10697
03/03/2019 11:10,2018,2017,B,Other Reporting Airports,SUMBURGH,DUNDEE,0,0,0,17,17,0,-100
03/03/2019 11:10,2018,2017,B,Other Reporting Airports,SUMBURGH,EDINBURGH,48134,48134,0,47674,47674,0,0.96489
03/03/2019 11:10,2018,2017,B,Other Reporting Airports,SUMBURGH,FAIR ISLE,72,72,0,96,96,0,-25
03/03/2019 11:10,2018,2017,B,Other Reporting Airports,SUMBURGH,GLASGOW,28821,28821,0,32977,32977,0,-12.60272
03/03/2019 11:10,2018,2017,B,Other Reporting Airports,SUMBURGH,INVERNESS,34,34,0,920,920,0,-96.30435
03/03/2019 11:10,2018,2017,B,Other Reporting Airports,SUMBURGH,KIRKWALL,21249,21249,0,22662,22662,0,-6.23511
03/03/2019 11:10,2018,2017,B,Other Reporting Airports,SUMBURGH,LERWICK (TINGWALL),15,15,0,7,7,0,114.28571
03/03/2019 11:10,2018,2017,B,Other Reporting Airports,SUMBURGH,MANCHESTER,799,799,0,0,0,0,0
03/03/2019 11:10,2018,2017,B,Other Reporting Airports,SUMBURGH,PRESTWICK,16,16,0,0,0,0,0
03/03/2019 11:10,2018,2017,B,Other Reporting Airports,TIREE,CAMPBELTOWN,25,25,0,63,63,0,-60.31746
03/03/2019 11:10,2018,2017,B,Other Reporting Airports,TIREE,COLL,489,489,0,155,155,0,215.48387
03/03/2019 11:10,2018,2017,B,Other Reporting Airports,TIREE,GLASGOW,11284,11284,0,11031,11031,0,2.29354
03/03/2019 11:10,2018,2017,B,Other Reporting Airports,TIREE,ISLAY,7,7,0,54,54,0,-87.03704
03/03/2019 11:10,2018,2017,B,Other Reporting Airports,TIREE,OBAN (NORTH CONNEL),469,469,0,138,138,0,239.85507
03/03/2019 11:10,2018,2017,B,Other Reporting Airports,TIREE,PRESTWICK,11,11,0,0,0,0,0
03/03/2019 11:10,2018,2017,B,Other Reporting Airports,WICK JOHN O GROATS,ABERDEEN,7407,7407,0,6642,6642,0,11.51762
03/03/2019 11:10,2018,2017,B,Other Reporting Airports,WICK JOHN O GROATS,EDINBURGH,9273,9273,0,11011,11011,0,-15.78422
03/03/2019 11:10,2018,2017,B,Other Reporting Airports,WICK JOHN O GROATS,KIRKWALL,0,0,0,7,7,0,-100
03/03/2019 11:10,2018,2017,B,Other Reporting Airports,WICK JOHN O GROATS,STORNOWAY,0,0,0,7,7,0,-100
03/03/2019 11:10,2018,2017,B,Other Reporting Airports,WICK JOHN O GROATS,SUMBURGH,0,0,0,1,1,0,-100

