rundate,report_period,region_num,foreign_region,foreign_country,uk_group,uk_apt,foreign_apt,ty_t_pax,ty_s_pax,ty_c_pax,ly_t_pax,ly_s_pax,ly_c_pax,pc_change
03/03/2019 11:05,2018,,Unknown,Unknown,1,GATWICK,Unknown,0,0,0,32,0,32,-100
03/03/2019 11:05,2018,,Unknown,Unknown,2,BELFAST CITY (GEORGE BEST),Unknown,0,0,0,1330,0,1330,-100
03/03/2019 11:05,2018,,Unknown,Unknown,2,BELFAST INTERNATIONAL,Unknown,0,0,0,145,0,145,-100
03/03/2019 11:05,2018,,Unknown,Unknown,2,BRISTOL,Unknown,0,0,0,10693,0,10693,-100
03/03/2019 11:05,2018,,Unknown,Unknown,2,CARDIFF WALES,Unknown,0,0,0,36,0,36,-100
03/03/2019 11:05,2018,,Unknown,Unknown,2,LEEDS BRADFORD,Unknown,0,0,0,5030,5030,0,-100
03/03/2019 11:05,2018,,Unknown,Unknown,2,MANCHESTER,Unknown,10,10,0,10271,8214,2057,-99.90264
03/03/2019 11:05,2018,,Unknown,Unknown,2,NEWCASTLE,Unknown,0,0,0,119,0,119,-100
03/03/2019 11:05,2018,,Unknown,Unknown,2,SOUTHAMPTON,Unknown,0,0,0,20,20,0,-100
03/03/2019 11:05,2018,1,WESTERN EUROPE-EU,AUSTRIA,1,GATWICK,INNSBRUCK,200652,176646,24006,209084,183664,25420,-4.03283
03/03/2019 11:05,2018,1,WESTERN EUROPE-EU,AUSTRIA,1,GATWICK,KLAGENFURT,5758,5758,0,838,838,0,587.11217
03/03/2019 11:05,2018,1,WESTERN EUROPE-EU,AUSTRIA,1,GATWICK,LINZ,172,172,0,0,0,0,0
03/03/2019 11:05,2018,1,WESTERN EUROPE-EU,AUSTRIA,1,GATWICK,SALZBURG,137514,118512,19002,144593,125057,19536,-4.89581
03/03/2019 11:05,2018,1,WESTERN EUROPE-EU,AUSTRIA,1,GATWICK,VIENNA,265519,265519,0,223828,223828,0,18.62636
03/03/2019 11:05,2018,1,WESTERN EUROPE-EU,AUSTRIA,1,HEATHROW,INNSBRUCK,54962,54962,0,34573,34573,0,58.97377
03/03/2019 11:05,2018,1,WESTERN EUROPE-EU,AUSTRIA,1,HEATHROW,SALZBURG,33855,33855,0,13566,13231,335,149.55772
03/03/2019 11:05,2018,1,WESTERN EUROPE-EU,AUSTRIA,1,HEATHROW,VIENNA,840882,840882,0,807858,807858,0,4.08785
03/03/2019 11:05,2018,1,WESTERN EUROPE-EU,AUSTRIA,1,LUTON,GRAZ,401,0,401,819,0,819,-51.03785
03/03/2019 11:05,2018,1,WESTERN EUROPE-EU,AUSTRIA,1,LUTON,INNSBRUCK,13975,13975,0,8515,8515,0,64.12214
03/03/2019 11:05,2018,1,WESTERN EUROPE-EU,AUSTRIA,1,LUTON,LINZ,218,218,0,190,0,190,14.73684
03/03/2019 11:05,2018,1,WESTERN EUROPE-EU,AUSTRIA,1,LUTON,SALZBURG,11521,8215,3306,11107,7648,3459,3.72738
03/03/2019 11:05,2018,1,WESTERN EUROPE-EU,AUSTRIA,1,LUTON,VIENNA,63564,63564,0,64044,64008,36,-0.74948
03/03/2019 11:05,2018,1,WESTERN EUROPE-EU,AUSTRIA,1,SOUTHEND,VIENNA,16884,16884,0,13375,13375,0,26.23551
03/03/2019 11:05,2018,1,WESTERN EUROPE-EU,AUSTRIA,1,STANSTED,GRAZ,0,0,0,502,0,502,-100
03/03/2019 11:05,2018,1,WESTERN EUROPE-EU,AUSTRIA,1,STANSTED,INNSBRUCK,8794,946,7848,7775,0,7775,13.10611
03/03/2019 11:05,2018,1,WESTERN EUROPE-EU,AUSTRIA,1,STANSTED,LINZ,26776,26776,0,34039,33929,110,-21.33729
03/03/2019 11:05,2018,1,WESTERN EUROPE-EU,AUSTRIA,1,STANSTED,SALZBURG,150737,146304,4433,105552,101419,4133,42.80828
03/03/2019 11:05,2018,1,WESTERN EUROPE-EU,AUSTRIA,1,STANSTED,VIENNA,104876,104876,0,86559,85566,993,21.16129
03/03/2019 11:05,2018,1,WESTERN EUROPE-EU,AUSTRIA,2,BELFAST CITY (GEORGE BEST),SALZBURG,1975,0,1975,3562,0,3562,-44.55362
03/03/2019 11:05,2018,1,WESTERN EUROPE-EU,AUSTRIA,2,BELFAST INTERNATIONAL,SALZBURG,5098,1584,3514,411,0,411,1140.38929
03/03/2019 11:05,2018,1,WESTERN EUROPE-EU,AUSTRIA,2,BELFAST INTERNATIONAL,VIENNA,562,296,266,293,293,0,91.80887
03/03/2019 11:05,2018,1,WESTERN EUROPE-EU,AUSTRIA,2,BIRMINGHAM,GRAZ,1859,1344,515,8312,8101,211,-77.63474
03/03/2019 11:05,2018,1,WESTERN EUROPE-EU,AUSTRIA,2,BIRMINGHAM,INNSBRUCK,15687,0,15687,17869,3312,14557,-12.21109
03/03/2019 11:05,2018,1,WESTERN EUROPE-EU,AUSTRIA,2,BIRMINGHAM,SALZBURG,16343,5555,10788,15578,5569,10009,4.91077
03/03/2019 11:05,2018,1,WESTERN EUROPE-EU,AUSTRIA,2,BIRMINGHAM,VIENNA,37621,37621,0,34626,34626,0,8.64957
03/03/2019 11:05,2018,1,WESTERN EUROPE-EU,AUSTRIA,2,BIRMINGHAM,ZELTWEG (MILITARY),0,0,0,44,0,44,-100
03/03/2019 11:05,2018,1,WESTERN EUROPE-EU,AUSTRIA,2,BOURNEMOUTH,VIENNA,0,0,0,159,159,0,-100
03/03/2019 11:05,2018,1,WESTERN EUROPE-EU,AUSTRIA,2,BRISTOL,INNSBRUCK,22220,10334,11886,21568,9709,11859,3.023
03/03/2019 11:05,2018,1,WESTERN EUROPE-EU,AUSTRIA,2,BRISTOL,SALZBURG,13240,8678,4562,13366,9031,4335,-0.94269
03/03/2019 11:05,2018,1,WESTERN EUROPE-EU,AUSTRIA,2,BRISTOL,VIENNA,31024,31024,0,30902,30902,0,0.3948
03/03/2019 11:05,2018,1,WESTERN EUROPE-EU,AUSTRIA,2,CARDIFF WALES,SALZBURG,39,0,39,0,0,0,0
03/03/2019 11:05,2018,1,WESTERN EUROPE-EU,AUSTRIA,2,CARDIFF WALES,VIENNA,0,0,0,396,155,241,-100
03/03/2019 11:05,2018,1,WESTERN EUROPE-EU,AUSTRIA,2,DONCASTER SHEFFIELD,SALZBURG,0,0,0,119,0,119,-100
03/03/2019 11:05,2018,1,WESTERN EUROPE-EU,AUSTRIA,2,DURHAM TEES VALLEY,GRAZ,50,0,50,0,0,0,0
03/03/2019 11:05,2018,1,WESTERN EUROPE-EU,AUSTRIA,2,DURHAM TEES VALLEY,LINZ,36,0,36,0,0,0,0
03/03/2019 11:05,2018,1,WESTERN EUROPE-EU,AUSTRIA,2,EAST MIDLANDS INTERNATIONAL,KLAGENFURT,0,0,0,102,0,102,-100
03/03/2019 11:05,2018,1,WESTERN EUROPE-EU,AUSTRIA,2,EAST MIDLANDS INTERNATIONAL,SALZBURG,6670,3314,3356,6936,3236,3700,-3.83506
03/03/2019 11:05,2018,1,WESTERN EUROPE-EU,AUSTRIA,2,EDINBURGH,INNSBRUCK,10976,0,10976,11058,0,11058,-0.74154
03/03/2019 11:05,2018,1,WESTERN EUROPE-EU,AUSTRIA,2,EDINBURGH,LINZ,296,0,296,0,0,0,0
03/03/2019 11:05,2018,1,WESTERN EUROPE-EU,AUSTRIA,2,EDINBURGH,SALZBURG,6818,4138,2680,5980,5296,684,14.01338
03/03/2019 11:05,2018,1,WESTERN EUROPE-EU,AUSTRIA,2,EDINBURGH,VIENNA,66234,66234,0,64196,64104,92,3.17465
03/03/2019 11:05,2018,1,WESTERN EUROPE-EU,AUSTRIA,2,EXETER,GRAZ,0,0,0,59,0,59,-100
03/03/2019 11:05,2018,1,WESTERN EUROPE-EU,AUSTRIA,2,EXETER,INNSBRUCK,0,0,0,367,367,0,-100
03/03/2019 11:05,2018,1,WESTERN EUROPE-EU,AUSTRIA,2,EXETER,LINZ,0,0,0,151,0,151,-100
03/03/2019 11:05,2018,1,WESTERN EUROPE-EU,AUSTRIA,2,EXETER,VIENNA,0,0,0,280,140,140,-100
03/03/2019 11:05,2018,1,WESTERN EUROPE-EU,AUSTRIA,2,GLASGOW,GRAZ,106,0,106,291,0,291,-63.57388
03/03/2019 11:05,2018,1,WESTERN EUROPE-EU,AUSTRIA,2,GLASGOW,LINZ,243,0,243,379,0,379,-35.88391
03/03/2019 11:05,2018,1,WESTERN EUROPE-EU,AUSTRIA,2,GLASGOW,SALZBURG,7592,0,7592,6524,0,6524,16.37032
03/03/2019 11:05,2018,1,WESTERN EUROPE-EU,AUSTRIA,2,GLASGOW,VIENNA,2933,716,2217,1263,0,1263,132.22486
03/03/2019 11:05,2018,1,WESTERN EUROPE-EU,AUSTRIA,2,HUMBERSIDE,VIENNA,92,0,92,0,0,0,0
03/03/2019 11:05,2018,1,WESTERN EUROPE-EU,AUSTRIA,2,JERSEY,VIENNA,696,0,696,945,0,945,-26.34921
03/03/2019 11:05,2018,1,WESTERN EUROPE-EU,AUSTRIA,2,LEEDS BRADFORD,INNSBRUCK,2536,0,2536,1446,0,1446,75.38036
03/03/2019 11:05,2018,1,WESTERN EUROPE-EU,AUSTRIA,2,LEEDS BRADFORD,SALZBURG,4019,4019,0,5462,4893,569,-26.41889
03/03/2019 11:05,2018,1,WESTERN EUROPE-EU,AUSTRIA,2,LEEDS BRADFORD,VIENNA,360,360,0,280,280,0,28.57143
03/03/2019 11:05,2018,1,WESTERN EUROPE-EU,AUSTRIA,2,LIVERPOOL (JOHN LENNON),GRAZ,121,0,121,0,0,0,0
03/03/2019 11:05,2018,1,WESTERN EUROPE-EU,AUSTRIA,2,LIVERPOOL (JOHN LENNON),SALZBURG,4937,4937,0,4781,4781,0,3.26292
03/03/2019 11:05,2018,1,WESTERN EUROPE-EU,AUSTRIA,2,MANCHESTER,INNSBRUCK,41091,17523,23568,48389,24168,24221,-15.08194
03/03/2019 11:05,2018,1,WESTERN EUROPE-EU,AUSTRIA,2,MANCHESTER,SALZBURG,36254,16147,20107,34097,13954,20143,6.32607
03/03/2019 11:05,2018,1,WESTERN EUROPE-EU,AUSTRIA,2,MANCHESTER,VIENNA,108527,108388,139,101116,101116,0,7.32921
03/03/2019 11:05,2018,1,WESTERN EUROPE-EU,AUSTRIA,2,NEWCASTLE,INNSBRUCK,4200,4168,32,4537,4537,0,-7.42782
03/03/2019 11:05,2018,1,WESTERN EUROPE-EU,AUSTRIA,2,NEWCASTLE,SALZBURG,7445,7299,146,7887,7817,70,-5.60416
03/03/2019 11:05,2018,1,WESTERN EUROPE-EU,AUSTRIA,2,NEWCASTLE,VIENNA,705,705,0,361,361,0,95.29086
03/03/2019 11:05,2018,1,WESTERN EUROPE-EU,AUSTRIA,2,SOUTHAMPTON,INNSBRUCK,0,0,0,786,0,786,-100
03/03/2019 11:05,2018,1,WESTERN EUROPE-EU,BELGIUM,1,GATWICK,ANTWERP,0,0,0,45,45,0,-100
03/03/2019 11:05,2018,1,WESTERN EUROPE-EU,BELGIUM,1,GATWICK,BRUSSELS,12304,12304,0,2240,2240,0,449.28571
03/03/2019 11:05,2018,1,WESTERN EUROPE-EU,BELGIUM,1,HEATHROW,BRUSSELS,672319,672319,0,651009,651009,0,3.27338
03/03/2019 11:05,2018,1,WESTERN EUROPE-EU,BELGIUM,1,LONDON CITY,ANTWERP,27525,27525,0,50564,50564,0,-45.56404
03/03/2019 11:05,2018,1,WESTERN EUROPE-EU,BELGIUM,1,LONDON CITY,BRUSSELS,67,67,0,0,0,0,0
03/03/2019 11:05,2018,1,WESTERN EUROPE-EU,BELGIUM,1,LONDON CITY,OSTEND,71,71,0,39,0,39,82.05128
03/03/2019 11:05,2018,1,WESTERN EUROPE-EU,BELGIUM,1,LUTON,ANTWERP,42,0,42,0,0,0,0
03/03/2019 11:05,2018,1,WESTERN EUROPE-EU,BELGIUM,1,LUTON,OSTEND,13,0,13,108,0,108,-87.96296
03/03/2019 11:05,2018,1,WESTERN EUROPE-EU,BELGIUM,1,SOUTHEND,ANTWERP,13246,13246,0,43,43,0,30704.65116
03/03/2019 11:05,2018,1,WESTERN EUROPE-EU,BELGIUM,1,STANSTED,BRUSSELS,0,0,0,366,366,0,-100
03/03/2019 11:05,2018,1,WESTERN EUROPE-EU,BELGIUM,2,ABERDEEN,ANTWERP,1279,1279,0,0,0,0,0
03/03/2019 11:05,2018,1,WESTERN EUROPE-EU,BELGIUM,2,BELFAST CITY (GEORGE BEST),BRUSSELS,0,0,0,3865,3865,0,-100
03/03/2019 11:05,2018,1,WESTERN EUROPE-EU,BELGIUM,2,BELFAST INTERNATIONAL,ANTWERP,0,0,0,37,0,37,-100
03/03/2019 11:05,2018,1,WESTERN EUROPE-EU,BELGIUM,2,BIRMINGHAM,ANTWERP,2179,2179,0,0,0,0,0
03/03/2019 11:05,2018,1,WESTERN EUROPE-EU,BELGIUM,2,BIRMINGHAM,BRUSSELS,141497,141408,89,152510,152510,0,-7.22117
03/03/2019 11:05,2018,1,WESTERN EUROPE-EU,BELGIUM,2,BRISTOL,BRUSSELS,55115,55115,0,60470,60470,0,-8.85563
03/03/2019 11:05,2018,1,WESTERN EUROPE-EU,BELGIUM,2,BRISTOL,LIEGE,2,2,0,0,0,0,0
03/03/2019 11:05,2018,1,WESTERN EUROPE-EU,BELGIUM,2,CARDIFF WALES,BRUSSELS,19,19,0,178,178,0,-89.32584
03/03/2019 11:05,2018,1,WESTERN EUROPE-EU,BELGIUM,2,DONCASTER SHEFFIELD,BRUSSELS,0,0,0,48,0,48,-100
03/03/2019 11:05,2018,1,WESTERN EUROPE-EU,BELGIUM,2,EAST MIDLANDS INTERNATIONAL,BRUSSELS,26631,26631,0,23034,23034,0,15.61605
03/03/2019 11:05,2018,1,WESTERN EUROPE-EU,BELGIUM,2,EDINBURGH,BRUSSELS,137002,136816,186,107943,107427,516,26.92069
03/03/2019 11:05,2018,1,WESTERN EUROPE-EU,BELGIUM,2,EDINBURGH,CHARLEROI,75304,75304,0,76543,76543,0,-1.6187
03/03/2019 11:05,2018,1,WESTERN EUROPE-EU,BELGIUM,2,EXETER,BRUSSELS,0,0,0,99,92,7,-100
03/03/2019 11:05,2018,1,WESTERN EUROPE-EU,BELGIUM,2,GLASGOW,ANTWERP,0,0,0,100,0,100,-100
03/03/2019 11:05,2018,1,WESTERN EUROPE-EU,BELGIUM,2,GLASGOW,BRUSSELS,132,0,132,1182,0,1182,-88.83249
03/03/2019 11:05,2018,1,WESTERN EUROPE-EU,BELGIUM,2,GLASGOW,CHARLEROI,26077,26077,0,30645,30645,0,-14.90618
03/03/2019 11:05,2018,1,WESTERN EUROPE-EU,BELGIUM,2,GLASGOW,LIEGE,88,0,88,0,0,0,0
03/03/2019 11:05,2018,1,WESTERN EUROPE-EU,BELGIUM,2,ISLE OF MAN,LIEGE,0,0,0,29,0,29,-100
03/03/2019 11:05,2018,1,WESTERN EUROPE-EU,BELGIUM,2,JERSEY,ANTWERP,0,0,0,42,42,0,-100
03/03/2019 11:05,2018,1,WESTERN EUROPE-EU,BELGIUM,2,LIVERPOOL (JOHN LENNON),BRUSSELS,186,0,186,0,0,0,0
03/03/2019 11:05,2018,1,WESTERN EUROPE-EU,BELGIUM,2,MANCHESTER,ANTWERP,173,0,173,0,0,0,0
03/03/2019 11:05,2018,1,WESTERN EUROPE-EU,BELGIUM,2,MANCHESTER,BRUSSELS,232161,232113,48,215347,213779,1568,7.80786
03/03/2019 11:05,2018,1,WESTERN EUROPE-EU,BELGIUM,2,MANCHESTER,CHARLEROI,174343,174343,0,180907,180907,0,-3.62838
03/03/2019 11:05,2018,1,WESTERN EUROPE-EU,BELGIUM,2,NEWCASTLE,BRUSSELS,28248,28248,0,24038,24038,0,17.51394
03/03/2019 11:05,2018,1,WESTERN EUROPE-EU,BELGIUM,2,PRESTWICK,BRUSSELS,0,0,0,83,0,83,-100
03/03/2019 11:05,2018,1,WESTERN EUROPE-EU,BELGIUM,2,SOUTHAMPTON,LIEGE,61,0,61,0,0,0,0
03/03/2019 11:05,2018,1,WESTERN EUROPE-EU,BELGIUM,2,SOUTHAMPTON,OSTEND,0,0,0,44,0,44,-100
03/03/2019 11:05,2018,1,WESTERN EUROPE-EU,CROATIA,1,GATWICK,DUBROVNIK,219074,218779,295,239366,238974,392,-8.47739
03/03/2019 11:05,2018,1,WESTERN EUROPE-EU,CROATIA,1,GATWICK,PULA,43821,20112,23709,35321,19221,16100,24.065
03/03/2019 11:05,2018,1,WESTERN EUROPE-EU,CROATIA,1,GATWICK,SPLIT,177874,161290,16584,153495,144972,8523,15.8826
03/03/2019 11:05,2018,1,WESTERN EUROPE-EU,CROATIA,1,GATWICK,ZAGREB,374,374,0,22260,22260,0,-98.31986
03/03/2019 11:05,2018,1,WESTERN EUROPE-EU,CROATIA,1,HEATHROW,PULA,7245,7245,0,7107,7107,0,1.94175
03/03/2019 11:05,2018,1,WESTERN EUROPE-EU,CROATIA,1,HEATHROW,RIJEKA,0,0,0,4043,4043,0,-100
03/03/2019 11:05,2018,1,WESTERN EUROPE-EU,CROATIA,1,HEATHROW,SPLIT,31201,31201,0,32607,32607,0,-4.31196
03/03/2019 11:05,2018,1,WESTERN EUROPE-EU,CROATIA,1,HEATHROW,ZAGREB,140534,140534,0,166287,166287,0,-15.48708
03/03/2019 11:05,2018,1,WESTERN EUROPE-EU,CROATIA,1,LUTON,DUBROVNIK,21951,21951,0,24462,24462,0,-10.2649
03/03/2019 11:05,2018,1,WESTERN EUROPE-EU,CROATIA,1,LUTON,SPLIT,87825,87825,0,72525,72525,0,21.09617
03/03/2019 11:05,2018,1,WESTERN EUROPE-EU,CROATIA,1,LUTON,ZADAR,14770,14770,0,10671,10671,0,38.41252
03/03/2019 11:05,2018,1,WESTERN EUROPE-EU,CROATIA,1,SOUTHEND,DUBROVNIK,15553,15553,0,5985,5985,0,159.86633
03/03/2019 11:05,2018,1,WESTERN EUROPE-EU,CROATIA,1,SOUTHEND,PULA,7209,7209,0,0,0,0,0
03/03/2019 11:05,2018,1,WESTERN EUROPE-EU,CROATIA,1,SOUTHEND,ZADAR,3894,3894,0,4905,4905,0,-20.61162
03/03/2019 11:05,2018,1,WESTERN EUROPE-EU,CROATIA,1,STANSTED,DUBROVNIK,84188,84188,0,70277,69456,821,19.79453
03/03/2019 11:05,2018,1,WESTERN EUROPE-EU,CROATIA,1,STANSTED,PULA,34895,34895,0,37701,37701,0,-7.44277
03/03/2019 11:05,2018,1,WESTERN EUROPE-EU,CROATIA,1,STANSTED,RIJEKA,6042,6042,0,11620,11620,0,-48.00344
03/03/2019 11:05,2018,1,WESTERN EUROPE-EU,CROATIA,1,STANSTED,SPLIT,44179,44179,0,37704,37704,0,17.17324
03/03/2019 11:05,2018,1,WESTERN EUROPE-EU,CROATIA,1,STANSTED,ZADAR,37323,32364,4959,41773,36346,5427,-10.65281
03/03/2019 11:05,2018,1,WESTERN EUROPE-EU,CROATIA,2,BELFAST INTERNATIONAL,DUBROVNIK,18559,18469,90,17049,17049,0,8.85682
03/03/2019 11:05,2018,1,WESTERN EUROPE-EU,CROATIA,2,BELFAST INTERNATIONAL,SPLIT,13386,13386,0,12874,12578,296,3.97701
03/03/2019 11:05,2018,1,WESTERN EUROPE-EU,CROATIA,2,BIRMINGHAM,DUBROVNIK,35371,35371,0,43775,43775,0,-19.19817
03/03/2019 11:05,2018,1,WESTERN EUROPE-EU,CROATIA,2,BIRMINGHAM,PULA,15530,0,15530,15205,0,15205,2.13745
03/03/2019 11:05,2018,1,WESTERN EUROPE-EU,CROATIA,2,BIRMINGHAM,SPLIT,14753,14753,0,9351,9351,0,57.76922
03/03/2019 11:05,2018,1,WESTERN EUROPE-EU,CROATIA,2,BRISTOL,DUBROVNIK,36870,36870,0,27484,27484,0,34.15078
03/03/2019 11:05,2018,1,WESTERN EUROPE-EU,CROATIA,2,BRISTOL,PULA,26420,14827,11593,21345,6062,15283,23.77606
03/03/2019 11:05,2018,1,WESTERN EUROPE-EU,CROATIA,2,BRISTOL,SPLIT,37659,37659,0,29881,29881,0,26.02992
03/03/2019 11:05,2018,1,WESTERN EUROPE-EU,CROATIA,2,BRISTOL,ZADAR,0,0,0,19134,19134,0,-100
03/03/2019 11:05,2018,1,WESTERN EUROPE-EU,CROATIA,2,CARDIFF WALES,ZAGREB,0,0,0,131,131,0,-100
03/03/2019 11:05,2018,1,WESTERN EUROPE-EU,CROATIA,2,DONCASTER SHEFFIELD,DUBROVNIK,8790,5707,3083,9452,9452,0,-7.00381
03/03/2019 11:05,2018,1,WESTERN EUROPE-EU,CROATIA,2,EAST MIDLANDS INTERNATIONAL,DUBROVNIK,23743,22852,891,14568,14568,0,62.98051
03/03/2019 11:05,2018,1,WESTERN EUROPE-EU,CROATIA,2,EAST MIDLANDS INTERNATIONAL,PULA,6293,0,6293,6011,0,6011,4.6914
03/03/2019 11:05,2018,1,WESTERN EUROPE-EU,CROATIA,2,EAST MIDLANDS INTERNATIONAL,SPLIT,11696,11696,0,6542,6542,0,78.78325
03/03/2019 11:05,2018,1,WESTERN EUROPE-EU,CROATIA,2,EDINBURGH,DUBROVNIK,37937,37937,0,40123,40123,0,-5.44825
03/03/2019 11:05,2018,1,WESTERN EUROPE-EU,CROATIA,2,EDINBURGH,PULA,17532,10736,6796,17930,11312,6618,-2.21974
03/03/2019 11:05,2018,1,WESTERN EUROPE-EU,CROATIA,2,EDINBURGH,SPLIT,11111,11111,0,11729,11729,0,-5.26899
03/03/2019 11:05,2018,1,WESTERN EUROPE-EU,CROATIA,2,GLASGOW,DUBROVNIK,18636,8635,10001,19344,8721,10623,-3.66005
03/03/2019 11:05,2018,1,WESTERN EUROPE-EU,CROATIA,2,GLASGOW,OSIJEK,315,0,315,0,0,0,0
03/03/2019 11:05,2018,1,WESTERN EUROPE-EU,CROATIA,2,GLASGOW,SPLIT,17126,17126,0,14937,14646,291,14.65488
03/03/2019 11:05,2018,1,WESTERN EUROPE-EU,CROATIA,2,GLASGOW,ZADAR,0,0,0,5628,5628,0,-100
03/03/2019 11:05,2018,1,WESTERN EUROPE-EU,CROATIA,2,HUMBERSIDE,DUBROVNIK,92,0,92,93,0,93,-1.07527
03/03/2019 11:05,2018,1,WESTERN EUROPE-EU,CROATIA,2,LEEDS BRADFORD,DUBROVNIK,19300,19300,0,18141,18127,14,6.38884
03/03/2019 11:05,2018,1,WESTERN EUROPE-EU,CROATIA,2,LEEDS BRADFORD,PULA,11439,11439,0,10848,10848,0,5.44801
03/03/2019 11:05,2018,1,WESTERN EUROPE-EU,CROATIA,2,LEEDS BRADFORD,SPLIT,11770,11770,0,11478,11478,0,2.544
03/03/2019 11:05,2018,1,WESTERN EUROPE-EU,CROATIA,2,LIVERPOOL (JOHN LENNON),PULA,5704,5661,43,0,0,0,0
03/03/2019 11:05,2018,1,WESTERN EUROPE-EU,CROATIA,2,LIVERPOOL (JOHN LENNON),RIJEKA,43,0,43,0,0,0,0
03/03/2019 11:05,2018,1,WESTERN EUROPE-EU,CROATIA,2,LIVERPOOL (JOHN LENNON),SPLIT,0,0,0,339,0,339,-100
03/03/2019 11:05,2018,1,WESTERN EUROPE-EU,CROATIA,2,LIVERPOOL (JOHN LENNON),ZADAR,0,0,0,148,148,0,-100
03/03/2019 11:05,2018,1,WESTERN EUROPE-EU,CROATIA,2,LIVERPOOL (JOHN LENNON),ZAGREB,501,0,501,0,0,0,0
03/03/2019 11:05,2018,1,WESTERN EUROPE-EU,CROATIA,2,MANCHESTER,DUBROVNIK,100519,100519,0,100142,99057,1085,0.37647
03/03/2019 11:05,2018,1,WESTERN EUROPE-EU,CROATIA,2,MANCHESTER,PULA,36967,20535,16432,37210,19800,17410,-0.65305
03/03/2019 11:05,2018,1,WESTERN EUROPE-EU,CROATIA,2,MANCHESTER,RIJEKA,0,0,0,170,0,170,-100
03/03/2019 11:05,2018,1,WESTERN EUROPE-EU,CROATIA,2,MANCHESTER,SPLIT,90853,75154,15699,67532,59542,7990,34.53326
03/03/2019 11:05,2018,1,WESTERN EUROPE-EU,CROATIA,2,MANCHESTER,ZADAR,25366,20891,4475,15709,12371,3338,61.47431
03/03/2019 11:05,2018,1,WESTERN EUROPE-EU,CROATIA,2,MANCHESTER,ZAGREB,0,0,0,11507,11288,219,-100
03/03/2019 11:05,2018,1,WESTERN EUROPE-EU,CROATIA,2,NEWCASTLE,DUBROVNIK,23702,23702,0,13452,13452,0,76.19685
03/03/2019 11:05,2018,1,WESTERN EUROPE-EU,CROATIA,2,NEWCASTLE,SPLIT,5619,5619,0,6688,6688,0,-15.98385
03/03/2019 11:05,2018,1,WESTERN EUROPE-EU,CROATIA,2,SOUTHAMPTON,DUBROVNIK,0,0,0,148,148,0,-100
03/03/2019 11:05,2018,1,WESTERN EUROPE-EU,CYPRUS,1,GATWICK,LARNACA,320533,265973,54560,299600,238537,61063,6.98698
03/03/2019 11:05,2018,1,WESTERN EUROPE-EU,CYPRUS,1,GATWICK,PAPHOS,378912,283680,95232,403465,294313,109152,-6.08553
03/03/2019 11:05,2018,1,WESTERN EUROPE-EU,CYPRUS,1,HEATHROW,LARNACA,273464,273464,0,299292,299292,0,-8.6297
03/03/2019 11:05,2018,1,WESTERN EUROPE-EU,CYPRUS,1,LUTON,LARNACA,160499,152254,8245,85998,76491,9507,86.63108
03/03/2019 11:05,2018,1,WESTERN EUROPE-EU,CYPRUS,1,LUTON,PAPHOS,107456,82473,24983,113018,78876,34142,-4.92134
03/03/2019 11:05,2018,1,WESTERN EUROPE-EU,CYPRUS,1,STANSTED,LARNACA,91852,82363,9489,67632,57478,10154,35.81145
03/03/2019 11:05,2018,1,WESTERN EUROPE-EU,CYPRUS,1,STANSTED,PAPHOS,228079,197854,30225,185723,154384,31339,22.80601
03/03/2019 11:05,2018,1,WESTERN EUROPE-EU,CYPRUS,2,ABERDEEN,LARNACA,0,0,0,286,0,286,-100
03/03/2019 11:05,2018,1,WESTERN EUROPE-EU,CYPRUS,2,BELFAST INTERNATIONAL,LARNACA,17581,0,17581,18096,0,18096,-2.84593
03/03/2019 11:05,2018,1,WESTERN EUROPE-EU,CYPRUS,2,BELFAST INTERNATIONAL,PAPHOS,8455,8455,0,0,0,0,0
03/03/2019 11:05,2018,1,WESTERN EUROPE-EU,CYPRUS,2,BIRMINGHAM,LARNACA,130075,96785,33290,136427,113710,22717,-4.65597
03/03/2019 11:05,2018,1,WESTERN EUROPE-EU,CYPRUS,2,BIRMINGHAM,PAPHOS,99193,46212,52981,104814,62717,42097,-5.36283
03/03/2019 11:05,2018,1,WESTERN EUROPE-EU,CYPRUS,2,BOURNEMOUTH,LARNACA,186,0,186,0,0,0,0
03/03/2019 11:05,2018,1,WESTERN EUROPE-EU,CYPRUS,2,BOURNEMOUTH,PAPHOS,19109,5698,13411,13711,371,13340,39.36985
03/03/2019 11:05,2018,1,WESTERN EUROPE-EU,CYPRUS,2,BRISTOL,LARNACA,44319,25012,19307,42023,22917,19106,5.46367
03/03/2019 11:05,2018,1,WESTERN EUROPE-EU,CYPRUS,2,BRISTOL,PAPHOS,88644,63605,25039,75219,50155,25064,17.84788
03/03/2019 11:05,2018,1,WESTERN EUROPE-EU,CYPRUS,2,CARDIFF WALES,LARNACA,17474,0,17474,17219,0,17219,1.48092
03/03/2019 11:05,2018,1,WESTERN EUROPE-EU,CYPRUS,2,CARDIFF WALES,PAPHOS,13716,0,13716,14056,360,13696,-2.4189
03/03/2019 11:05,2018,1,WESTERN EUROPE-EU,CYPRUS,2,DONCASTER SHEFFIELD,LARNACA,9806,0,9806,9045,0,9045,8.41349
03/03/2019 11:05,2018,1,WESTERN EUROPE-EU,CYPRUS,2,DONCASTER SHEFFIELD,PAPHOS,22412,0,22412,22913,0,22913,-2.18653
03/03/2019 11:05,2018,1,WESTERN EUROPE-EU,CYPRUS,2,EAST MIDLANDS INTERNATIONAL,LARNACA,39610,30961,8649,42678,31487,11191,-7.18872
03/03/2019 11:05,2018,1,WESTERN EUROPE-EU,CYPRUS,2,EAST MIDLANDS INTERNATIONAL,PAPHOS,70292,47542,22750,65410,42608,22802,7.46369
03/03/2019 11:05,2018,1,WESTERN EUROPE-EU,CYPRUS,2,EDINBURGH,LARNACA,21118,10636,10482,17482,8890,8592,20.79854
03/03/2019 11:05,2018,1,WESTERN EUROPE-EU,CYPRUS,2,EDINBURGH,PAPHOS,73948,59759,14189,64727,47474,17253,14.24599
03/03/2019 11:05,2018,1,WESTERN EUROPE-EU,CYPRUS,2,EXETER,LARNACA,10631,0,10631,10608,0,10608,0.21682
03/03/2019 11:05,2018,1,WESTERN EUROPE-EU,CYPRUS,2,EXETER,PAPHOS,12055,0,12055,12371,0,12371,-2.55436
03/03/2019 11:05,2018,1,WESTERN EUROPE-EU,CYPRUS,2,GLASGOW,LARNACA,45142,33684,11458,43097,23357,19740,4.74511
03/03/2019 11:05,2018,1,WESTERN EUROPE-EU,CYPRUS,2,GLASGOW,PAPHOS,41289,26261,15028,49769,24855,24914,-17.03872
03/03/2019 11:05,2018,1,WESTERN EUROPE-EU,CYPRUS,2,LEEDS BRADFORD,LARNACA,39605,39605,0,43886,43562,324,-9.75482
03/03/2019 11:05,2018,1,WESTERN EUROPE-EU,CYPRUS,2,LEEDS BRADFORD,PAPHOS,52106,45211,6895,45932,38113,7819,13.44161
03/03/2019 11:05,2018,1,WESTERN EUROPE-EU,CYPRUS,2,LIVERPOOL (JOHN LENNON),LARNACA,35055,35055,0,40073,39851,222,-12.52215
03/03/2019 11:05,2018,1,WESTERN EUROPE-EU,CYPRUS,2,LIVERPOOL (JOHN LENNON),PAPHOS,5491,5491,0,0,0,0,0
03/03/2019 11:05,2018,1,WESTERN EUROPE-EU,CYPRUS,2,MANCHESTER,LARNACA,146322,96557,49765,154462,104566,49896,-5.2699
03/03/2019 11:05,2018,1,WESTERN EUROPE-EU,CYPRUS,2,MANCHESTER,PAPHOS,318068,222270,95798,331479,227732,103747,-4.04581
03/03/2019 11:05,2018,1,WESTERN EUROPE-EU,CYPRUS,2,NEWCASTLE,LARNACA,57810,57810,0,48546,48546,0,19.08293
03/03/2019 11:05,2018,1,WESTERN EUROPE-EU,CYPRUS,2,NEWCASTLE,PAPHOS,52480,52480,0,57906,57906,0,-9.37036
03/03/2019 11:05,2018,1,WESTERN EUROPE-EU,CYPRUS,2,NORWICH,PAPHOS,7099,0,7099,7095,0,7095,0.05638
03/03/2019 11:05,2018,1,WESTERN EUROPE-EU,DENMARK,1,GATWICK,AALBORG,31405,31405,0,40380,40380,0,-22.22635
03/03/2019 11:05,2018,1,WESTERN EUROPE-EU,DENMARK,1,GATWICK,AARHUS (TIRSTRUP),3452,3452,0,0,0,0,0
03/03/2019 11:05,2018,1,WESTERN EUROPE-EU,DENMARK,1,GATWICK,BILLUND,0,0,0,55,54,1,-100
03/03/2019 11:05,2018,1,WESTERN EUROPE-EU,DENMARK,1,GATWICK,COPENHAGEN,798591,798464,127,808511,808276,235,-1.22695
03/03/2019 11:05,2018,1,WESTERN EUROPE-EU,DENMARK,1,GATWICK,RONNE,7,0,7,0,0,0,0
03/03/2019 11:05,2018,1,WESTERN EUROPE-EU,DENMARK,1,HEATHROW,BILLUND,125046,125046,0,124523,124523,0,0.42
03/03/2019 11:05,2018,1,WESTERN EUROPE-EU,DENMARK,1,HEATHROW,COPENHAGEN,1012730,1012730,0,982928,982928,0,3.03196
03/03/2019 11:05,2018,1,WESTERN EUROPE-EU,DENMARK,1,LONDON CITY,BILLUND,18730,18730,0,18979,18979,0,-1.31198
03/03/2019 11:05,2018,1,WESTERN EUROPE-EU,DENMARK,1,LUTON,BILLUND,168,168,0,0,0,0,0
03/03/2019 11:05,2018,1,WESTERN EUROPE-EU,DENMARK,1,LUTON,COPENHAGEN,123412,123412,0,266867,266855,12,-53.75524
03/03/2019 11:05,2018,1,WESTERN EUROPE-EU,DENMARK,1,LUTON,KARUP,84,0,84,0,0,0,0
03/03/2019 11:05,2018,1,WESTERN EUROPE-EU,DENMARK,1,SOUTHEND,BILLUND,24,24,0,99,99,0,-75.75758
03/03/2019 11:05,2018,1,WESTERN EUROPE-EU,DENMARK,1,STANSTED,AALBORG,54734,54734,0,15968,15968,0,242.77305
03/03/2019 11:05,2018,1,WESTERN EUROPE-EU,DENMARK,1,STANSTED,AARHUS (TIRSTRUP),103089,103089,0,95819,95819,0,7.58722
03/03/2019 11:05,2018,1,WESTERN EUROPE-EU,DENMARK,1,STANSTED,BILLUND,212578,212375,203,213239,213239,0,-0.30998
03/03/2019 11:05,2018,1,WESTERN EUROPE-EU,DENMARK,1,STANSTED,COPENHAGEN,339888,339606,282,263371,263109,262,29.05293
03/03/2019 11:05,2018,1,WESTERN EUROPE-EU,DENMARK,2,ABERDEEN,COPENHAGEN,25331,25331,0,26394,26394,0,-4.02743
03/03/2019 11:05,2018,1,WESTERN EUROPE-EU,DENMARK,2,ABERDEEN,ESBJERG,11274,11274,0,9082,9082,0,24.13565
03/03/2019 11:05,2018,1,WESTERN EUROPE-EU,DENMARK,2,BELFAST INTERNATIONAL,ROSKILDE,79,0,79,0,0,0,0
03/03/2019 11:05,2018,1,WESTERN EUROPE-EU,DENMARK,2,BIRMINGHAM,AARHUS (TIRSTRUP),0,0,0,42,0,42,-100
03/03/2019 11:05,2018,1,WESTERN EUROPE-EU,DENMARK,2,BIRMINGHAM,BILLUND,11,11,0,0,0,0,0
03/03/2019 11:05,2018,1,WESTERN EUROPE-EU,DENMARK,2,BIRMINGHAM,COPENHAGEN,78149,78149,0,84314,84314,0,-7.31195
03/03/2019 11:05,2018,1,WESTERN EUROPE-EU,DENMARK,2,BRISTOL,COPENHAGEN,44603,44603,0,32493,32493,0,37.26957
03/03/2019 11:05,2018,1,WESTERN EUROPE-EU,DENMARK,2,BRISTOL,KARUP,445,0,445,0,0,0,0
03/03/2019 11:05,2018,1,WESTERN EUROPE-EU,DENMARK,2,CARDIFF WALES,AARHUS (TIRSTRUP),152,0,152,0,0,0,0
03/03/2019 11:05,2018,1,WESTERN EUROPE-EU,DENMARK,2,CARDIFF WALES,BILLUND,65,0,65,0,0,0,0
03/03/2019 11:05,2018,1,WESTERN EUROPE-EU,DENMARK,2,CITY OF DERRY (EGLINTON),KARUP,0,0,0,130,0,130,-100
03/03/2019 11:05,2018,1,WESTERN EUROPE-EU,DENMARK,2,EAST MIDLANDS INTERNATIONAL,COPENHAGEN,0,0,0,179,179,0,-100
03/03/2019 11:05,2018,1,WESTERN EUROPE-EU,DENMARK,2,EDINBURGH,BILLUND,266,159,107,0,0,0,0
03/03/2019 11:05,2018,1,WESTERN EUROPE-EU,DENMARK,2,EDINBURGH,COPENHAGEN,241852,241565,287,230461,230461,0,4.9427
03/03/2019 11:05,2018,1,WESTERN EUROPE-EU,DENMARK,2,EDINBURGH,ODENSE,442,0,442,428,0,428,3.27103
03/03/2019 11:05,2018,1,WESTERN EUROPE-EU,DENMARK,2,EXETER,COPENHAGEN,0,0,0,314,314,0,-100
03/03/2019 11:05,2018,1,WESTERN EUROPE-EU,DENMARK,2,GLASGOW,COPENHAGEN,0,0,0,107,107,0,-100
03/03/2019 11:05,2018,1,WESTERN EUROPE-EU,DENMARK,2,LEEDS BRADFORD,COPENHAGEN,371,371,0,290,290,0,27.93103
03/03/2019 11:05,2018,1,WESTERN EUROPE-EU,DENMARK,2,LIVERPOOL (JOHN LENNON),BILLUND,0,0,0,63,63,0,-100
03/03/2019 11:05,2018,1,WESTERN EUROPE-EU,DENMARK,2,LIVERPOOL (JOHN LENNON),ODENSE,283,0,283,64,64,0,342.1875
03/03/2019 11:05,2018,1,WESTERN EUROPE-EU,DENMARK,2,LIVERPOOL (JOHN LENNON),ROSKILDE,111,0,111,0,0,0,0
03/03/2019 11:05,2018,1,WESTERN EUROPE-EU,DENMARK,2,MANCHESTER,AALBORG,211,211,0,0,0,0,0
03/03/2019 11:05,2018,1,WESTERN EUROPE-EU,DENMARK,2,MANCHESTER,AARHUS (TIRSTRUP),33,0,33,0,0,0,0
03/03/2019 11:05,2018,1,WESTERN EUROPE-EU,DENMARK,2,MANCHESTER,BILLUND,23686,23686,0,24715,24715,0,-4.16346
03/03/2019 11:05,2018,1,WESTERN EUROPE-EU,DENMARK,2,MANCHESTER,COPENHAGEN,340293,340293,0,326808,326650,158,4.12628
03/03/2019 11:05,2018,1,WESTERN EUROPE-EU,DENMARK,2,MANCHESTER,KARUP,0,0,0,29,0,29,-100
03/03/2019 11:05,2018,1,WESTERN EUROPE-EU,DENMARK,2,NEWCASTLE,BILLUND,0,0,0,93,0,93,-100
03/03/2019 11:05,2018,1,WESTERN EUROPE-EU,DENMARK,2,NEWCASTLE,COPENHAGEN,374,374,0,13590,13556,34,-97.24798
03/03/2019 11:05,2018,1,WESTERN EUROPE-EU,DENMARK,2,NEWCASTLE,ESBJERG,295,0,295,0,0,0,0
03/03/2019 11:05,2018,1,WESTERN EUROPE-EU,FINLAND,1,GATWICK,ENONTEKIO,3676,0,3676,4791,0,4791,-23.2728
03/03/2019 11:05,2018,1,WESTERN EUROPE-EU,FINLAND,1,GATWICK,HELSINKI,230541,230541,0,232720,232720,0,-0.93632
03/03/2019 11:05,2018,1,WESTERN EUROPE-EU,FINLAND,1,GATWICK,IVALO,15817,6035,9782,11891,1773,10118,33.01657
03/03/2019 11:05,2018,1,WESTERN EUROPE-EU,FINLAND,1,GATWICK,KITTILA,23486,4828,18658,28832,6571,22261,-18.5419
03/03/2019 11:05,2018,1,WESTERN EUROPE-EU,FINLAND,1,GATWICK,KUUSAMO,5708,0,5708,3991,0,3991,43.0218
03/03/2019 11:05,2018,1,WESTERN EUROPE-EU,FINLAND,1,GATWICK,ROVANIEMI,39418,27792,11626,29443,19007,10436,33.87902
03/03/2019 11:05,2018,1,WESTERN EUROPE-EU,FINLAND,1,HEATHROW,HELSINKI,774505,774505,0,714261,714261,0,8.43445
03/03/2019 11:05,2018,1,WESTERN EUROPE-EU,FINLAND,1,LUTON,IVALO,1337,715,622,719,0,719,85.95271
03/03/2019 11:05,2018,1,WESTERN EUROPE-EU,FINLAND,1,LUTON,SEINAJOKI,0,0,0,42,0,42,-100
03/03/2019 11:05,2018,1,WESTERN EUROPE-EU,FINLAND,1,STANSTED,ENONTEKIO,1454,0,1454,2447,0,2447,-40.5803
03/03/2019 11:05,2018,1,WESTERN EUROPE-EU,FINLAND,1,STANSTED,IVALO,2016,0,2016,1805,0,1805,11.68975
03/03/2019 11:05,2018,1,WESTERN EUROPE-EU,FINLAND,1,STANSTED,KITTILA,964,0,964,734,0,734,31.33515
03/03/2019 11:05,2018,1,WESTERN EUROPE-EU,FINLAND,1,STANSTED,ROVANIEMI,362,0,362,1196,436,760,-69.73244
03/03/2019 11:05,2018,1,WESTERN EUROPE-EU,FINLAND,1,STANSTED,TAMPERE,0,0,0,98,0,98,-100
03/03/2019 11:05,2018,1,WESTERN EUROPE-EU,FINLAND,2,ABERDEEN,ENONTEKIO,748,0,748,370,0,370,102.16216
03/03/2019 11:05,2018,1,WESTERN EUROPE-EU,FINLAND,2,ABERDEEN,IVALO,270,0,270,354,0,354,-23.72881
03/03/2019 11:05,2018,1,WESTERN EUROPE-EU,FINLAND,2,BELFAST INTERNATIONAL,ENONTEKIO,370,0,370,704,0,704,-47.44318
03/03/2019 11:05,2018,1,WESTERN EUROPE-EU,FINLAND,2,BELFAST INTERNATIONAL,IVALO,360,0,360,358,0,358,0.55866
03/03/2019 11:05,2018,1,WESTERN EUROPE-EU,FINLAND,2,BELFAST INTERNATIONAL,KUOPIO,0,0,0,2,0,2,-100
03/03/2019 11:05,2018,1,WESTERN EUROPE-EU,FINLAND,2,BELFAST INTERNATIONAL,ROVANIEMI,1728,0,1728,1754,0,1754,-1.48233
03/03/2019 11:05,2018,1,WESTERN EUROPE-EU,FINLAND,2,BIRMINGHAM,ENONTEKIO,2575,0,2575,2572,0,2572,0.11664
03/03/2019 11:05,2018,1,WESTERN EUROPE-EU,FINLAND,2,BIRMINGHAM,IVALO,5429,0,5429,1864,0,1864,191.25536
03/03/2019 11:05,2018,1,WESTERN EUROPE-EU,FINLAND,2,BIRMINGHAM,KITTILA,442,0,442,378,0,378,16.93122
03/03/2019 11:05,2018,1,WESTERN EUROPE-EU,FINLAND,2,BIRMINGHAM,KUUSAMO,727,0,727,0,0,0,0
03/03/2019 11:05,2018,1,WESTERN EUROPE-EU,FINLAND,2,BIRMINGHAM,ROVANIEMI,5925,1992,3933,5229,1316,3913,13.31038
03/03/2019 11:05,2018,1,WESTERN EUROPE-EU,FINLAND,2,BOURNEMOUTH,ENONTEKIO,246,0,246,378,0,378,-34.92063
03/03/2019 11:05,2018,1,WESTERN EUROPE-EU,FINLAND,2,BOURNEMOUTH,IVALO,0,0,0,706,0,706,-100
03/03/2019 11:05,2018,1,WESTERN EUROPE-EU,FINLAND,2,BOURNEMOUTH,KITTILA,371,0,371,371,0,371,0
03/03/2019 11:05,2018,1,WESTERN EUROPE-EU,FINLAND,2,BRISTOL,ENONTEKIO,1730,171,1559,1304,0,1304,32.66871
03/03/2019 11:05,2018,1,WESTERN EUROPE-EU,FINLAND,2,BRISTOL,IVALO,1250,0,1250,1493,0,1493,-16.27595
03/03/2019 11:05,2018,1,WESTERN EUROPE-EU,FINLAND,2,BRISTOL,KITTILA,10601,0,10601,9578,0,9578,10.68073
03/03/2019 11:05,2018,1,WESTERN EUROPE-EU,FINLAND,2,BRISTOL,ROVANIEMI,1620,0,1620,1747,1298,449,-7.26961
03/03/2019 11:05,2018,1,WESTERN EUROPE-EU,FINLAND,2,CARDIFF WALES,ENONTEKIO,375,0,375,187,0,187,100.53476
03/03/2019 11:05,2018,1,WESTERN EUROPE-EU,FINLAND,2,CARDIFF WALES,IVALO,512,0,512,358,0,358,43.01676
03/03/2019 11:05,2018,1,WESTERN EUROPE-EU,FINLAND,2,DONCASTER SHEFFIELD,ENONTEKIO,1352,0,1352,722,0,722,87.25762
03/03/2019 11:05,2018,1,WESTERN EUROPE-EU,FINLAND,2,DONCASTER SHEFFIELD,KITTILA,2290,0,2290,375,0,375,510.66667
03/03/2019 11:05,2018,1,WESTERN EUROPE-EU,FINLAND,2,DURHAM TEES VALLEY,ENONTEKIO,374,0,374,379,0,379,-1.31926
03/03/2019 11:05,2018,1,WESTERN EUROPE-EU,FINLAND,2,EAST MIDLANDS INTERNATIONAL,ENONTEKIO,1595,0,1595,1261,0,1261,26.48692
03/03/2019 11:05,2018,1,WESTERN EUROPE-EU,FINLAND,2,EAST MIDLANDS INTERNATIONAL,IVALO,965,0,965,900,0,900,7.22222
03/03/2019 11:05,2018,1,WESTERN EUROPE-EU,FINLAND,2,EAST MIDLANDS INTERNATIONAL,KITTILA,4449,439,4010,3551,543,3008,25.28865
03/03/2019 11:05,2018,1,WESTERN EUROPE-EU,FINLAND,2,EAST MIDLANDS INTERNATIONAL,ROVANIEMI,2477,1736,741,1473,1305,168,68.16022
03/03/2019 11:05,2018,1,WESTERN EUROPE-EU,FINLAND,2,EAST MIDLANDS INTERNATIONAL,TURKU,0,0,0,36,0,36,-100
03/03/2019 11:05,2018,1,WESTERN EUROPE-EU,FINLAND,2,EDINBURGH,ENONTEKIO,732,0,732,748,0,748,-2.13904
03/03/2019 11:05,2018,1,WESTERN EUROPE-EU,FINLAND,2,EDINBURGH,HELSINKI,46775,46552,223,31094,31094,0,50.43095
03/03/2019 11:05,2018,1,WESTERN EUROPE-EU,FINLAND,2,EDINBURGH,IVALO,342,0,342,360,0,360,-5
03/03/2019 11:05,2018,1,WESTERN EUROPE-EU,FINLAND,2,EDINBURGH,KITTILA,376,0,376,372,0,372,1.07527
03/03/2019 11:05,2018,1,WESTERN EUROPE-EU,FINLAND,2,EXETER,ENONTEKIO,374,0,374,376,0,376,-0.53191
03/03/2019 11:05,2018,1,WESTERN EUROPE-EU,FINLAND,2,EXETER,IVALO,359,0,359,362,0,362,-0.82873
03/03/2019 11:05,2018,1,WESTERN EUROPE-EU,FINLAND,2,EXETER,ROVANIEMI,138,0,138,378,0,378,-63.49206
03/03/2019 11:05,2018,1,WESTERN EUROPE-EU,FINLAND,2,GLASGOW,ENONTEKIO,1229,359,870,1060,0,1060,15.9434
03/03/2019 11:05,2018,1,WESTERN EUROPE-EU,FINLAND,2,GLASGOW,IVALO,713,713,0,708,0,708,0.70621
03/03/2019 11:05,2018,1,WESTERN EUROPE-EU,FINLAND,2,GLASGOW,KITTILA,411,0,411,1418,550,868,-71.01551
03/03/2019 11:05,2018,1,WESTERN EUROPE-EU,FINLAND,2,GLASGOW,ROVANIEMI,3287,430,2857,3459,440,3019,-4.97254
03/03/2019 11:05,2018,1,WESTERN EUROPE-EU,FINLAND,2,HUMBERSIDE,ENONTEKIO,836,0,836,376,0,376,122.34043
03/03/2019 11:05,2018,1,WESTERN EUROPE-EU,FINLAND,2,HUMBERSIDE,IVALO,356,0,356,0,0,0,0
03/03/2019 11:05,2018,1,WESTERN EUROPE-EU,FINLAND,2,LEEDS BRADFORD,ENONTEKIO,894,0,894,1428,0,1428,-37.39496
03/03/2019 11:05,2018,1,WESTERN EUROPE-EU,FINLAND,2,LEEDS BRADFORD,IVALO,1065,0,1065,1080,0,1080,-1.38889
03/03/2019 11:05,2018,1,WESTERN EUROPE-EU,FINLAND,2,LIVERPOOL (JOHN LENNON),ENONTEKIO,375,0,375,376,0,376,-0.26596
03/03/2019 11:05,2018,1,WESTERN EUROPE-EU,FINLAND,2,LIVERPOOL (JOHN LENNON),IVALO,269,0,269,895,0,895,-69.94413
03/03/2019 11:05,2018,1,WESTERN EUROPE-EU,FINLAND,2,MANCHESTER,ENONTEKIO,3835,0,3835,3531,420,3111,8.60946
03/03/2019 11:05,2018,1,WESTERN EUROPE-EU,FINLAND,2,MANCHESTER,HELSINKI,145975,145975,0,117154,117125,29,24.60095
03/03/2019 11:05,2018,1,WESTERN EUROPE-EU,FINLAND,2,MANCHESTER,IVALO,8750,0,8750,8733,0,8733,0.19466
03/03/2019 11:05,2018,1,WESTERN EUROPE-EU,FINLAND,2,MANCHESTER,KITTILA,18449,1721,16728,23414,2575,20839,-21.20526
03/03/2019 11:05,2018,1,WESTERN EUROPE-EU,FINLAND,2,MANCHESTER,KUUSAMO,5724,0,5724,4120,0,4120,38.93204
03/03/2019 11:05,2018,1,WESTERN EUROPE-EU,FINLAND,2,MANCHESTER,ROVANIEMI,12311,5998,6313,12005,6010,5995,2.54894
03/03/2019 11:05,2018,1,WESTERN EUROPE-EU,FINLAND,2,NEWCASTLE,ENONTEKIO,373,315,58,376,376,0,-0.79787
03/03/2019 11:05,2018,1,WESTERN EUROPE-EU,FINLAND,2,NEWCASTLE,HELSINKI,0,0,0,112,0,112,-100
03/03/2019 11:05,2018,1,WESTERN EUROPE-EU,FINLAND,2,NEWCASTLE,IVALO,624,624,0,712,712,0,-12.35955
03/03/2019 11:05,2018,1,WESTERN EUROPE-EU,FINLAND,2,NEWCASTLE,KITTILA,2879,2879,0,2616,2616,0,10.05352
03/03/2019 11:05,2018,1,WESTERN EUROPE-EU,FINLAND,2,NEWCASTLE,ROVANIEMI,1236,1236,0,1672,1672,0,-26.07656
03/03/2019 11:05,2018,1,WESTERN EUROPE-EU,FINLAND,2,NORWICH,IVALO,356,0,356,356,0,356,0
03/03/2019 11:05,2018,1,WESTERN EUROPE-EU,FINLAND,2,SOUTHAMPTON,ENONTEKIO,0,0,0,752,0,752,-100
03/03/2019 11:05,2018,1,WESTERN EUROPE-EU,FINLAND,2,SOUTHAMPTON,IVALO,0,0,0,306,0,306,-100
03/03/2019 11:05,2018,1,WESTERN EUROPE-EU,FRANCE,1,GATWICK,AJACCIO,6418,6418,0,6935,6935,0,-7.45494
03/03/2019 11:05,2018,1,WESTERN EUROPE-EU,FRANCE,1,GATWICK,BASTIA,10653,10653,0,11196,11196,0,-4.84995
03/03/2019 11:05,2018,1,WESTERN EUROPE-EU,FRANCE,1,GATWICK,BIARRITZ,29728,29728,0,28785,28785,0,3.27601
03/03/2019 11:05,2018,1,WESTERN EUROPE-EU,FRANCE,1,GATWICK,BORDEAUX,311909,311858,51,294040,294040,0,6.07706
03/03/2019 11:05,2018,1,WESTERN EUROPE-EU,FRANCE,1,GATWICK,CANNES,0,0,0,3,0,3,-100
03/03/2019 11:05,2018,1,WESTERN EUROPE-EU,FRANCE,1,GATWICK,CHAMBERY,46837,186,46651,44340,0,44340,5.63148
03/03/2019 11:05,2018,1,WESTERN EUROPE-EU,FRANCE,1,GATWICK,CHATEAUROUX DEOLS,0,0,0,8,0,8,-100
03/03/2019 11:05,2018,1,WESTERN EUROPE-EU,FRANCE,1,GATWICK,FIGARI,7704,7704,0,7239,7239,0,6.42354
03/03/2019 11:05,2018,1,WESTERN EUROPE-EU,FRANCE,1,GATWICK,GRENOBLE,129111,43165,85946,129318,54645,74673,-0.16007
03/03/2019 11:05,2018,1,WESTERN EUROPE-EU,FRANCE,1,GATWICK,LA ROCHELLE,28868,28868,0,28680,28680,0,0.65551
03/03/2019 11:05,2018,1,WESTERN EUROPE-EU,FRANCE,1,GATWICK,LIMOGES,11695,11695,0,13856,13856,0,-15.59613
03/03/2019 11:05,2018,1,WESTERN EUROPE-EU,FRANCE,1,GATWICK,LYON,227985,212654,15331,213213,204023,9190,6.92828
03/03/2019 11:05,2018,1,WESTERN EUROPE-EU,FRANCE,1,GATWICK,MARSEILLE,149228,148880,348,154380,154380,0,-3.33722
03/03/2019 11:05,2018,1,WESTERN EUROPE-EU,FRANCE,1,GATWICK,MONTPELLIER,145756,145756,0,146562,146562,0,-0.54994
03/03/2019 11:05,2018,1,WESTERN EUROPE-EU,FRANCE,1,GATWICK,NANTES,167694,167656,38,162127,162127,0,3.43373
03/03/2019 11:05,2018,1,WESTERN EUROPE-EU,FRANCE,1,GATWICK,NICE,620834,619189,1645,622783,621878,905,-0.31295
03/03/2019 11:05,2018,1,WESTERN EUROPE-EU,FRANCE,1,GATWICK,NIMES,0,0,0,18,0,18,-100
03/03/2019 11:05,2018,1,WESTERN EUROPE-EU,FRANCE,1,GATWICK,PARIS (CHARLES DE GAULLE),486072,486072,0,455425,455117,308,6.72932
03/03/2019 11:05,2018,1,WESTERN EUROPE-EU,FRANCE,1,GATWICK,PARIS (ORLY),105,105,0,638,638,0,-83.54232
03/03/2019 11:05,2018,1,WESTERN EUROPE-EU,FRANCE,1,GATWICK,RENNES,782,782,0,17186,17186,0,-95.44978
03/03/2019 11:05,2018,1,WESTERN EUROPE-EU,FRANCE,1,GATWICK,TARBES-LOURDES INTERNATIONAL,0,0,0,1026,0,1026,-100
03/03/2019 11:05,2018,1,WESTERN EUROPE-EU,FRANCE,1,GATWICK,TOULOUSE (BLAGNAC),271680,265592,6088,282042,275931,6111,-3.67392
03/03/2019 11:05,2018,1,WESTERN EUROPE-EU,FRANCE,1,HEATHROW,BASTIA,4385,0,4385,4889,0,4889,-10.30886
03/03/2019 11:05,2018,1,WESTERN EUROPE-EU,FRANCE,1,HEATHROW,BIARRITZ,0,0,0,4497,4497,0,-100
03/03/2019 11:05,2018,1,WESTERN EUROPE-EU,FRANCE,1,HEATHROW,FIGARI,8858,4134,4724,5438,0,5438,62.89077
03/03/2019 11:05,2018,1,WESTERN EUROPE-EU,FRANCE,1,HEATHROW,GRENOBLE,8156,4209,3947,11038,763,10275,-26.1098
03/03/2019 11:05,2018,1,WESTERN EUROPE-EU,FRANCE,1,HEATHROW,LYON,267813,267813,0,249677,249677,0,7.26378
03/03/2019 11:05,2018,1,WESTERN EUROPE-EU,FRANCE,1,HEATHROW,MARSEILLE,263324,263324,0,248439,248439,0,5.99141
03/03/2019 11:05,2018,1,WESTERN EUROPE-EU,FRANCE,1,HEATHROW,MONTPELLIER,0,0,0,8769,8769,0,-100
03/03/2019 11:05,2018,1,WESTERN EUROPE-EU,FRANCE,1,HEATHROW,NANTES,9153,9153,0,9946,9946,0,-7.97305
03/03/2019 11:05,2018,1,WESTERN EUROPE-EU,FRANCE,1,HEATHROW,NICE,553540,553540,0,549690,549690,0,0.70039
03/03/2019 11:05,2018,1,WESTERN EUROPE-EU,FRANCE,1,HEATHROW,PARIS (CHARLES DE GAULLE),1250771,1250771,0,1207929,1207929,0,3.54673
03/03/2019 11:05,2018,1,WESTERN EUROPE-EU,FRANCE,1,HEATHROW,PARIS (ORLY),176,176,0,226685,226685,0,-99.92236
03/03/2019 11:05,2018,1,WESTERN EUROPE-EU,FRANCE,1,HEATHROW,TOULOUSE (BLAGNAC),249444,249444,0,250002,250002,0,-0.2232
03/03/2019 11:05,2018,1,WESTERN EUROPE-EU,FRANCE,1,LONDON CITY,AVIGNON,0,0,0,3740,3740,0,-100
03/03/2019 11:05,2018,1,WESTERN EUROPE-EU,FRANCE,1,LONDON CITY,BERGERAC,10015,10015,0,9565,9565,0,4.70465
03/03/2019 11:05,2018,1,WESTERN EUROPE-EU,FRANCE,1,LONDON CITY,CHAMBERY,5382,5382,0,6492,6492,0,-17.09797
03/03/2019 11:05,2018,1,WESTERN EUROPE-EU,FRANCE,1,LONDON CITY,DINARD,159,0,159,126,0,126,26.19048
03/03/2019 11:05,2018,1,WESTERN EUROPE-EU,FRANCE,1,LONDON CITY,LILLE,0,0,0,75,0,75,-100
03/03/2019 11:05,2018,1,WESTERN EUROPE-EU,FRANCE,1,LONDON CITY,NANTES,0,0,0,3984,3984,0,-100
03/03/2019 11:05,2018,1,WESTERN EUROPE-EU,FRANCE,1,LONDON CITY,NICE,39797,39797,0,38546,38546,0,3.24547
03/03/2019 11:05,2018,1,WESTERN EUROPE-EU,FRANCE,1,LONDON CITY,PARIS (CHARLES DE GAULLE),0,0,0,4092,3900,192,-100
03/03/2019 11:05,2018,1,WESTERN EUROPE-EU,FRANCE,1,LONDON CITY,PARIS (ORLY),95447,95447,0,37309,37309,0,155.82835
03/03/2019 11:05,2018,1,WESTERN EUROPE-EU,FRANCE,1,LONDON CITY,QUIMPER,6846,6846,0,6812,6812,0,0.49912
03/03/2019 11:05,2018,1,WESTERN EUROPE-EU,FRANCE,1,LONDON CITY,RENNES,2590,2590,0,5709,5709,0,-54.63304
03/03/2019 11:05,2018,1,WESTERN EUROPE-EU,FRANCE,1,LONDON CITY,TOULON / HYERES,0,0,0,7533,7533,0,-100
03/03/2019 11:05,2018,1,WESTERN EUROPE-EU,FRANCE,1,LUTON,BEZIERS,40534,40534,0,40818,40818,0,-0.69577
03/03/2019 11:05,2018,1,WESTERN EUROPE-EU,FRANCE,1,LUTON,BIARRITZ,5101,5101,0,5587,5587,0,-8.69876
03/03/2019 11:05,2018,1,WESTERN EUROPE-EU,FRANCE,1,LUTON,BORDEAUX,89352,89352,0,84847,84836,11,5.30956
03/03/2019 11:05,2018,1,WESTERN EUROPE-EU,FRANCE,1,LUTON,BREST,0,0,0,974,974,0,-100
03/03/2019 11:05,2018,1,WESTERN EUROPE-EU,FRANCE,1,LUTON,CARCASSONNE,0,0,0,80,80,0,-100
03/03/2019 11:05,2018,1,WESTERN EUROPE-EU,FRANCE,1,LUTON,CHAMBERY,4320,0,4320,539,0,539,701.48423
03/03/2019 11:05,2018,1,WESTERN EUROPE-EU,FRANCE,1,LUTON,CLERMONT FERRAND,0,0,0,1891,1267,624,-100
03/03/2019 11:05,2018,1,WESTERN EUROPE-EU,FRANCE,1,LUTON,GRENOBLE,10969,10685,284,8065,7482,583,36.00744
03/03/2019 11:05,2018,1,WESTERN EUROPE-EU,FRANCE,1,LUTON,LA ROCHELLE,92,92,0,79,0,79,16.4557
03/03/2019 11:05,2018,1,WESTERN EUROPE-EU,FRANCE,1,LUTON,LILLE,0,0,0,39,0,39,-100
03/03/2019 11:05,2018,1,WESTERN EUROPE-EU,FRANCE,1,LUTON,LYON,96452,96159,293,96229,95901,328,0.23174
03/03/2019 11:05,2018,1,WESTERN EUROPE-EU,FRANCE,1,LUTON,MARSEILLE,43327,43327,0,40940,40940,0,5.83048
03/03/2019 11:05,2018,1,WESTERN EUROPE-EU,FRANCE,1,LUTON,MONTPELLIER,11595,11595,0,16101,16101,0,-27.98584
03/03/2019 11:05,2018,1,WESTERN EUROPE-EU,FRANCE,1,LUTON,NANTES,51757,51757,0,43038,42936,102,20.25884
03/03/2019 11:05,2018,1,WESTERN EUROPE-EU,FRANCE,1,LUTON,NICE,168171,167440,731,161975,161589,386,3.82528
03/03/2019 11:05,2018,1,WESTERN EUROPE-EU,FRANCE,1,LUTON,NIMES,35318,35318,0,41508,41508,0,-14.91279
03/03/2019 11:05,2018,1,WESTERN EUROPE-EU,FRANCE,1,LUTON,PARIS (CHARLES DE GAULLE),291331,291331,0,289242,289242,0,0.72223
03/03/2019 11:05,2018,1,WESTERN EUROPE-EU,FRANCE,1,LUTON,PARIS (LE BOURGET),0,0,0,25,0,25,-100
03/03/2019 11:05,2018,1,WESTERN EUROPE-EU,FRANCE,1,LUTON,PARIS (ORLY),0,0,0,29475,29475,0,-100
03/03/2019 11:05,2018,1,WESTERN EUROPE-EU,FRANCE,1,LUTON,PERPIGNAN,579,152,427,183,183,0,216.39344
03/03/2019 11:05,2018,1,WESTERN EUROPE-EU,FRANCE,1,LUTON,STRASBOURG,0,0,0,251,251,0,-100
03/03/2019 11:05,2018,1,WESTERN EUROPE-EU,FRANCE,1,LUTON,TARBES-LOURDES INTERNATIONAL,278,0,278,0,0,0,0
03/03/2019 11:05,2018,1,WESTERN EUROPE-EU,FRANCE,1,LUTON,TOULOUSE (BLAGNAC),55351,55351,0,54728,54728,0,1.13836
03/03/2019 11:05,2018,1,WESTERN EUROPE-EU,FRANCE,1,SOUTHEND,BASTIA,0,0,0,207,207,0,-100
03/03/2019 11:05,2018,1,WESTERN EUROPE-EU,FRANCE,1,SOUTHEND,BORDEAUX,8256,8256,0,153,153,0,5296.07843
03/03/2019 11:05,2018,1,WESTERN EUROPE-EU,FRANCE,1,SOUTHEND,CAEN,13420,13420,0,12937,12937,0,3.73348
03/03/2019 11:05,2018,1,WESTERN EUROPE-EU,FRANCE,1,SOUTHEND,CHATEAUROUX DEOLS,1022,1022,0,0,0,0,0
03/03/2019 11:05,2018,1,WESTERN EUROPE-EU,FRANCE,1,SOUTHEND,LYON,31409,31409,0,15958,15958,0,96.82291
03/03/2019 11:05,2018,1,WESTERN EUROPE-EU,FRANCE,1,SOUTHEND,NANTES,0,0,0,68,68,0,-100
03/03/2019 11:05,2018,1,WESTERN EUROPE-EU,FRANCE,1,SOUTHEND,NICE,0,0,0,41,41,0,-100
03/03/2019 11:05,2018,1,WESTERN EUROPE-EU,FRANCE,1,SOUTHEND,PARIS (CHARLES DE GAULLE),51862,51862,0,49144,49144,0,5.53069
03/03/2019 11:05,2018,1,WESTERN EUROPE-EU,FRANCE,1,SOUTHEND,PARIS (ORLY),44,44,0,95,95,0,-53.68421
03/03/2019 11:05,2018,1,WESTERN EUROPE-EU,FRANCE,1,SOUTHEND,PERPIGNAN,0,0,0,3560,3560,0,-100
03/03/2019 11:05,2018,1,WESTERN EUROPE-EU,FRANCE,1,SOUTHEND,RENNES,46046,46046,0,44844,44844,0,2.6804
03/03/2019 11:05,2018,1,WESTERN EUROPE-EU,FRANCE,1,SOUTHEND,TOULON / HYERES,0,0,0,92,92,0,-100
03/03/2019 11:05,2018,1,WESTERN EUROPE-EU,FRANCE,1,STANSTED,AJACCIO,20232,20232,0,0,0,0,0
03/03/2019 11:05,2018,1,WESTERN EUROPE-EU,FRANCE,1,STANSTED,BASTIA,20860,20860,0,406,0,406,5037.93103
03/03/2019 11:05,2018,1,WESTERN EUROPE-EU,FRANCE,1,STANSTED,BERGERAC,92068,92068,0,108541,108541,0,-15.17675
03/03/2019 11:05,2018,1,WESTERN EUROPE-EU,FRANCE,1,STANSTED,BEZIERS,28922,28922,0,14956,14956,0,93.38058
03/03/2019 11:05,2018,1,WESTERN EUROPE-EU,FRANCE,1,STANSTED,BIARRITZ,107321,107321,0,106439,106439,0,0.82864
03/03/2019 11:05,2018,1,WESTERN EUROPE-EU,FRANCE,1,STANSTED,BORDEAUX,94623,94623,0,84604,84604,0,11.84223
03/03/2019 11:05,2018,1,WESTERN EUROPE-EU,FRANCE,1,STANSTED,BREST,193,193,0,131,131,0,47.32824
03/03/2019 11:05,2018,1,WESTERN EUROPE-EU,FRANCE,1,STANSTED,BRIVE-LA-GAILLARDE,17833,17833,0,17992,17992,0,-0.88373
03/03/2019 11:05,2018,1,WESTERN EUROPE-EU,FRANCE,1,STANSTED,CALVI,3471,0,3471,3954,0,3954,-12.21548
03/03/2019 11:05,2018,1,WESTERN EUROPE-EU,FRANCE,1,STANSTED,CARCASSONNE,89186,89186,0,104475,104475,0,-14.63412
03/03/2019 11:05,2018,1,WESTERN EUROPE-EU,FRANCE,1,STANSTED,CHAMBERY,20513,5309,15204,18762,4744,14018,9.33269
03/03/2019 11:05,2018,1,WESTERN EUROPE-EU,FRANCE,1,STANSTED,CLERMONT FERRAND,20208,20208,0,10784,10784,0,87.38872
03/03/2019 11:05,2018,1,WESTERN EUROPE-EU,FRANCE,1,STANSTED,DEAUVILLE,0,0,0,17848,17848,0,-100
03/03/2019 11:05,2018,1,WESTERN EUROPE-EU,FRANCE,1,STANSTED,DINARD,76245,76245,0,83017,83017,0,-8.15737
03/03/2019 11:05,2018,1,WESTERN EUROPE-EU,FRANCE,1,STANSTED,DOLE,703,703,0,0,0,0,0
03/03/2019 11:05,2018,1,WESTERN EUROPE-EU,FRANCE,1,STANSTED,FIGARI,5857,5857,0,0,0,0,0
03/03/2019 11:05,2018,1,WESTERN EUROPE-EU,FRANCE,1,STANSTED,GRENOBLE,53467,52071,1396,36054,35578,476,48.297
03/03/2019 11:05,2018,1,WESTERN EUROPE-EU,FRANCE,1,STANSTED,LA ROCHELLE,62254,62254,0,60391,60391,0,3.0849
03/03/2019 11:05,2018,1,WESTERN EUROPE-EU,FRANCE,1,STANSTED,LIMOGES,99761,99761,0,99706,99706,0,0.05516
03/03/2019 11:05,2018,1,WESTERN EUROPE-EU,FRANCE,1,STANSTED,LORIENT,0,0,0,13876,13876,0,-100
03/03/2019 11:05,2018,1,WESTERN EUROPE-EU,FRANCE,1,STANSTED,LYON,8041,6159,1882,1984,449,1535,305.29234
03/03/2019 11:05,2018,1,WESTERN EUROPE-EU,FRANCE,1,STANSTED,MARSEILLE,158505,158505,0,152091,152091,0,4.21721
03/03/2019 11:05,2018,1,WESTERN EUROPE-EU,FRANCE,1,STANSTED,NANTES,14946,14946,0,337,337,0,4335.01484
03/03/2019 11:05,2018,1,WESTERN EUROPE-EU,FRANCE,1,STANSTED,NICE,223418,223418,0,132154,131632,522,69.05883
03/03/2019 11:05,2018,1,WESTERN EUROPE-EU,FRANCE,1,STANSTED,NIMES,44731,44731,0,36617,36617,0,22.15911
03/03/2019 11:05,2018,1,WESTERN EUROPE-EU,FRANCE,1,STANSTED,PARIS (CHARLES DE GAULLE),0,0,0,287,287,0,-100
03/03/2019 11:05,2018,1,WESTERN EUROPE-EU,FRANCE,1,STANSTED,PARIS (ORLY),257,257,0,0,0,0,0
03/03/2019 11:05,2018,1,WESTERN EUROPE-EU,FRANCE,1,STANSTED,PAU,167,167,0,326,326,0,-48.77301
03/03/2019 11:05,2018,1,WESTERN EUROPE-EU,FRANCE,1,STANSTED,PERPIGNAN,48240,48240,0,50527,50527,0,-4.52629
03/03/2019 11:05,2018,1,WESTERN EUROPE-EU,FRANCE,1,STANSTED,POITIERS,56925,56925,0,58355,58355,0,-2.45052
03/03/2019 11:05,2018,1,WESTERN EUROPE-EU,FRANCE,1,STANSTED,QUIMPER,0,0,0,105,0,105,-100
03/03/2019 11:05,2018,1,WESTERN EUROPE-EU,FRANCE,1,STANSTED,RENNES,180,180,0,640,640,0,-71.875
03/03/2019 11:05,2018,1,WESTERN EUROPE-EU,FRANCE,1,STANSTED,STRASBOURG,18618,18618,0,18031,18031,0,3.2555
03/03/2019 11:05,2018,1,WESTERN EUROPE-EU,FRANCE,1,STANSTED,TARBES-LOURDES INTERNATIONAL,63057,55625,7432,59096,52690,6406,6.70265
03/03/2019 11:05,2018,1,WESTERN EUROPE-EU,FRANCE,1,STANSTED,TOULON / HYERES,245,0,245,221,0,221,10.85973
03/03/2019 11:05,2018,1,WESTERN EUROPE-EU,FRANCE,1,STANSTED,TOULOUSE (BLAGNAC),201713,201713,0,170152,170152,0,18.54871
03/03/2019 11:05,2018,1,WESTERN EUROPE-EU,FRANCE,1,STANSTED,TOURS,50037,50037,0,53018,53018,0,-5.62262
03/03/2019 11:05,2018,1,WESTERN EUROPE-EU,FRANCE,2,ABERDEEN,PARIS (CHARLES DE GAULLE),90518,90455,63,85601,85475,126,5.74409
03/03/2019 11:05,2018,1,WESTERN EUROPE-EU,FRANCE,2,ABERDEEN,PARIS (LE BOURGET),0,0,0,110,70,40,-100
03/03/2019 11:05,2018,1,WESTERN EUROPE-EU,FRANCE,2,BELFAST INTERNATIONAL,BORDEAUX,12469,12469,0,8888,8636,252,40.29028
03/03/2019 11:05,2018,1,WESTERN EUROPE-EU,FRANCE,2,BELFAST INTERNATIONAL,LA ROCHELLE,292,0,292,273,0,273,6.95971
03/03/2019 11:05,2018,1,WESTERN EUROPE-EU,FRANCE,2,BELFAST INTERNATIONAL,LYON,4422,4422,0,4589,4589,0,-3.63914
03/03/2019 11:05,2018,1,WESTERN EUROPE-EU,FRANCE,2,BELFAST INTERNATIONAL,NICE,20133,20133,0,18593,18593,0,8.28269
03/03/2019 11:05,2018,1,WESTERN EUROPE-EU,FRANCE,2,BELFAST INTERNATIONAL,PARIS (CHARLES DE GAULLE),89175,88943,232,76399,76399,0,16.72273
03/03/2019 11:05,2018,1,WESTERN EUROPE-EU,FRANCE,2,BELFAST INTERNATIONAL,PARIS (LE BOURGET),0,0,0,70,0,70,-100
03/03/2019 11:05,2018,1,WESTERN EUROPE-EU,FRANCE,2,BELFAST INTERNATIONAL,TARBES-LOURDES INTERNATIONAL,6218,0,6218,6304,0,6304,-1.36421
03/03/2019 11:05,2018,1,WESTERN EUROPE-EU,FRANCE,2,BIRMINGHAM,AVIGNON,2628,2628,0,3146,3146,0,-16.46535
03/03/2019 11:05,2018,1,WESTERN EUROPE-EU,FRANCE,2,BIRMINGHAM,BASTIA,1852,1852,0,2274,2274,0,-18.55761
03/03/2019 11:05,2018,1,WESTERN EUROPE-EU,FRANCE,2,BIRMINGHAM,BERGERAC,16127,16127,0,13334,13334,0,20.94645
03/03/2019 11:05,2018,1,WESTERN EUROPE-EU,FRANCE,2,BIRMINGHAM,BIARRITZ,5477,5477,0,5418,5418,0,1.08896
03/03/2019 11:05,2018,1,WESTERN EUROPE-EU,FRANCE,2,BIRMINGHAM,BORDEAUX,19072,19072,0,23664,23664,0,-19.405
03/03/2019 11:05,2018,1,WESTERN EUROPE-EU,FRANCE,2,BIRMINGHAM,BREST,1237,1237,0,1094,1094,0,13.0713
03/03/2019 11:05,2018,1,WESTERN EUROPE-EU,FRANCE,2,BIRMINGHAM,BRIVE-LA-GAILLARDE,0,0,0,116,0,116,-100
03/03/2019 11:05,2018,1,WESTERN EUROPE-EU,FRANCE,2,BIRMINGHAM,CAEN,0,0,0,45,0,45,-100
03/03/2019 11:05,2018,1,WESTERN EUROPE-EU,FRANCE,2,BIRMINGHAM,CARCASSONNE,111,111,0,0,0,0,0
03/03/2019 11:05,2018,1,WESTERN EUROPE-EU,FRANCE,2,BIRMINGHAM,CHAMBERY,15917,2984,12933,18780,2588,16192,-15.24494
03/03/2019 11:05,2018,1,WESTERN EUROPE-EU,FRANCE,2,BIRMINGHAM,CLERMONT FERRAND,0,0,0,90,0,90,-100
03/03/2019 11:05,2018,1,WESTERN EUROPE-EU,FRANCE,2,BIRMINGHAM,FIGARI,38,0,38,117,0,117,-67.52137
03/03/2019 11:05,2018,1,WESTERN EUROPE-EU,FRANCE,2,BIRMINGHAM,GRENOBLE,18198,12220,5978,16639,9465,7174,9.36955
03/03/2019 11:05,2018,1,WESTERN EUROPE-EU,FRANCE,2,BIRMINGHAM,LA ROCHELLE,3867,3867,0,4386,3938,448,-11.83311
03/03/2019 11:05,2018,1,WESTERN EUROPE-EU,FRANCE,2,BIRMINGHAM,LIMOGES,0,0,0,5513,5513,0,-100
03/03/2019 11:05,2018,1,WESTERN EUROPE-EU,FRANCE,2,BIRMINGHAM,LYON,44390,44050,340,45733,45733,0,-2.93661
03/03/2019 11:05,2018,1,WESTERN EUROPE-EU,FRANCE,2,BIRMINGHAM,MARSEILLE,94,58,36,16,0,16,487.5
03/03/2019 11:05,2018,1,WESTERN EUROPE-EU,FRANCE,2,BIRMINGHAM,MONTPELLIER,270,0,270,0,0,0,0
03/03/2019 11:05,2018,1,WESTERN EUROPE-EU,FRANCE,2,BIRMINGHAM,NANTES,17622,17622,0,17742,17742,0,-0.67636
03/03/2019 11:05,2018,1,WESTERN EUROPE-EU,FRANCE,2,BIRMINGHAM,NICE,413,0,413,15565,15193,372,-97.34661
03/03/2019 11:05,2018,1,WESTERN EUROPE-EU,FRANCE,2,BIRMINGHAM,PARIS (CHARLES DE GAULLE),412050,411543,507,399484,399397,87,3.14556
03/03/2019 11:05,2018,1,WESTERN EUROPE-EU,FRANCE,2,BIRMINGHAM,PARIS (ORLY),293,293,0,40657,40657,0,-99.27934
03/03/2019 11:05,2018,1,WESTERN EUROPE-EU,FRANCE,2,BIRMINGHAM,PAU,90,0,90,0,0,0,0
03/03/2019 11:05,2018,1,WESTERN EUROPE-EU,FRANCE,2,BIRMINGHAM,PERPIGNAN,19390,19390,0,18521,18521,0,4.69197
03/03/2019 11:05,2018,1,WESTERN EUROPE-EU,FRANCE,2,BIRMINGHAM,RENNES,67,67,0,6689,6689,0,-98.99836
03/03/2019 11:05,2018,1,WESTERN EUROPE-EU,FRANCE,2,BIRMINGHAM,TARBES-LOURDES INTERNATIONAL,1200,0,1200,992,0,992,20.96774
03/03/2019 11:05,2018,1,WESTERN EUROPE-EU,FRANCE,2,BIRMINGHAM,TOULOUSE (BLAGNAC),9307,5405,3902,40450,37736,2714,-76.99135
03/03/2019 11:05,2018,1,WESTERN EUROPE-EU,FRANCE,2,BOURNEMOUTH,LYON,0,0,0,28,28,0,-100
03/03/2019 11:05,2018,1,WESTERN EUROPE-EU,FRANCE,2,BOURNEMOUTH,NANTES,0,0,0,147,0,147,-100
03/03/2019 11:05,2018,1,WESTERN EUROPE-EU,FRANCE,2,BOURNEMOUTH,NICE,0,0,0,123,123,0,-100
03/03/2019 11:05,2018,1,WESTERN EUROPE-EU,FRANCE,2,BOURNEMOUTH,RODEZ,43,43,0,0,0,0,0
03/03/2019 11:05,2018,1,WESTERN EUROPE-EU,FRANCE,2,BOURNEMOUTH,TOULON / HYERES,0,0,0,40,40,0,-100
03/03/2019 11:05,2018,1,WESTERN EUROPE-EU,FRANCE,2,BRISTOL,BASTIA,0,0,0,793,0,793,-100
03/03/2019 11:05,2018,1,WESTERN EUROPE-EU,FRANCE,2,BRISTOL,BERGERAC,5921,5921,0,15902,15902,0,-62.76569
03/03/2019 11:05,2018,1,WESTERN EUROPE-EU,FRANCE,2,BRISTOL,BEZIERS,29605,29605,0,32223,32223,0,-8.12463
03/03/2019 11:05,2018,1,WESTERN EUROPE-EU,FRANCE,2,BRISTOL,BORDEAUX,58514,58514,0,49467,49467,0,18.28896
03/03/2019 11:05,2018,1,WESTERN EUROPE-EU,FRANCE,2,BRISTOL,BREST,0,0,0,332,332,0,-100
03/03/2019 11:05,2018,1,WESTERN EUROPE-EU,FRANCE,2,BRISTOL,BRIVE-LA-GAILLARDE,0,0,0,66,0,66,-100
03/03/2019 11:05,2018,1,WESTERN EUROPE-EU,FRANCE,2,BRISTOL,CHAMBERY,11317,0,11317,12933,1093,11840,-12.49517
03/03/2019 11:05,2018,1,WESTERN EUROPE-EU,FRANCE,2,BRISTOL,FIGARI,0,0,0,342,0,342,-100
03/03/2019 11:05,2018,1,WESTERN EUROPE-EU,FRANCE,2,BRISTOL,GRENOBLE,12640,12467,173,10318,10318,0,22.50436
03/03/2019 11:05,2018,1,WESTERN EUROPE-EU,FRANCE,2,BRISTOL,LA ROCHELLE,6867,6615,252,7009,7009,0,-2.02597
03/03/2019 11:05,2018,1,WESTERN EUROPE-EU,FRANCE,2,BRISTOL,LIMOGES,25836,25836,0,21383,21383,0,20.82495
03/03/2019 11:05,2018,1,WESTERN EUROPE-EU,FRANCE,2,BRISTOL,LYON,5265,4794,471,4499,4388,111,17.02601
03/03/2019 11:05,2018,1,WESTERN EUROPE-EU,FRANCE,2,BRISTOL,MARSEILLE,17688,17688,0,14899,14899,0,18.71938
03/03/2019 11:05,2018,1,WESTERN EUROPE-EU,FRANCE,2,BRISTOL,MONTPELLIER,41,0,41,0,0,0,0
03/03/2019 11:05,2018,1,WESTERN EUROPE-EU,FRANCE,2,BRISTOL,NANTES,10637,10637,0,13288,13288,0,-19.95033
03/03/2019 11:05,2018,1,WESTERN EUROPE-EU,FRANCE,2,BRISTOL,NICE,96317,96317,0,93420,93420,0,3.10105
03/03/2019 11:05,2018,1,WESTERN EUROPE-EU,FRANCE,2,BRISTOL,PARIS (CHARLES DE GAULLE),154657,154589,68,152571,152373,198,1.36723
03/03/2019 11:05,2018,1,WESTERN EUROPE-EU,FRANCE,2,BRISTOL,TARBES-LOURDES INTERNATIONAL,370,0,370,375,159,216,-1.33333
03/03/2019 11:05,2018,1,WESTERN EUROPE-EU,FRANCE,2,BRISTOL,TOULON / HYERES,0,0,0,246,0,246,-100
03/03/2019 11:05,2018,1,WESTERN EUROPE-EU,FRANCE,2,BRISTOL,TOULOUSE (BLAGNAC),110243,97526,12717,110670,93453,17217,-0.38583
03/03/2019 11:05,2018,1,WESTERN EUROPE-EU,FRANCE,2,CARDIFF WALES,BORDEAUX,1511,0,1511,0,0,0,0
03/03/2019 11:05,2018,1,WESTERN EUROPE-EU,FRANCE,2,CARDIFF WALES,CHAMBERY,2709,2709,0,1855,1855,0,46.03774
03/03/2019 11:05,2018,1,WESTERN EUROPE-EU,FRANCE,2,CARDIFF WALES,CLERMONT FERRAND,125,0,125,83,0,83,50.60241
03/03/2019 11:05,2018,1,WESTERN EUROPE-EU,FRANCE,2,CARDIFF WALES,GRENOBLE,918,0,918,0,0,0,0
03/03/2019 11:05,2018,1,WESTERN EUROPE-EU,FRANCE,2,CARDIFF WALES,LA ROCHELLE,453,0,453,0,0,0,0
03/03/2019 11:05,2018,1,WESTERN EUROPE-EU,FRANCE,2,CARDIFF WALES,LYON,2515,187,2328,424,0,424,493.16038
03/03/2019 11:05,2018,1,WESTERN EUROPE-EU,FRANCE,2,CARDIFF WALES,LYON(BRON),38,0,38,35,0,35,8.57143
03/03/2019 11:05,2018,1,WESTERN EUROPE-EU,FRANCE,2,CARDIFF WALES,MARSEILLE,377,0,377,0,0,0,0
03/03/2019 11:05,2018,1,WESTERN EUROPE-EU,FRANCE,2,CARDIFF WALES,NANTES,581,0,581,0,0,0,0
03/03/2019 11:05,2018,1,WESTERN EUROPE-EU,FRANCE,2,CARDIFF WALES,NICE,0,0,0,136,125,11,-100
03/03/2019 11:05,2018,1,WESTERN EUROPE-EU,FRANCE,2,CARDIFF WALES,PARIS (CHARLES DE GAULLE),77676,75402,2274,60820,60402,418,27.71457
03/03/2019 11:05,2018,1,WESTERN EUROPE-EU,FRANCE,2,CARDIFF WALES,PARIS (LE BOURGET),81,0,81,172,0,172,-52.90698
03/03/2019 11:05,2018,1,WESTERN EUROPE-EU,FRANCE,2,CARDIFF WALES,PARIS (ORLY),819,0,819,561,0,561,45.9893
03/03/2019 11:05,2018,1,WESTERN EUROPE-EU,FRANCE,2,CARDIFF WALES,PAU,231,0,231,116,0,116,99.13793
03/03/2019 11:05,2018,1,WESTERN EUROPE-EU,FRANCE,2,CARDIFF WALES,TARBES-LOURDES INTERNATIONAL,460,0,460,671,0,671,-31.4456
03/03/2019 11:05,2018,1,WESTERN EUROPE-EU,FRANCE,2,CARDIFF WALES,TOULON / HYERES,208,0,208,82,0,82,153.65854
03/03/2019 11:05,2018,1,WESTERN EUROPE-EU,FRANCE,2,CARDIFF WALES,TOULOUSE (BLAGNAC),2141,83,2058,0,0,0,0
03/03/2019 11:05,2018,1,WESTERN EUROPE-EU,FRANCE,2,CITY OF DERRY (EGLINTON),PARIS (LE BOURGET),50,0,50,0,0,0,0
03/03/2019 11:05,2018,1,WESTERN EUROPE-EU,FRANCE,2,DONCASTER SHEFFIELD,BIARRITZ,5,0,5,0,0,0,0
03/03/2019 11:05,2018,1,WESTERN EUROPE-EU,FRANCE,2,DONCASTER SHEFFIELD,CHAMBERY,3925,0,3925,1180,737,443,232.62712
03/03/2019 11:05,2018,1,WESTERN EUROPE-EU,FRANCE,2,DONCASTER SHEFFIELD,NANTES,111,0,111,0,0,0,0
03/03/2019 11:05,2018,1,WESTERN EUROPE-EU,FRANCE,2,DONCASTER SHEFFIELD,NICE,163,0,163,0,0,0,0
03/03/2019 11:05,2018,1,WESTERN EUROPE-EU,FRANCE,2,DONCASTER SHEFFIELD,PARIS (CHARLES DE GAULLE),36181,36181,0,41697,41697,0,-13.22877
03/03/2019 11:05,2018,1,WESTERN EUROPE-EU,FRANCE,2,DONCASTER SHEFFIELD,PARIS (ORLY),0,0,0,4,4,0,-100
03/03/2019 11:05,2018,1,WESTERN EUROPE-EU,FRANCE,2,DONCASTER SHEFFIELD,TARBES-LOURDES INTERNATIONAL,494,0,494,490,0,490,0.81633
03/03/2019 11:05,2018,1,WESTERN EUROPE-EU,FRANCE,2,DONCASTER SHEFFIELD,TOULOUSE (BLAGNAC),0,0,0,82,82,0,-100
03/03/2019 11:05,2018,1,WESTERN EUROPE-EU,FRANCE,2,DURHAM TEES VALLEY,MARSEILLE,3,3,0,0,0,0,0
03/03/2019 11:05,2018,1,WESTERN EUROPE-EU,FRANCE,2,DURHAM TEES VALLEY,TARBES-LOURDES INTERNATIONAL,742,0,742,761,0,761,-2.49671
03/03/2019 11:05,2018,1,WESTERN EUROPE-EU,FRANCE,2,EAST MIDLANDS INTERNATIONAL,AUXERRE,0,0,0,17,0,17,-100
03/03/2019 11:05,2018,1,WESTERN EUROPE-EU,FRANCE,2,EAST MIDLANDS INTERNATIONAL,BERGERAC,19345,19345,0,19515,19515,0,-0.87112
03/03/2019 11:05,2018,1,WESTERN EUROPE-EU,FRANCE,2,EAST MIDLANDS INTERNATIONAL,CARCASSONNE,20931,20931,0,28757,28757,0,-27.21424
03/03/2019 11:05,2018,1,WESTERN EUROPE-EU,FRANCE,2,EAST MIDLANDS INTERNATIONAL,CHAMBERY,3723,0,3723,4271,0,4271,-12.83072
03/03/2019 11:05,2018,1,WESTERN EUROPE-EU,FRANCE,2,EAST MIDLANDS INTERNATIONAL,DINARD,29110,29110,0,36174,36174,0,-19.52784
03/03/2019 11:05,2018,1,WESTERN EUROPE-EU,FRANCE,2,EAST MIDLANDS INTERNATIONAL,GRENOBLE,0,0,0,558,558,0,-100
03/03/2019 11:05,2018,1,WESTERN EUROPE-EU,FRANCE,2,EAST MIDLANDS INTERNATIONAL,LA ROCHELLE,58,0,58,0,0,0,0
03/03/2019 11:05,2018,1,WESTERN EUROPE-EU,FRANCE,2,EAST MIDLANDS INTERNATIONAL,LIMOGES,45171,45171,0,47145,47145,0,-4.18708
03/03/2019 11:05,2018,1,WESTERN EUROPE-EU,FRANCE,2,EAST MIDLANDS INTERNATIONAL,LYON,472,0,472,0,0,0,0
03/03/2019 11:05,2018,1,WESTERN EUROPE-EU,FRANCE,2,EAST MIDLANDS INTERNATIONAL,NICE,0,0,0,32,0,32,-100
03/03/2019 11:05,2018,1,WESTERN EUROPE-EU,FRANCE,2,EAST MIDLANDS INTERNATIONAL,PARIS (CHARLES DE GAULLE),784,0,784,3099,3099,0,-74.70152
03/03/2019 11:05,2018,1,WESTERN EUROPE-EU,FRANCE,2,EAST MIDLANDS INTERNATIONAL,PARIS (LE BOURGET),93,0,93,95,0,95,-2.10526
03/03/2019 11:05,2018,1,WESTERN EUROPE-EU,FRANCE,2,EAST MIDLANDS INTERNATIONAL,RENNES,139,139,0,0,0,0,0
03/03/2019 11:05,2018,1,WESTERN EUROPE-EU,FRANCE,2,EAST MIDLANDS INTERNATIONAL,TARBES-LOURDES INTERNATIONAL,308,0,308,241,0,241,27.80083
03/03/2019 11:05,2018,1,WESTERN EUROPE-EU,FRANCE,2,EAST MIDLANDS INTERNATIONAL,TOULOUSE (BLAGNAC),176,0,176,0,0,0,0
03/03/2019 11:05,2018,1,WESTERN EUROPE-EU,FRANCE,2,EAST MIDLANDS INTERNATIONAL,TOURS,0,0,0,1,0,1,-100
03/03/2019 11:05,2018,1,WESTERN EUROPE-EU,FRANCE,2,EDINBURGH,AJACCIO,340,0,340,0,0,0,0
03/03/2019 11:05,2018,1,WESTERN EUROPE-EU,FRANCE,2,EDINBURGH,BERGERAC,2117,2117,0,2429,2429,0,-12.84479
03/03/2019 11:05,2018,1,WESTERN EUROPE-EU,FRANCE,2,EDINBURGH,BEZIERS,20418,20418,0,22006,22006,0,-7.21621
03/03/2019 11:05,2018,1,WESTERN EUROPE-EU,FRANCE,2,EDINBURGH,BORDEAUX,33415,32407,1008,39961,39961,0,-16.38097
03/03/2019 11:05,2018,1,WESTERN EUROPE-EU,FRANCE,2,EDINBURGH,CAEN,40,0,40,0,0,0,0
03/03/2019 11:05,2018,1,WESTERN EUROPE-EU,FRANCE,2,EDINBURGH,CARCASSONNE,25395,25395,0,3822,3822,0,564.4427
03/03/2019 11:05,2018,1,WESTERN EUROPE-EU,FRANCE,2,EDINBURGH,CHAMBERY,5770,0,5770,5728,0,5728,0.73324
03/03/2019 11:05,2018,1,WESTERN EUROPE-EU,FRANCE,2,EDINBURGH,CLERMONT FERRAND,0,0,0,2905,360,2545,-100
03/03/2019 11:05,2018,1,WESTERN EUROPE-EU,FRANCE,2,EDINBURGH,DOLE,318,0,318,0,0,0,0
03/03/2019 11:05,2018,1,WESTERN EUROPE-EU,FRANCE,2,EDINBURGH,GRENOBLE,5528,5150,378,4836,4836,0,14.30935
03/03/2019 11:05,2018,1,WESTERN EUROPE-EU,FRANCE,2,EDINBURGH,LYON,23862,22558,1304,23870,23870,0,-0.03351
03/03/2019 11:05,2018,1,WESTERN EUROPE-EU,FRANCE,2,EDINBURGH,LYON(BRON),0,0,0,69,0,69,-100
03/03/2019 11:05,2018,1,WESTERN EUROPE-EU,FRANCE,2,EDINBURGH,MARSEILLE,34919,34212,707,28911,28751,160,20.78102
03/03/2019 11:05,2018,1,WESTERN EUROPE-EU,FRANCE,2,EDINBURGH,MONTPELLIER,321,172,149,0,0,0,0
03/03/2019 11:05,2018,1,WESTERN EUROPE-EU,FRANCE,2,EDINBURGH,NANTES,35689,34968,721,5157,5157,0,592.04964
03/03/2019 11:05,2018,1,WESTERN EUROPE-EU,FRANCE,2,EDINBURGH,NICE,47631,47631,0,57144,57144,0,-16.64742
03/03/2019 11:05,2018,1,WESTERN EUROPE-EU,FRANCE,2,EDINBURGH,PARIS (CHARLES DE GAULLE),396635,393649,2986,357450,356110,1340,10.96237
03/03/2019 11:05,2018,1,WESTERN EUROPE-EU,FRANCE,2,EDINBURGH,PARIS (LE BOURGET),0,0,0,77,0,77,-100
03/03/2019 11:05,2018,1,WESTERN EUROPE-EU,FRANCE,2,EDINBURGH,PARIS (ORLY),46775,46135,640,54849,54687,162,-14.72041
03/03/2019 11:05,2018,1,WESTERN EUROPE-EU,FRANCE,2,EDINBURGH,POITIERS,6026,6026,0,8724,8724,0,-30.92618
03/03/2019 11:05,2018,1,WESTERN EUROPE-EU,FRANCE,2,EDINBURGH,TARBES-LOURDES INTERNATIONAL,1608,0,1608,1057,0,1057,52.12867
03/03/2019 11:05,2018,1,WESTERN EUROPE-EU,FRANCE,2,EDINBURGH,TOULON / HYERES,140,0,140,0,0,0,0
03/03/2019 11:05,2018,1,WESTERN EUROPE-EU,FRANCE,2,EDINBURGH,TOULOUSE (BLAGNAC),35560,32406,3154,7347,5544,1803,384.00708
03/03/2019 11:05,2018,1,WESTERN EUROPE-EU,FRANCE,2,EXETER,BERGERAC,3451,3451,0,3318,3318,0,4.00844
03/03/2019 11:05,2018,1,WESTERN EUROPE-EU,FRANCE,2,EXETER,CARCASSONNE,156,0,156,0,0,0,0
03/03/2019 11:05,2018,1,WESTERN EUROPE-EU,FRANCE,2,EXETER,CHAMBERY,6726,2319,4407,2685,2222,463,150.50279
03/03/2019 11:05,2018,1,WESTERN EUROPE-EU,FRANCE,2,EXETER,CLERMONT FERRAND,0,0,0,98,0,98,-100
03/03/2019 11:05,2018,1,WESTERN EUROPE-EU,FRANCE,2,EXETER,DEAUVILLE,0,0,0,123,123,0,-100
03/03/2019 11:05,2018,1,WESTERN EUROPE-EU,FRANCE,2,EXETER,GUYANCOURT,109,109,0,0,0,0,0
03/03/2019 11:05,2018,1,WESTERN EUROPE-EU,FRANCE,2,EXETER,LYON,441,0,441,0,0,0,0
03/03/2019 11:05,2018,1,WESTERN EUROPE-EU,FRANCE,2,EXETER,MONTPELLIER,0,0,0,144,0,144,-100
03/03/2019 11:05,2018,1,WESTERN EUROPE-EU,FRANCE,2,EXETER,PARIS (CHARLES DE GAULLE),50016,50016,0,42943,42913,30,16.47067
03/03/2019 11:05,2018,1,WESTERN EUROPE-EU,FRANCE,2,EXETER,RENNES,1644,1644,0,1386,1386,0,18.61472
03/03/2019 11:05,2018,1,WESTERN EUROPE-EU,FRANCE,2,EXETER,TARBES-LOURDES INTERNATIONAL,130,0,130,95,0,95,36.84211
03/03/2019 11:05,2018,1,WESTERN EUROPE-EU,FRANCE,2,EXETER,TOULOUSE (BLAGNAC),24,24,0,194,120,74,-87.62887
03/03/2019 11:05,2018,1,WESTERN EUROPE-EU,FRANCE,2,GLASGOW,BORDEAUX,9903,9903,0,6716,6716,0,47.45384
03/03/2019 11:05,2018,1,WESTERN EUROPE-EU,FRANCE,2,GLASGOW,CARCASSONNE,16912,16912,0,20200,20200,0,-16.27723
03/03/2019 11:05,2018,1,WESTERN EUROPE-EU,FRANCE,2,GLASGOW,CHAMBERY,5927,0,5927,5686,0,5686,4.23848
03/03/2019 11:05,2018,1,WESTERN EUROPE-EU,FRANCE,2,GLASGOW,GRENOBLE,4278,4278,0,3173,3173,0,34.82509
03/03/2019 11:05,2018,1,WESTERN EUROPE-EU,FRANCE,2,GLASGOW,LYON,1479,0,1479,466,0,466,217.38197
03/03/2019 11:05,2018,1,WESTERN EUROPE-EU,FRANCE,2,GLASGOW,LYON(BRON),0,0,0,49,0,49,-100
03/03/2019 11:05,2018,1,WESTERN EUROPE-EU,FRANCE,2,GLASGOW,MARSEILLE,5522,5522,0,8709,8627,82,-36.59433
03/03/2019 11:05,2018,1,WESTERN EUROPE-EU,FRANCE,2,GLASGOW,MONTPELLIER,0,0,0,432,0,432,-100
03/03/2019 11:05,2018,1,WESTERN EUROPE-EU,FRANCE,2,GLASGOW,NANTES,0,0,0,255,0,255,-100
03/03/2019 11:05,2018,1,WESTERN EUROPE-EU,FRANCE,2,GLASGOW,NICE,170,0,170,194,0,194,-12.37113
03/03/2019 11:05,2018,1,WESTERN EUROPE-EU,FRANCE,2,GLASGOW,PARIS (CHARLES DE GAULLE),128746,128746,0,149948,148876,1072,-14.13957
03/03/2019 11:05,2018,1,WESTERN EUROPE-EU,FRANCE,2,GLASGOW,PARIS (ORLY),0,0,0,98,0,98,-100
03/03/2019 11:05,2018,1,WESTERN EUROPE-EU,FRANCE,2,GLASGOW,TARBES-LOURDES INTERNATIONAL,1443,0,1443,1270,0,1270,13.62205
03/03/2019 11:05,2018,1,WESTERN EUROPE-EU,FRANCE,2,GLASGOW,TOULON / HYERES,140,0,140,0,0,0,0
03/03/2019 11:05,2018,1,WESTERN EUROPE-EU,FRANCE,2,GUERNSEY,BORDEAUX,140,140,0,0,0,0,0
03/03/2019 11:05,2018,1,WESTERN EUROPE-EU,FRANCE,2,GUERNSEY,DINARD,1640,1581,59,2712,2604,108,-39.52802
03/03/2019 11:05,2018,1,WESTERN EUROPE-EU,FRANCE,2,GUERNSEY,GRENOBLE,1155,893,262,739,739,0,56.29229
03/03/2019 11:05,2018,1,WESTERN EUROPE-EU,FRANCE,2,HUMBERSIDE,NANTES,0,0,0,73,0,73,-100
03/03/2019 11:05,2018,1,WESTERN EUROPE-EU,FRANCE,2,HUMBERSIDE,NICE,0,0,0,252,0,252,-100
03/03/2019 11:05,2018,1,WESTERN EUROPE-EU,FRANCE,2,HUMBERSIDE,PERPIGNAN,264,0,264,281,0,281,-6.04982
03/03/2019 11:05,2018,1,WESTERN EUROPE-EU,FRANCE,2,ISLE OF MAN,PARIS (CHARLES DE GAULLE),78,0,78,271,0,271,-71.21771
03/03/2019 11:05,2018,1,WESTERN EUROPE-EU,FRANCE,2,JERSEY,CAEN,2,2,0,0,0,0,0
03/03/2019 11:05,2018,1,WESTERN EUROPE-EU,FRANCE,2,JERSEY,DINARD,0,0,0,3,3,0,-100
03/03/2019 11:05,2018,1,WESTERN EUROPE-EU,FRANCE,2,JERSEY,GRENOBLE,302,302,0,0,0,0,0
03/03/2019 11:05,2018,1,WESTERN EUROPE-EU,FRANCE,2,JERSEY,NANTES,73,73,0,0,0,0,0
03/03/2019 11:05,2018,1,WESTERN EUROPE-EU,FRANCE,2,JERSEY,RENNES,0,0,0,11,0,11,-100
03/03/2019 11:05,2018,1,WESTERN EUROPE-EU,FRANCE,2,LEEDS BRADFORD,BERGERAC,4924,4924,0,5245,5245,0,-6.12011
03/03/2019 11:05,2018,1,WESTERN EUROPE-EU,FRANCE,2,LEEDS BRADFORD,GRENOBLE,4107,4107,0,3540,3540,0,16.01695
03/03/2019 11:05,2018,1,WESTERN EUROPE-EU,FRANCE,2,LEEDS BRADFORD,LA ROCHELLE,4547,4547,0,0,0,0,0
03/03/2019 11:05,2018,1,WESTERN EUROPE-EU,FRANCE,2,LEEDS BRADFORD,LIMOGES,24090,24090,0,20611,20611,0,16.87934
03/03/2019 11:05,2018,1,WESTERN EUROPE-EU,FRANCE,2,LEEDS BRADFORD,MONTPELLIER,0,0,0,7968,7968,0,-100
03/03/2019 11:05,2018,1,WESTERN EUROPE-EU,FRANCE,2,LEEDS BRADFORD,NICE,23337,23337,0,22562,22562,0,3.43498
03/03/2019 11:05,2018,1,WESTERN EUROPE-EU,FRANCE,2,LEEDS BRADFORD,PARIS (CHARLES DE GAULLE),52011,52011,0,49051,49051,0,6.03454
03/03/2019 11:05,2018,1,WESTERN EUROPE-EU,FRANCE,2,LEEDS BRADFORD,PERPIGNAN,373,0,373,891,144,747,-58.13692
03/03/2019 11:05,2018,1,WESTERN EUROPE-EU,FRANCE,2,LEEDS BRADFORD,TARBES-LOURDES INTERNATIONAL,680,0,680,501,0,501,35.72854
03/03/2019 11:05,2018,1,WESTERN EUROPE-EU,FRANCE,2,LIVERPOOL (JOHN LENNON),BERGERAC,21079,21079,0,33685,33685,0,-37.42319
03/03/2019 11:05,2018,1,WESTERN EUROPE-EU,FRANCE,2,LIVERPOOL (JOHN LENNON),BORDEAUX,22132,22132,0,18169,18169,0,21.81188
03/03/2019 11:05,2018,1,WESTERN EUROPE-EU,FRANCE,2,LIVERPOOL (JOHN LENNON),CHAMBERY,109,0,109,120,0,120,-9.16667
03/03/2019 11:05,2018,1,WESTERN EUROPE-EU,FRANCE,2,LIVERPOOL (JOHN LENNON),GRENOBLE,4424,4424,0,3253,3253,0,35.99754
03/03/2019 11:05,2018,1,WESTERN EUROPE-EU,FRANCE,2,LIVERPOOL (JOHN LENNON),LORIENT,0,0,0,143,143,0,-100
03/03/2019 11:05,2018,1,WESTERN EUROPE-EU,FRANCE,2,LIVERPOOL (JOHN LENNON),LYON,0,0,0,992,0,992,-100
03/03/2019 11:05,2018,1,WESTERN EUROPE-EU,FRANCE,2,LIVERPOOL (JOHN LENNON),NANTES,8241,8241,0,5522,5522,0,49.23941
03/03/2019 11:05,2018,1,WESTERN EUROPE-EU,FRANCE,2,LIVERPOOL (JOHN LENNON),NICE,94964,94964,0,93325,93325,0,1.75623
03/03/2019 11:05,2018,1,WESTERN EUROPE-EU,FRANCE,2,LIVERPOOL (JOHN LENNON),NIMES,0,0,0,11874,11874,0,-100
03/03/2019 11:05,2018,1,WESTERN EUROPE-EU,FRANCE,2,LIVERPOOL (JOHN LENNON),PARIS (CHARLES DE GAULLE),87697,87178,519,75573,75573,0,16.04277
03/03/2019 11:05,2018,1,WESTERN EUROPE-EU,FRANCE,2,LIVERPOOL (JOHN LENNON),PARIS (ORLY),130,0,130,0,0,0,0
03/03/2019 11:05,2018,1,WESTERN EUROPE-EU,FRANCE,2,LIVERPOOL (JOHN LENNON),PERPIGNAN,540,0,540,134,0,134,302.98507
03/03/2019 11:05,2018,1,WESTERN EUROPE-EU,FRANCE,2,LIVERPOOL (JOHN LENNON),RENNES,106,0,106,0,0,0,0
03/03/2019 11:05,2018,1,WESTERN EUROPE-EU,FRANCE,2,LIVERPOOL (JOHN LENNON),TARBES-LOURDES INTERNATIONAL,787,0,787,845,0,845,-6.86391
03/03/2019 11:05,2018,1,WESTERN EUROPE-EU,FRANCE,2,LIVERPOOL (JOHN LENNON),TOULOUSE (BLAGNAC),5818,5818,0,0,0,0,0
03/03/2019 11:05,2018,1,WESTERN EUROPE-EU,FRANCE,2,MANCHESTER,AVIGNON,0,0,0,31,0,31,-100
03/03/2019 11:05,2018,1,WESTERN EUROPE-EU,FRANCE,2,MANCHESTER,BASTIA,7087,7087,0,5343,5343,0,32.64084
03/03/2019 11:05,2018,1,WESTERN EUROPE-EU,FRANCE,2,MANCHESTER,BEAUVAIS,0,0,0,40663,40663,0,-100
03/03/2019 11:05,2018,1,WESTERN EUROPE-EU,FRANCE,2,MANCHESTER,BERGERAC,5848,5848,0,2519,2519,0,132.15562
03/03/2019 11:05,2018,1,WESTERN EUROPE-EU,FRANCE,2,MANCHESTER,BEZIERS,20825,20825,0,25588,25459,129,-18.61419
03/03/2019 11:05,2018,1,WESTERN EUROPE-EU,FRANCE,2,MANCHESTER,BORDEAUX,4509,4427,82,84,0,84,5267.85714
03/03/2019 11:05,2018,1,WESTERN EUROPE-EU,FRANCE,2,MANCHESTER,CALVI,2466,0,2466,2487,0,2487,-0.84439
03/03/2019 11:05,2018,1,WESTERN EUROPE-EU,FRANCE,2,MANCHESTER,CARCASSONNE,40210,40210,0,43088,43088,0,-6.67935
03/03/2019 11:05,2018,1,WESTERN EUROPE-EU,FRANCE,2,MANCHESTER,CHAMBERY,27294,5020,22274,19294,3242,16052,41.46367
03/03/2019 11:05,2018,1,WESTERN EUROPE-EU,FRANCE,2,MANCHESTER,GRENOBLE,27145,20585,6560,32954,27733,5221,-17.6276
03/03/2019 11:05,2018,1,WESTERN EUROPE-EU,FRANCE,2,MANCHESTER,LA ROCHELLE,3187,3187,0,2005,2005,0,58.95262
03/03/2019 11:05,2018,1,WESTERN EUROPE-EU,FRANCE,2,MANCHESTER,LIMOGES,46397,46397,0,53255,53255,0,-12.87766
03/03/2019 11:05,2018,1,WESTERN EUROPE-EU,FRANCE,2,MANCHESTER,LYON,49372,48401,971,56334,53350,2984,-12.35843
03/03/2019 11:05,2018,1,WESTERN EUROPE-EU,FRANCE,2,MANCHESTER,LYON(BRON),77,0,77,0,0,0,0
03/03/2019 11:05,2018,1,WESTERN EUROPE-EU,FRANCE,2,MANCHESTER,MARSEILLE,16068,16068,0,24184,24184,0,-33.55938
03/03/2019 11:05,2018,1,WESTERN EUROPE-EU,FRANCE,2,MANCHESTER,MONTPELLIER,78,0,78,31,0,31,151.6129
03/03/2019 11:05,2018,1,WESTERN EUROPE-EU,FRANCE,2,MANCHESTER,NANTES,13845,13845,0,15661,15661,0,-11.59568
03/03/2019 11:05,2018,1,WESTERN EUROPE-EU,FRANCE,2,MANCHESTER,NICE,49417,49161,256,48467,46663,1804,1.9601
03/03/2019 11:05,2018,1,WESTERN EUROPE-EU,FRANCE,2,MANCHESTER,PARIS (CHARLES DE GAULLE),628020,627770,250,629316,629018,298,-0.20594
03/03/2019 11:05,2018,1,WESTERN EUROPE-EU,FRANCE,2,MANCHESTER,PARIS (ORLY),0,0,0,130,0,130,-100
03/03/2019 11:05,2018,1,WESTERN EUROPE-EU,FRANCE,2,MANCHESTER,PERPIGNAN,813,0,813,1276,0,1276,-36.28527
03/03/2019 11:05,2018,1,WESTERN EUROPE-EU,FRANCE,2,MANCHESTER,RENNES,3540,3540,0,3003,3003,0,17.88212
03/03/2019 11:05,2018,1,WESTERN EUROPE-EU,FRANCE,2,MANCHESTER,ST ETIENNE,0,0,0,2402,0,2402,-100
03/03/2019 11:05,2018,1,WESTERN EUROPE-EU,FRANCE,2,MANCHESTER,TARBES-LOURDES INTERNATIONAL,2927,0,2927,3218,0,3218,-9.04288
03/03/2019 11:05,2018,1,WESTERN EUROPE-EU,FRANCE,2,MANCHESTER,TOULOUSE (BLAGNAC),49588,44326,5262,63479,58063,5416,-21.88283
03/03/2019 11:05,2018,1,WESTERN EUROPE-EU,FRANCE,2,NEWCASTLE,BORDEAUX,0,0,0,262,0,262,-100
03/03/2019 11:05,2018,1,WESTERN EUROPE-EU,FRANCE,2,NEWCASTLE,BRIVE-LA-GAILLARDE,172,0,172,0,0,0,0
03/03/2019 11:05,2018,1,WESTERN EUROPE-EU,FRANCE,2,NEWCASTLE,GRENOBLE,4131,4131,0,3852,3852,0,7.24299
03/03/2019 11:05,2018,1,WESTERN EUROPE-EU,FRANCE,2,NEWCASTLE,NICE,23504,23504,0,23071,22942,129,1.87682
03/03/2019 11:05,2018,1,WESTERN EUROPE-EU,FRANCE,2,NEWCASTLE,PARIS (CHARLES DE GAULLE),144374,144374,0,148184,148184,0,-2.57113
03/03/2019 11:05,2018,1,WESTERN EUROPE-EU,FRANCE,2,NEWCASTLE,PERPIGNAN,289,0,289,179,0,179,61.45251
03/03/2019 11:05,2018,1,WESTERN EUROPE-EU,FRANCE,2,NEWCASTLE,TARBES-LOURDES INTERNATIONAL,868,296,572,1023,1023,0,-15.15152
03/03/2019 11:05,2018,1,WESTERN EUROPE-EU,FRANCE,2,NORWICH,CHAMBERY,0,0,0,931,931,0,-100
03/03/2019 11:05,2018,1,WESTERN EUROPE-EU,FRANCE,2,PRESTWICK,PARIS (CHARLES DE GAULLE),0,0,0,427,2,425,-100
03/03/2019 11:05,2018,1,WESTERN EUROPE-EU,FRANCE,2,PRESTWICK,TARBES-LOURDES INTERNATIONAL,0,0,0,262,131,131,-100
03/03/2019 11:05,2018,1,WESTERN EUROPE-EU,FRANCE,2,SOUTHAMPTON,AVIGNON,3567,3567,0,6114,6114,0,-41.65849
03/03/2019 11:05,2018,1,WESTERN EUROPE-EU,FRANCE,2,SOUTHAMPTON,BASTIA,1643,1643,0,2141,2141,0,-23.26016
03/03/2019 11:05,2018,1,WESTERN EUROPE-EU,FRANCE,2,SOUTHAMPTON,BERGERAC,37772,37772,0,37490,37490,0,0.7522
03/03/2019 11:05,2018,1,WESTERN EUROPE-EU,FRANCE,2,SOUTHAMPTON,BIARRITZ,1857,1857,0,5416,5416,0,-65.7127
03/03/2019 11:05,2018,1,WESTERN EUROPE-EU,FRANCE,2,SOUTHAMPTON,BORDEAUX,10312,10312,0,13937,13937,0,-26.0099
03/03/2019 11:05,2018,1,WESTERN EUROPE-EU,FRANCE,2,SOUTHAMPTON,BREST,1207,1207,0,2916,2916,0,-58.60768
03/03/2019 11:05,2018,1,WESTERN EUROPE-EU,FRANCE,2,SOUTHAMPTON,CHAMBERY,9204,6228,2976,8658,5994,2664,6.30631
03/03/2019 11:05,2018,1,WESTERN EUROPE-EU,FRANCE,2,SOUTHAMPTON,GRENOBLE,0,0,0,21,21,0,-100
03/03/2019 11:05,2018,1,WESTERN EUROPE-EU,FRANCE,2,SOUTHAMPTON,LA ROCHELLE,10898,10898,0,17352,17352,0,-37.19456
03/03/2019 11:05,2018,1,WESTERN EUROPE-EU,FRANCE,2,SOUTHAMPTON,LIMOGES,12465,12465,0,17444,17444,0,-28.54277
03/03/2019 11:05,2018,1,WESTERN EUROPE-EU,FRANCE,2,SOUTHAMPTON,LYON,1268,1268,0,18647,18647,0,-93.19998
03/03/2019 11:05,2018,1,WESTERN EUROPE-EU,FRANCE,2,SOUTHAMPTON,NANTES,15314,15314,0,23139,23139,0,-33.81736
03/03/2019 11:05,2018,1,WESTERN EUROPE-EU,FRANCE,2,SOUTHAMPTON,NICE,68,68,0,0,0,0,0
03/03/2019 11:05,2018,1,WESTERN EUROPE-EU,FRANCE,2,SOUTHAMPTON,PARIS (CHARLES DE GAULLE),77953,77953,0,63032,63032,0,23.6721
03/03/2019 11:05,2018,1,WESTERN EUROPE-EU,FRANCE,2,SOUTHAMPTON,PARIS (LE BOURGET),70,70,0,0,0,0,0
03/03/2019 11:05,2018,1,WESTERN EUROPE-EU,FRANCE,2,SOUTHAMPTON,PARIS (ORLY),0,0,0,14392,14321,71,-100
03/03/2019 11:05,2018,1,WESTERN EUROPE-EU,FRANCE,2,SOUTHAMPTON,PERPIGNAN,1938,1938,0,2326,2326,0,-16.681
03/03/2019 11:05,2018,1,WESTERN EUROPE-EU,FRANCE,2,SOUTHAMPTON,RENNES,12565,12565,0,15588,15588,0,-19.39312
03/03/2019 11:05,2018,1,WESTERN EUROPE-EU,FRANCE,2,SOUTHAMPTON,RODEZ,2059,2059,0,851,851,0,141.95065
03/03/2019 11:05,2018,1,WESTERN EUROPE-EU,FRANCE,2,SOUTHAMPTON,TARBES-LOURDES INTERNATIONAL,0,0,0,328,180,148,-100
03/03/2019 11:05,2018,1,WESTERN EUROPE-EU,FRANCE,2,SOUTHAMPTON,TOULON / HYERES,3502,3502,0,9024,9024,0,-61.19238
03/03/2019 11:05,2018,1,WESTERN EUROPE-EU,FRANCE,2,SOUTHAMPTON,TOULOUSE (BLAGNAC),0,0,0,1,1,0,-100
03/03/2019 11:05,2018,1,WESTERN EUROPE-EU,GERMANY,1,GATWICK,BERLIN (SCHONEFELD),290056,290056,0,488945,488497,448,-40.67717
03/03/2019 11:05,2018,1,WESTERN EUROPE-EU,GERMANY,1,GATWICK,BERLIN (TEGEL),173730,173730,0,0,0,0,0
03/03/2019 11:05,2018,1,WESTERN EUROPE-EU,GERMANY,1,GATWICK,BRAUNSCHWEIG,39,0,39,0,0,0,0
03/03/2019 11:05,2018,1,WESTERN EUROPE-EU,GERMANY,1,GATWICK,COLOGNE BONN,6821,6821,0,0,0,0,0
03/03/2019 11:05,2018,1,WESTERN EUROPE-EU,GERMANY,1,GATWICK,DRESDEN,0,0,0,1430,1430,0,-100
03/03/2019 11:05,2018,1,WESTERN EUROPE-EU,GERMANY,1,GATWICK,DUSSELDORF,37,0,37,8,0,8,362.5
03/03/2019 11:05,2018,1,WESTERN EUROPE-EU,GERMANY,1,GATWICK,ERFURT,0,0,0,1,0,1,-100
03/03/2019 11:05,2018,1,WESTERN EUROPE-EU,GERMANY,1,GATWICK,FRANKFURT MAIN,361,172,189,89,50,39,305.61798
03/03/2019 11:05,2018,1,WESTERN EUROPE-EU,GERMANY,1,GATWICK,FRIEDRICHSHAFEN,23513,14642,8871,22405,15412,6993,4.94532
03/03/2019 11:05,2018,1,WESTERN EUROPE-EU,GERMANY,1,GATWICK,HAMBURG,167827,167827,0,154660,154660,0,8.51351
03/03/2019 11:05,2018,1,WESTERN EUROPE-EU,GERMANY,1,GATWICK,LEIPZIG,0,0,0,557,0,557,-100
03/03/2019 11:05,2018,1,WESTERN EUROPE-EU,GERMANY,1,GATWICK,MUNICH,250777,250777,0,254956,254209,747,-1.63911
03/03/2019 11:05,2018,1,WESTERN EUROPE-EU,GERMANY,1,GATWICK,MUNSTER-OSNABRUCK,0,0,0,139,0,139,-100
03/03/2019 11:05,2018,1,WESTERN EUROPE-EU,GERMANY,1,GATWICK,NUREMBERG,7735,7735,0,4691,4691,0,64.89022
03/03/2019 11:05,2018,1,WESTERN EUROPE-EU,GERMANY,1,GATWICK,ROSTOCK-LAAGE,0,0,0,1,0,1,-100
03/03/2019 11:05,2018,1,WESTERN EUROPE-EU,GERMANY,1,GATWICK,STUTTGART,125629,125629,0,128760,128580,180,-2.43166
03/03/2019 11:05,2018,1,WESTERN EUROPE-EU,GERMANY,1,HEATHROW,BERLIN (TEGEL),817252,817252,0,779203,778561,642,4.88307
03/03/2019 11:05,2018,1,WESTERN EUROPE-EU,GERMANY,1,HEATHROW,COLOGNE BONN,193790,193790,0,179102,179030,72,8.20091
03/03/2019 11:05,2018,1,WESTERN EUROPE-EU,GERMANY,1,HEATHROW,DUSSELDORF,737313,737313,0,741486,741486,0,-0.56279
03/03/2019 11:05,2018,1,WESTERN EUROPE-EU,GERMANY,1,HEATHROW,FRANKFURT MAIN,1559218,1559218,0,1501134,1501134,0,3.86934
03/03/2019 11:05,2018,1,WESTERN EUROPE-EU,GERMANY,1,HEATHROW,FRIEDRICHSHAFEN,604,0,604,814,0,814,-25.79853
03/03/2019 11:05,2018,1,WESTERN EUROPE-EU,GERMANY,1,HEATHROW,HAMBURG,600913,600913,0,584508,584508,0,2.80663
03/03/2019 11:05,2018,1,WESTERN EUROPE-EU,GERMANY,1,HEATHROW,HANOVER,213722,213722,0,212274,212274,0,0.68214
03/03/2019 11:05,2018,1,WESTERN EUROPE-EU,GERMANY,1,HEATHROW,MUNICH,1242063,1242063,0,1190441,1190441,0,4.33638
03/03/2019 11:05,2018,1,WESTERN EUROPE-EU,GERMANY,1,HEATHROW,STUTTGART,343928,343928,0,317014,317014,0,8.48985
03/03/2019 11:05,2018,1,WESTERN EUROPE-EU,GERMANY,1,LONDON CITY,BERLIN (TEGEL),122062,122062,0,109586,109492,94,11.38467
03/03/2019 11:05,2018,1,WESTERN EUROPE-EU,GERMANY,1,LONDON CITY,BREMEN,0,0,0,985,985,0,-100
03/03/2019 11:05,2018,1,WESTERN EUROPE-EU,GERMANY,1,LONDON CITY,DUSSELDORF,160406,160406,0,155803,155803,0,2.95437
03/03/2019 11:05,2018,1,WESTERN EUROPE-EU,GERMANY,1,LONDON CITY,FRANKFURT MAIN,249937,249937,0,247322,247250,72,1.05733
03/03/2019 11:05,2018,1,WESTERN EUROPE-EU,GERMANY,1,LONDON CITY,HAMBURG,0,0,0,13291,13291,0,-100
03/03/2019 11:05,2018,1,WESTERN EUROPE-EU,GERMANY,1,LONDON CITY,MUNSTER-OSNABRUCK,0,0,0,44,0,44,-100
03/03/2019 11:05,2018,1,WESTERN EUROPE-EU,GERMANY,1,LONDON CITY,SAARBRUCKEN,67,67,0,0,0,0,0
03/03/2019 11:05,2018,1,WESTERN EUROPE-EU,GERMANY,1,LUTON,BERLIN (SCHONEFELD),179320,179320,0,187393,187393,0,-4.30806
03/03/2019 11:05,2018,1,WESTERN EUROPE-EU,GERMANY,1,LUTON,BERLIN (TEGEL),461,461,0,99,0,99,365.65657
03/03/2019 11:05,2018,1,WESTERN EUROPE-EU,GERMANY,1,LUTON,COLOGNE BONN,874,874,0,226,83,143,286.72566
03/03/2019 11:05,2018,1,WESTERN EUROPE-EU,GERMANY,1,LUTON,DORTMUND,101750,101750,0,95283,95283,0,6.78715
03/03/2019 11:05,2018,1,WESTERN EUROPE-EU,GERMANY,1,LUTON,DRESDEN,149,0,149,709,709,0,-78.98449
03/03/2019 11:05,2018,1,WESTERN EUROPE-EU,GERMANY,1,LUTON,FRANKFURT MAIN,217,0,217,15,0,15,1346.66667
03/03/2019 11:05,2018,1,WESTERN EUROPE-EU,GERMANY,1,LUTON,HAMBURG,12556,12556,0,84567,84567,0,-85.1526
03/03/2019 11:05,2018,1,WESTERN EUROPE-EU,GERMANY,1,LUTON,HANOVER,0,0,0,152,152,0,-100
03/03/2019 11:05,2018,1,WESTERN EUROPE-EU,GERMANY,1,LUTON,LEIPZIG,193,193,0,0,0,0,0
03/03/2019 11:05,2018,1,WESTERN EUROPE-EU,GERMANY,1,LUTON,MEMMINGEN ALLGAU,0,0,0,2,0,2,-100
03/03/2019 11:05,2018,1,WESTERN EUROPE-EU,GERMANY,1,LUTON,MUNICH,80873,80873,0,94553,94023,530,-14.46808
03/03/2019 11:05,2018,1,WESTERN EUROPE-EU,GERMANY,1,LUTON,MUNSTER-OSNABRUCK,223,223,0,0,0,0,0
03/03/2019 11:05,2018,1,WESTERN EUROPE-EU,GERMANY,1,LUTON,NIEDERRHEIN,175,175,0,19956,19956,0,-99.12307
03/03/2019 11:05,2018,1,WESTERN EUROPE-EU,GERMANY,1,LUTON,STUTTGART,0,0,0,208,0,208,-100
03/03/2019 11:05,2018,1,WESTERN EUROPE-EU,GERMANY,1,SOUTHEND,BREMEN,0,0,0,41,41,0,-100
03/03/2019 11:05,2018,1,WESTERN EUROPE-EU,GERMANY,1,SOUTHEND,COLOGNE BONN,30518,30518,0,17540,17540,0,73.99088
03/03/2019 11:05,2018,1,WESTERN EUROPE-EU,GERMANY,1,SOUTHEND,DUSSELDORF,57,57,0,168,168,0,-66.07143
03/03/2019 11:05,2018,1,WESTERN EUROPE-EU,GERMANY,1,SOUTHEND,FRANKFURT MAIN,0,0,0,31,31,0,-100
03/03/2019 11:05,2018,1,WESTERN EUROPE-EU,GERMANY,1,SOUTHEND,HAMBURG,0,0,0,37,37,0,-100
03/03/2019 11:05,2018,1,WESTERN EUROPE-EU,GERMANY,1,SOUTHEND,PADERBORN,247,247,0,0,0,0,0
03/03/2019 11:05,2018,1,WESTERN EUROPE-EU,GERMANY,1,STANSTED,BERLIN (SCHONEFELD),453167,453000,167,437820,437820,0,3.50532
03/03/2019 11:05,2018,1,WESTERN EUROPE-EU,GERMANY,1,STANSTED,BERLIN (TEGEL),7248,7152,96,7121,7020,101,1.78346
03/03/2019 11:05,2018,1,WESTERN EUROPE-EU,GERMANY,1,STANSTED,BRAUNSCHWEIG,0,0,0,255,0,255,-100
03/03/2019 11:05,2018,1,WESTERN EUROPE-EU,GERMANY,1,STANSTED,BREMEN,186731,186731,0,156937,156937,0,18.98469
03/03/2019 11:05,2018,1,WESTERN EUROPE-EU,GERMANY,1,STANSTED,COLOGNE BONN,438037,437498,539,414955,414672,283,5.56253
03/03/2019 11:05,2018,1,WESTERN EUROPE-EU,GERMANY,1,STANSTED,DORTMUND,118369,118302,67,119523,119523,0,-0.9655
03/03/2019 11:05,2018,1,WESTERN EUROPE-EU,GERMANY,1,STANSTED,DUSSELDORF,0,0,0,85,85,0,-100
03/03/2019 11:05,2018,1,WESTERN EUROPE-EU,GERMANY,1,STANSTED,FRANKFURT MAIN,229780,229780,0,54861,54861,0,318.84034
03/03/2019 11:05,2018,1,WESTERN EUROPE-EU,GERMANY,1,STANSTED,FRIEDRICHSHAFEN,160,160,0,146,146,0,9.58904
03/03/2019 11:05,2018,1,WESTERN EUROPE-EU,GERMANY,1,STANSTED,HAHN,106260,106260,0,118544,118544,0,-10.3624
03/03/2019 11:05,2018,1,WESTERN EUROPE-EU,GERMANY,1,STANSTED,HAMBURG,199345,199345,0,216774,216774,0,-8.04017
03/03/2019 11:05,2018,1,WESTERN EUROPE-EU,GERMANY,1,STANSTED,HANOVER,74475,74475,0,55915,55915,0,33.19324
03/03/2019 11:05,2018,1,WESTERN EUROPE-EU,GERMANY,1,STANSTED,KARLSRUHE/BADEN BADEN,127567,127567,0,122582,122582,0,4.06667
03/03/2019 11:05,2018,1,WESTERN EUROPE-EU,GERMANY,1,STANSTED,LEIPZIG,48006,48006,0,49561,49561,0,-3.13755
03/03/2019 11:05,2018,1,WESTERN EUROPE-EU,GERMANY,1,STANSTED,MEMMINGEN ALLGAU,88960,88960,0,94015,94015,0,-5.3768
03/03/2019 11:05,2018,1,WESTERN EUROPE-EU,GERMANY,1,STANSTED,MUNICH,169474,168536,938,159315,158380,935,6.37668
03/03/2019 11:05,2018,1,WESTERN EUROPE-EU,GERMANY,1,STANSTED,MUNSTER-OSNABRUCK,0,0,0,146,0,146,-100
03/03/2019 11:05,2018,1,WESTERN EUROPE-EU,GERMANY,1,STANSTED,NIEDERRHEIN,42246,42246,0,31960,31960,0,32.18398
03/03/2019 11:05,2018,1,WESTERN EUROPE-EU,GERMANY,1,STANSTED,NUREMBERG,192367,192367,0,192636,192636,0,-0.13964
03/03/2019 11:05,2018,1,WESTERN EUROPE-EU,GERMANY,1,STANSTED,STUTTGART,16508,16508,0,80110,80110,0,-79.39333
03/03/2019 11:05,2018,1,WESTERN EUROPE-EU,GERMANY,2,ABERDEEN,FRANKFURT MAIN,18573,18573,0,103506,103506,0,-82.05611
03/03/2019 11:05,2018,1,WESTERN EUROPE-EU,GERMANY,2,ABERDEEN,FRIEDRICHSHAFEN,0,0,0,150,0,150,-100
03/03/2019 11:05,2018,1,WESTERN EUROPE-EU,GERMANY,2,ABERDEEN,HAHN,171,171,0,0,0,0,0
03/03/2019 11:05,2018,1,WESTERN EUROPE-EU,GERMANY,2,BELFAST CITY (GEORGE BEST),FRANKFURT MAIN,0,0,0,120,0,120,-100
03/03/2019 11:05,2018,1,WESTERN EUROPE-EU,GERMANY,2,BELFAST INTERNATIONAL,BERLIN (SCHONEFELD),34305,34305,0,44683,44683,0,-23.22584
03/03/2019 11:05,2018,1,WESTERN EUROPE-EU,GERMANY,2,BELFAST INTERNATIONAL,FRANKFURT MAIN,0,0,0,276,0,276,-100
03/03/2019 11:05,2018,1,WESTERN EUROPE-EU,GERMANY,2,BIRMINGHAM,BERLIN (SCHONEFELD),360,360,0,176,176,0,104.54545
03/03/2019 11:05,2018,1,WESTERN EUROPE-EU,GERMANY,2,BIRMINGHAM,BERLIN (TEGEL),62211,62087,124,75815,75736,79,-17.94368
03/03/2019 11:05,2018,1,WESTERN EUROPE-EU,GERMANY,2,BIRMINGHAM,BREMEN,0,0,0,3,3,0,-100
03/03/2019 11:05,2018,1,WESTERN EUROPE-EU,GERMANY,2,BIRMINGHAM,COLOGNE BONN,463,206,257,41,41,0,1029.26829
03/03/2019 11:05,2018,1,WESTERN EUROPE-EU,GERMANY,2,BIRMINGHAM,DORTMUND,79,0,79,149,0,149,-46.97987
03/03/2019 11:05,2018,1,WESTERN EUROPE-EU,GERMANY,2,BIRMINGHAM,DRESDEN,0,0,0,136,0,136,-100
03/03/2019 11:05,2018,1,WESTERN EUROPE-EU,GERMANY,2,BIRMINGHAM,DUSSELDORF,270446,270446,0,270940,270874,66,-0.18233
03/03/2019 11:05,2018,1,WESTERN EUROPE-EU,GERMANY,2,BIRMINGHAM,FRANKFURT MAIN,321985,321985,0,306599,306450,149,5.01828
03/03/2019 11:05,2018,1,WESTERN EUROPE-EU,GERMANY,2,BIRMINGHAM,FRIEDRICHSHAFEN,0,0,0,48,0,48,-100
03/03/2019 11:05,2018,1,WESTERN EUROPE-EU,GERMANY,2,BIRMINGHAM,HAHN,183,183,0,0,0,0,0
03/03/2019 11:05,2018,1,WESTERN EUROPE-EU,GERMANY,2,BIRMINGHAM,HAMBURG,33936,33936,0,24505,24505,0,38.48602
03/03/2019 11:05,2018,1,WESTERN EUROPE-EU,GERMANY,2,BIRMINGHAM,HANOVER,34513,34396,117,41355,41355,0,-16.54455
03/03/2019 11:05,2018,1,WESTERN EUROPE-EU,GERMANY,2,BIRMINGHAM,LEIPZIG,0,0,0,118,118,0,-100
03/03/2019 11:05,2018,1,WESTERN EUROPE-EU,GERMANY,2,BIRMINGHAM,MUNICH,209484,208630,854,204954,203597,1357,2.21025
03/03/2019 11:05,2018,1,WESTERN EUROPE-EU,GERMANY,2,BIRMINGHAM,NIEDERRHEIN,0,0,0,46,0,46,-100
03/03/2019 11:05,2018,1,WESTERN EUROPE-EU,GERMANY,2,BIRMINGHAM,NUREMBERG,0,0,0,5782,5782,0,-100
03/03/2019 11:05,2018,1,WESTERN EUROPE-EU,GERMANY,2,BIRMINGHAM,PADERBORN,741,741,0,4818,3732,1086,-84.62017
03/03/2019 11:05,2018,1,WESTERN EUROPE-EU,GERMANY,2,BIRMINGHAM,STUTTGART,67465,67465,0,68457,68457,0,-1.44908
03/03/2019 11:05,2018,1,WESTERN EUROPE-EU,GERMANY,2,BOURNEMOUTH,MUNICH,0,0,0,53,0,53,-100
03/03/2019 11:05,2018,1,WESTERN EUROPE-EU,GERMANY,2,BOURNEMOUTH,NIEDERRHEIN,0,0,0,46,0,46,-100
03/03/2019 11:05,2018,1,WESTERN EUROPE-EU,GERMANY,2,BRISTOL,BERLIN (SCHONEFELD),94480,94480,0,83438,83438,0,13.23378
03/03/2019 11:05,2018,1,WESTERN EUROPE-EU,GERMANY,2,BRISTOL,BERLIN (TEGEL),2,2,0,0,0,0,0
03/03/2019 11:05,2018,1,WESTERN EUROPE-EU,GERMANY,2,BRISTOL,BREMEN,0,0,0,50,0,50,-100
03/03/2019 11:05,2018,1,WESTERN EUROPE-EU,GERMANY,2,BRISTOL,COLOGNE BONN,59549,59549,0,10758,10758,0,453.53226
03/03/2019 11:05,2018,1,WESTERN EUROPE-EU,GERMANY,2,BRISTOL,DORTMUND,0,0,0,215,0,215,-100
03/03/2019 11:05,2018,1,WESTERN EUROPE-EU,GERMANY,2,BRISTOL,DUSSELDORF,12807,12807,0,16196,16196,0,-20.92492
03/03/2019 11:05,2018,1,WESTERN EUROPE-EU,GERMANY,2,BRISTOL,FRANKFURT MAIN,53277,53277,0,49342,49342,0,7.97495
03/03/2019 11:05,2018,1,WESTERN EUROPE-EU,GERMANY,2,BRISTOL,HAMBURG,13071,13071,0,15483,15483,0,-15.57838
03/03/2019 11:05,2018,1,WESTERN EUROPE-EU,GERMANY,2,BRISTOL,MUNICH,47994,47994,0,42482,42241,241,12.97491
03/03/2019 11:05,2018,1,WESTERN EUROPE-EU,GERMANY,2,BRISTOL,ROSTOCK-LAAGE,29,29,0,0,0,0,0
03/03/2019 11:05,2018,1,WESTERN EUROPE-EU,GERMANY,2,BRISTOL,STUTTGART,0,0,0,95,0,95,-100
03/03/2019 11:05,2018,1,WESTERN EUROPE-EU,GERMANY,2,CARDIFF WALES,BERLIN (SCHONEFELD),144,144,0,43,43,0,234.88372
03/03/2019 11:05,2018,1,WESTERN EUROPE-EU,GERMANY,2,CARDIFF WALES,BERLIN (TEGEL),14894,14801,93,18559,18559,0,-19.74783
03/03/2019 11:05,2018,1,WESTERN EUROPE-EU,GERMANY,2,CARDIFF WALES,BRAUNSCHWEIG,45,0,45,0,0,0,0
03/03/2019 11:05,2018,1,WESTERN EUROPE-EU,GERMANY,2,CARDIFF WALES,DUSSELDORF,3235,3235,0,2663,2663,0,21.47953
03/03/2019 11:05,2018,1,WESTERN EUROPE-EU,GERMANY,2,CARDIFF WALES,FRANKFURT MAIN,66,66,0,131,91,40,-49.61832
03/03/2019 11:05,2018,1,WESTERN EUROPE-EU,GERMANY,2,CARDIFF WALES,HAHN,0,0,0,101,0,101,-100
03/03/2019 11:05,2018,1,WESTERN EUROPE-EU,GERMANY,2,CARDIFF WALES,HAMBURG,12,12,0,32,32,0,-62.5
03/03/2019 11:05,2018,1,WESTERN EUROPE-EU,GERMANY,2,CARDIFF WALES,MUNICH,15783,15739,44,17955,17955,0,-12.09691
03/03/2019 11:05,2018,1,WESTERN EUROPE-EU,GERMANY,2,DONCASTER SHEFFIELD,BERLIN (TEGEL),3487,3487,0,20247,20247,0,-82.7777
03/03/2019 11:05,2018,1,WESTERN EUROPE-EU,GERMANY,2,DONCASTER SHEFFIELD,DUSSELDORF,0,0,0,1229,1229,0,-100
03/03/2019 11:05,2018,1,WESTERN EUROPE-EU,GERMANY,2,DURHAM TEES VALLEY,FRIEDRICHSHAFEN,0,0,0,115,115,0,-100
03/03/2019 11:05,2018,1,WESTERN EUROPE-EU,GERMANY,2,DURHAM TEES VALLEY,MEMMINGEN ALLGAU,0,0,0,45,0,45,-100
03/03/2019 11:05,2018,1,WESTERN EUROPE-EU,GERMANY,2,EAST MIDLANDS INTERNATIONAL,BERLIN (SCHONEFELD),48429,48429,0,49896,49896,0,-2.94012
03/03/2019 11:05,2018,1,WESTERN EUROPE-EU,GERMANY,2,EAST MIDLANDS INTERNATIONAL,BREMEN,110,110,0,0,0,0,0
03/03/2019 11:05,2018,1,WESTERN EUROPE-EU,GERMANY,2,EAST MIDLANDS INTERNATIONAL,COLOGNE BONN,585,175,410,183,183,0,219.67213
03/03/2019 11:05,2018,1,WESTERN EUROPE-EU,GERMANY,2,EAST MIDLANDS INTERNATIONAL,DUSSELDORF,33,0,33,48,0,48,-31.25
03/03/2019 11:05,2018,1,WESTERN EUROPE-EU,GERMANY,2,EAST MIDLANDS INTERNATIONAL,HAMBURG,122,122,0,174,174,0,-29.88506
03/03/2019 11:05,2018,1,WESTERN EUROPE-EU,GERMANY,2,EAST MIDLANDS INTERNATIONAL,LEIPZIG,0,0,0,321,321,0,-100
03/03/2019 11:05,2018,1,WESTERN EUROPE-EU,GERMANY,2,EAST MIDLANDS INTERNATIONAL,MUNSTER-OSNABRUCK,0,0,0,212,0,212,-100
03/03/2019 11:05,2018,1,WESTERN EUROPE-EU,GERMANY,2,EDINBURGH,BERLIN (SCHONEFELD),42968,41834,1134,79769,79769,0,-46.13446
03/03/2019 11:05,2018,1,WESTERN EUROPE-EU,GERMANY,2,EDINBURGH,BERLIN (TEGEL),70613,70510,103,0,0,0,0
03/03/2019 11:05,2018,1,WESTERN EUROPE-EU,GERMANY,2,EDINBURGH,BREMEN,0,0,0,31704,31704,0,-100
03/03/2019 11:05,2018,1,WESTERN EUROPE-EU,GERMANY,2,EDINBURGH,COLOGNE BONN,59730,59730,0,56179,55926,253,6.32087
03/03/2019 11:05,2018,1,WESTERN EUROPE-EU,GERMANY,2,EDINBURGH,DUSSELDORF,35339,35244,95,27596,27596,0,28.05841
03/03/2019 11:05,2018,1,WESTERN EUROPE-EU,GERMANY,2,EDINBURGH,FRANKFURT MAIN,194227,194077,150,190659,190601,58,1.8714
03/03/2019 11:05,2018,1,WESTERN EUROPE-EU,GERMANY,2,EDINBURGH,FRIEDRICHSHAFEN,0,0,0,30,0,30,-100
03/03/2019 11:05,2018,1,WESTERN EUROPE-EU,GERMANY,2,EDINBURGH,HAHN,30037,30037,0,30756,30756,0,-2.33776
03/03/2019 11:05,2018,1,WESTERN EUROPE-EU,GERMANY,2,EDINBURGH,HAMBURG,111062,111062,0,72617,72617,0,52.94215
03/03/2019 11:05,2018,1,WESTERN EUROPE-EU,GERMANY,2,EDINBURGH,KARLSRUHE/BADEN BADEN,25034,25034,0,4256,4256,0,488.20489
03/03/2019 11:05,2018,1,WESTERN EUROPE-EU,GERMANY,2,EDINBURGH,MEMMINGEN ALLGAU,4459,4459,0,0,0,0,0
03/03/2019 11:05,2018,1,WESTERN EUROPE-EU,GERMANY,2,EDINBURGH,MUNICH,154084,154084,0,148259,148259,0,3.92894
03/03/2019 11:05,2018,1,WESTERN EUROPE-EU,GERMANY,2,EDINBURGH,NIEDERRHEIN,36650,36650,0,52631,52631,0,-30.36423
03/03/2019 11:05,2018,1,WESTERN EUROPE-EU,GERMANY,2,EDINBURGH,STUTTGART,29510,29510,0,28836,28836,0,2.33736
03/03/2019 11:05,2018,1,WESTERN EUROPE-EU,GERMANY,2,EXETER,DUSSELDORF,0,0,0,50,50,0,-100
03/03/2019 11:05,2018,1,WESTERN EUROPE-EU,GERMANY,2,EXETER,FRANKFURT MAIN,0,0,0,114,114,0,-100
03/03/2019 11:05,2018,1,WESTERN EUROPE-EU,GERMANY,2,EXETER,FRIEDRICHSHAFEN,0,0,0,130,0,130,-100
03/03/2019 11:05,2018,1,WESTERN EUROPE-EU,GERMANY,2,EXETER,HAMBURG,0,0,0,90,90,0,-100
03/03/2019 11:05,2018,1,WESTERN EUROPE-EU,GERMANY,2,EXETER,MUNICH,56,56,0,138,106,32,-59.42029
03/03/2019 11:05,2018,1,WESTERN EUROPE-EU,GERMANY,2,GLASGOW,BERLIN (SCHONEFELD),179862,179753,109,207428,207428,0,-13.28943
03/03/2019 11:05,2018,1,WESTERN EUROPE-EU,GERMANY,2,GLASGOW,DRESDEN,0,0,0,130,130,0,-100
03/03/2019 11:05,2018,1,WESTERN EUROPE-EU,GERMANY,2,GLASGOW,DUSSELDORF,41368,41368,0,51113,51113,0,-19.0656
03/03/2019 11:05,2018,1,WESTERN EUROPE-EU,GERMANY,2,GLASGOW,ERFURT,141,0,141,142,0,142,-0.70423
03/03/2019 11:05,2018,1,WESTERN EUROPE-EU,GERMANY,2,GLASGOW,FRANKFURT MAIN,113506,113271,235,29940,29784,156,279.11156
03/03/2019 11:05,2018,1,WESTERN EUROPE-EU,GERMANY,2,GLASGOW,FRIEDRICHSHAFEN,0,0,0,64,0,64,-100
03/03/2019 11:05,2018,1,WESTERN EUROPE-EU,GERMANY,2,GLASGOW,HAMBURG,61,0,61,0,0,0,0
03/03/2019 11:05,2018,1,WESTERN EUROPE-EU,GERMANY,2,GLASGOW,KARLSRUHE/BADEN BADEN,23,0,23,0,0,0,0
03/03/2019 11:05,2018,1,WESTERN EUROPE-EU,GERMANY,2,GLASGOW,LEIPZIG,1396,0,1396,606,0,606,130.36304
03/03/2019 11:05,2018,1,WESTERN EUROPE-EU,GERMANY,2,GLASGOW,MUNICH,47873,47726,147,10711,7120,3591,346.95173
03/03/2019 11:05,2018,1,WESTERN EUROPE-EU,GERMANY,2,GUERNSEY,DUSSELDORF,2827,2827,0,1191,1191,0,137.36356
03/03/2019 11:05,2018,1,WESTERN EUROPE-EU,GERMANY,2,HUMBERSIDE,FRIEDRICHSHAFEN,0,0,0,244,0,244,-100
03/03/2019 11:05,2018,1,WESTERN EUROPE-EU,GERMANY,2,ISLE OF MAN,COLOGNE BONN,210,105,105,0,0,0,0
03/03/2019 11:05,2018,1,WESTERN EUROPE-EU,GERMANY,2,ISLE OF MAN,FRIEDRICHSHAFEN,0,0,0,101,0,101,-100
03/03/2019 11:05,2018,1,WESTERN EUROPE-EU,GERMANY,2,JERSEY,BERLIN (TEGEL),1567,1567,0,0,0,0,0
03/03/2019 11:05,2018,1,WESTERN EUROPE-EU,GERMANY,2,JERSEY,BREMEN,0,0,0,290,290,0,-100
03/03/2019 11:05,2018,1,WESTERN EUROPE-EU,GERMANY,2,JERSEY,DRESDEN,160,0,160,288,288,0,-44.44444
03/03/2019 11:05,2018,1,WESTERN EUROPE-EU,GERMANY,2,JERSEY,DUSSELDORF,7306,6252,1054,7656,7656,0,-4.57158
03/03/2019 11:05,2018,1,WESTERN EUROPE-EU,GERMANY,2,JERSEY,ERFURT,219,0,219,73,0,73,200
03/03/2019 11:05,2018,1,WESTERN EUROPE-EU,GERMANY,2,JERSEY,FRANKFURT MAIN,0,0,0,294,294,0,-100
03/03/2019 11:05,2018,1,WESTERN EUROPE-EU,GERMANY,2,JERSEY,FRIEDRICHSHAFEN,0,0,0,420,282,138,-100
03/03/2019 11:05,2018,1,WESTERN EUROPE-EU,GERMANY,2,JERSEY,HAMBURG,397,397,0,0,0,0,0
03/03/2019 11:05,2018,1,WESTERN EUROPE-EU,GERMANY,2,JERSEY,KASSEL,0,0,0,230,230,0,-100
03/03/2019 11:05,2018,1,WESTERN EUROPE-EU,GERMANY,2,JERSEY,MUNICH,3991,3991,0,3244,3244,0,23.02713
03/03/2019 11:05,2018,1,WESTERN EUROPE-EU,GERMANY,2,JERSEY,STUTTGART,297,0,297,146,146,0,103.42466
03/03/2019 11:05,2018,1,WESTERN EUROPE-EU,GERMANY,2,LEEDS BRADFORD,BERLIN (SCHONEFELD),21227,21227,0,18270,18270,0,16.185
03/03/2019 11:05,2018,1,WESTERN EUROPE-EU,GERMANY,2,LEEDS BRADFORD,BERLIN (TEGEL),0,0,0,31,31,0,-100
03/03/2019 11:05,2018,1,WESTERN EUROPE-EU,GERMANY,2,LEEDS BRADFORD,COLOGNE BONN,373,373,0,0,0,0,0
03/03/2019 11:05,2018,1,WESTERN EUROPE-EU,GERMANY,2,LEEDS BRADFORD,DUSSELDORF,32844,32844,0,45761,45761,0,-28.22709
03/03/2019 11:05,2018,1,WESTERN EUROPE-EU,GERMANY,2,LEEDS BRADFORD,FRANKFURT MAIN,47,47,0,0,0,0,0
03/03/2019 11:05,2018,1,WESTERN EUROPE-EU,GERMANY,2,LEEDS BRADFORD,FRIEDRICHSHAFEN,0,0,0,118,0,118,-100
03/03/2019 11:05,2018,1,WESTERN EUROPE-EU,GERMANY,2,LEEDS BRADFORD,MUNICH,0,0,0,120,120,0,-100
03/03/2019 11:05,2018,1,WESTERN EUROPE-EU,GERMANY,2,LIVERPOOL (JOHN LENNON),BERLIN (SCHONEFELD),65258,65258,0,60812,60812,0,7.31106
03/03/2019 11:05,2018,1,WESTERN EUROPE-EU,GERMANY,2,LIVERPOOL (JOHN LENNON),BREMEN,0,0,0,157,157,0,-100
03/03/2019 11:05,2018,1,WESTERN EUROPE-EU,GERMANY,2,LIVERPOOL (JOHN LENNON),BUCHEL,0,0,0,155,155,0,-100
03/03/2019 11:05,2018,1,WESTERN EUROPE-EU,GERMANY,2,LIVERPOOL (JOHN LENNON),DRESDEN,0,0,0,175,175,0,-100
03/03/2019 11:05,2018,1,WESTERN EUROPE-EU,GERMANY,2,LIVERPOOL (JOHN LENNON),DUSSELDORF,0,0,0,178,178,0,-100
03/03/2019 11:05,2018,1,WESTERN EUROPE-EU,GERMANY,2,LIVERPOOL (JOHN LENNON),FRANKFURT MAIN,0,0,0,321,154,167,-100
03/03/2019 11:05,2018,1,WESTERN EUROPE-EU,GERMANY,2,LIVERPOOL (JOHN LENNON),HAMBURG,0,0,0,3264,3264,0,-100
03/03/2019 11:05,2018,1,WESTERN EUROPE-EU,GERMANY,2,LIVERPOOL (JOHN LENNON),MUNICH,0,0,0,117,0,117,-100
03/03/2019 11:05,2018,1,WESTERN EUROPE-EU,GERMANY,2,MANCHESTER,BADEN BADEN,287,0,287,353,0,353,-18.69688
03/03/2019 11:05,2018,1,WESTERN EUROPE-EU,GERMANY,2,MANCHESTER,BERLIN (SCHONEFELD),332579,332447,132,306899,306705,194,8.36757
03/03/2019 11:05,2018,1,WESTERN EUROPE-EU,GERMANY,2,MANCHESTER,BRAUNSCHWEIG,336,0,336,368,0,368,-8.69565
03/03/2019 11:05,2018,1,WESTERN EUROPE-EU,GERMANY,2,MANCHESTER,BREMEN,0,0,0,897,897,0,-100
03/03/2019 11:05,2018,1,WESTERN EUROPE-EU,GERMANY,2,MANCHESTER,COLOGNE BONN,130116,130116,0,72378,72378,0,79.77286
03/03/2019 11:05,2018,1,WESTERN EUROPE-EU,GERMANY,2,MANCHESTER,DUSSELDORF,271722,271722,0,247205,247205,0,9.91768
03/03/2019 11:05,2018,1,WESTERN EUROPE-EU,GERMANY,2,MANCHESTER,FRANKFURT MAIN,526188,525942,246,398622,398339,283,32.00175
03/03/2019 11:05,2018,1,WESTERN EUROPE-EU,GERMANY,2,MANCHESTER,FRIEDRICHSHAFEN,0,0,0,31,0,31,-100
03/03/2019 11:05,2018,1,WESTERN EUROPE-EU,GERMANY,2,MANCHESTER,HAHN,293,0,293,0,0,0,0
03/03/2019 11:05,2018,1,WESTERN EUROPE-EU,GERMANY,2,MANCHESTER,HAMBURG,226171,226171,0,285420,285420,0,-20.75853
03/03/2019 11:05,2018,1,WESTERN EUROPE-EU,GERMANY,2,MANCHESTER,HANOVER,36737,36641,96,41572,41572,0,-11.63042
03/03/2019 11:05,2018,1,WESTERN EUROPE-EU,GERMANY,2,MANCHESTER,MUNICH,344957,344270,687,347022,346102,920,-0.59506
03/03/2019 11:05,2018,1,WESTERN EUROPE-EU,GERMANY,2,MANCHESTER,NUREMBERG,86181,86181,0,102927,102927,0,-16.26978
03/03/2019 11:05,2018,1,WESTERN EUROPE-EU,GERMANY,2,MANCHESTER,STUTTGART,78791,78791,0,94095,94095,0,-16.26441
03/03/2019 11:05,2018,1,WESTERN EUROPE-EU,GERMANY,2,NEWCASTLE,AUGSBURG/MUELHAUSEN,32,0,32,0,0,0,0
03/03/2019 11:05,2018,1,WESTERN EUROPE-EU,GERMANY,2,NEWCASTLE,BERLIN (SCHONEFELD),40155,40155,0,40848,40687,161,-1.69653
03/03/2019 11:05,2018,1,WESTERN EUROPE-EU,GERMANY,2,NEWCASTLE,BRAUNSCHWEIG,0,0,0,92,0,92,-100
03/03/2019 11:05,2018,1,WESTERN EUROPE-EU,GERMANY,2,NEWCASTLE,COLOGNE BONN,20,0,20,0,0,0,0
03/03/2019 11:05,2018,1,WESTERN EUROPE-EU,GERMANY,2,NEWCASTLE,DUSSELDORF,38259,38259,0,46103,46103,0,-17.01408
03/03/2019 11:05,2018,1,WESTERN EUROPE-EU,GERMANY,2,NEWCASTLE,FRANKFURT MAIN,0,0,0,302,0,302,-100
03/03/2019 11:05,2018,1,WESTERN EUROPE-EU,GERMANY,2,NEWCASTLE,MUNICH,283,283,0,287,287,0,-1.39373
03/03/2019 11:05,2018,1,WESTERN EUROPE-EU,GERMANY,2,NEWQUAY,BERLIN (TEGEL),1135,1135,0,0,0,0,0
03/03/2019 11:05,2018,1,WESTERN EUROPE-EU,GERMANY,2,NEWQUAY,DUSSELDORF,2678,2678,0,3954,3954,0,-32.27112
03/03/2019 11:05,2018,1,WESTERN EUROPE-EU,GERMANY,2,NEWQUAY,HAHN,17617,17617,0,16302,16302,0,8.06649
03/03/2019 11:05,2018,1,WESTERN EUROPE-EU,GERMANY,2,NEWQUAY,STUTTGART,2007,2007,0,0,0,0,0
03/03/2019 11:05,2018,1,WESTERN EUROPE-EU,GERMANY,2,NORWICH,DORTMUND,105,0,105,0,0,0,0
03/03/2019 11:05,2018,1,WESTERN EUROPE-EU,GERMANY,2,NORWICH,FRIEDRICHSHAFEN,0,0,0,70,0,70,-100
03/03/2019 11:05,2018,1,WESTERN EUROPE-EU,GERMANY,2,PRESTWICK,BERLIN (SCHONEFELD),0,0,0,366,183,183,-100
03/03/2019 11:05,2018,1,WESTERN EUROPE-EU,GERMANY,2,PRESTWICK,FRANKFURT MAIN,135,0,135,167,0,167,-19.16168
03/03/2019 11:05,2018,1,WESTERN EUROPE-EU,GERMANY,2,SOUTHAMPTON,BREMEN,134,134,0,0,0,0,0
03/03/2019 11:05,2018,1,WESTERN EUROPE-EU,GERMANY,2,SOUTHAMPTON,DUSSELDORF,30856,30762,94,30342,30342,0,1.69402
03/03/2019 11:05,2018,1,WESTERN EUROPE-EU,GERMANY,2,SOUTHAMPTON,FRIEDRICHSHAFEN,20,0,20,57,0,57,-64.91228
03/03/2019 11:05,2018,1,WESTERN EUROPE-EU,GERMANY,2,SOUTHAMPTON,HAMBURG,129,0,129,0,0,0,0
03/03/2019 11:05,2018,1,WESTERN EUROPE-EU,GERMANY,2,SOUTHAMPTON,MUNICH,4878,4878,0,33590,33590,0,-85.47782
03/03/2019 11:05,2018,1,WESTERN EUROPE-EU,GIBRALTAR,1,GATWICK,GIBRALTAR,188144,187989,155,202881,202881,0,-7.26386
03/03/2019 11:05,2018,1,WESTERN EUROPE-EU,GIBRALTAR,1,HEATHROW,GIBRALTAR,152710,152710,0,135879,135879,0,12.38676
03/03/2019 11:05,2018,1,WESTERN EUROPE-EU,GIBRALTAR,1,LUTON,GIBRALTAR,2120,2120,0,50846,50468,378,-95.83055
03/03/2019 11:05,2018,1,WESTERN EUROPE-EU,GIBRALTAR,2,BIRMINGHAM,GIBRALTAR,303,135,168,35586,35586,0,-99.14854
03/03/2019 11:05,2018,1,WESTERN EUROPE-EU,GIBRALTAR,2,BRISTOL,GIBRALTAR,48081,48081,0,43220,43220,0,11.24711
03/03/2019 11:05,2018,1,WESTERN EUROPE-EU,GIBRALTAR,2,CARDIFF WALES,GIBRALTAR,0,0,0,162,162,0,-100
03/03/2019 11:05,2018,1,WESTERN EUROPE-EU,GIBRALTAR,2,MANCHESTER,GIBRALTAR,43837,43837,0,95060,94812,248,-53.88491
03/03/2019 11:05,2018,1,WESTERN EUROPE-EU,GREECE,1,GATWICK,ATHENS,202016,202016,0,199298,199298,0,1.36379
03/03/2019 11:05,2018,1,WESTERN EUROPE-EU,GREECE,1,GATWICK,CHANIA,126705,87312,39393,120250,97376,22874,5.36798
03/03/2019 11:05,2018,1,WESTERN EUROPE-EU,GREECE,1,GATWICK,CORFU,233799,172869,60930,242496,172070,70426,-3.58645
03/03/2019 11:05,2018,1,WESTERN EUROPE-EU,GREECE,1,GATWICK,HERAKLION,274029,224006,50023,299361,232340,67021,-8.46202
03/03/2019 11:05,2018,1,WESTERN EUROPE-EU,GREECE,1,GATWICK,KALAMATA,37857,37857,0,35032,34991,41,8.06406
03/03/2019 11:05,2018,1,WESTERN EUROPE-EU,GREECE,1,GATWICK,KAVALA,32898,19431,13467,25360,12018,13342,29.72397
03/03/2019 11:05,2018,1,WESTERN EUROPE-EU,GREECE,1,GATWICK,KEFALLINIA,126441,95723,30718,128515,89900,38615,-1.61382
03/03/2019 11:05,2018,1,WESTERN EUROPE-EU,GREECE,1,GATWICK,KOS,124297,58784,65513,123186,57033,66153,0.90189
03/03/2019 11:05,2018,1,WESTERN EUROPE-EU,GREECE,1,GATWICK,LEMNOS,1065,0,1065,1086,0,1086,-1.9337
03/03/2019 11:05,2018,1,WESTERN EUROPE-EU,GREECE,1,GATWICK,MIKONOS,87815,87815,0,87644,87644,0,0.19511
03/03/2019 11:05,2018,1,WESTERN EUROPE-EU,GREECE,1,GATWICK,MYTILINI,9244,9244,0,8914,8914,0,3.70204
03/03/2019 11:05,2018,1,WESTERN EUROPE-EU,GREECE,1,GATWICK,PREVEZA,74887,39219,35668,100798,62119,38679,-25.70587
03/03/2019 11:05,2018,1,WESTERN EUROPE-EU,GREECE,1,GATWICK,RHODES,192095,132033,60062,191890,123637,68253,0.10683
03/03/2019 11:05,2018,1,WESTERN EUROPE-EU,GREECE,1,GATWICK,SALONIKA,165304,146739,18565,164269,144937,19332,0.63006
03/03/2019 11:05,2018,1,WESTERN EUROPE-EU,GREECE,1,GATWICK,SAMOS,10219,0,10219,9801,0,9801,4.26487
03/03/2019 11:05,2018,1,WESTERN EUROPE-EU,GREECE,1,GATWICK,SKIATHOS,46281,26139,20142,46452,17490,28962,-0.36812
03/03/2019 11:05,2018,1,WESTERN EUROPE-EU,GREECE,1,GATWICK,THIRA (SANTORINI),118106,108306,9800,122805,107698,15107,-3.82639
03/03/2019 11:05,2018,1,WESTERN EUROPE-EU,GREECE,1,GATWICK,VOLOS NEA ANCHILOS,7806,6237,1569,2813,0,2813,177.49733
03/03/2019 11:05,2018,1,WESTERN EUROPE-EU,GREECE,1,GATWICK,ZAKINTHOS,145669,102997,42672,164773,107665,57108,-11.59413
03/03/2019 11:05,2018,1,WESTERN EUROPE-EU,GREECE,1,HEATHROW,ATHENS,753589,753589,0,761330,758261,3069,-1.01677
03/03/2019 11:05,2018,1,WESTERN EUROPE-EU,GREECE,1,HEATHROW,CHANIA,13449,13449,0,12006,12006,0,12.01899
03/03/2019 11:05,2018,1,WESTERN EUROPE-EU,GREECE,1,HEATHROW,CORFU,65992,60958,5034,45610,40661,4949,44.68757
03/03/2019 11:05,2018,1,WESTERN EUROPE-EU,GREECE,1,HEATHROW,KALAMATA,23157,13165,9992,23087,13005,10082,0.3032
03/03/2019 11:05,2018,1,WESTERN EUROPE-EU,GREECE,1,HEATHROW,KEFALLINIA,16194,11189,5005,0,0,0,0
03/03/2019 11:05,2018,1,WESTERN EUROPE-EU,GREECE,1,HEATHROW,KOS,2260,0,2260,8237,5971,2266,-72.56283
03/03/2019 11:05,2018,1,WESTERN EUROPE-EU,GREECE,1,HEATHROW,LEMNOS,15361,0,15361,15286,200,15086,0.49065
03/03/2019 11:05,2018,1,WESTERN EUROPE-EU,GREECE,1,HEATHROW,MIKONOS,36840,36840,0,20657,20657,0,78.34148
03/03/2019 11:05,2018,1,WESTERN EUROPE-EU,GREECE,1,HEATHROW,PREVEZA,17354,208,17146,17108,0,17108,1.43792
03/03/2019 11:05,2018,1,WESTERN EUROPE-EU,GREECE,1,HEATHROW,RHODES,11192,0,11192,11356,0,11356,-1.44417
03/03/2019 11:05,2018,1,WESTERN EUROPE-EU,GREECE,1,HEATHROW,THIRA (SANTORINI),35393,35393,0,24528,24528,0,44.29631
03/03/2019 11:05,2018,1,WESTERN EUROPE-EU,GREECE,1,HEATHROW,ZAKINTHOS,10096,10096,0,10172,10172,0,-0.74715
03/03/2019 11:05,2018,1,WESTERN EUROPE-EU,GREECE,1,LONDON CITY,MIKONOS,8314,8314,0,8465,8465,0,-1.78382
03/03/2019 11:05,2018,1,WESTERN EUROPE-EU,GREECE,1,LONDON CITY,SKIATHOS,3961,3961,0,4269,4269,0,-7.2148
03/03/2019 11:05,2018,1,WESTERN EUROPE-EU,GREECE,1,LONDON CITY,THIRA (SANTORINI),3268,3268,0,3362,3362,0,-2.79595
03/03/2019 11:05,2018,1,WESTERN EUROPE-EU,GREECE,1,LUTON,ATHENS,99859,99859,0,207,185,22,48141.0628
03/03/2019 11:05,2018,1,WESTERN EUROPE-EU,GREECE,1,LUTON,CHANIA,169,169,0,0,0,0,0
03/03/2019 11:05,2018,1,WESTERN EUROPE-EU,GREECE,1,LUTON,CORFU,67662,58139,9523,68749,56054,12695,-1.58111
03/03/2019 11:05,2018,1,WESTERN EUROPE-EU,GREECE,1,LUTON,HERAKLION,32740,32740,0,38384,29278,9106,-14.70404
03/03/2019 11:05,2018,1,WESTERN EUROPE-EU,GREECE,1,LUTON,KALAMATA,0,0,0,11,0,11,-100
03/03/2019 11:05,2018,1,WESTERN EUROPE-EU,GREECE,1,LUTON,KAVALA,0,0,0,133,0,133,-100
03/03/2019 11:05,2018,1,WESTERN EUROPE-EU,GREECE,1,LUTON,KEFALLINIA,6813,0,6813,7518,0,7518,-9.37749
03/03/2019 11:05,2018,1,WESTERN EUROPE-EU,GREECE,1,LUTON,MIKONOS,17758,17758,0,16620,16612,8,6.84717
03/03/2019 11:05,2018,1,WESTERN EUROPE-EU,GREECE,1,LUTON,RHODES,37972,18025,19947,30163,11633,18530,25.88933
03/03/2019 11:05,2018,1,WESTERN EUROPE-EU,GREECE,1,LUTON,SALONIKA,9026,9026,0,0,0,0,0
03/03/2019 11:05,2018,1,WESTERN EUROPE-EU,GREECE,1,LUTON,SKIATHOS,8018,0,8018,6665,0,6665,20.30008
03/03/2019 11:05,2018,1,WESTERN EUROPE-EU,GREECE,1,LUTON,ZAKINTHOS,10786,0,10786,8722,0,8722,23.6643
03/03/2019 11:05,2018,1,WESTERN EUROPE-EU,GREECE,1,SOUTHEND,RHODES,0,0,0,180,180,0,-100
03/03/2019 11:05,2018,1,WESTERN EUROPE-EU,GREECE,1,STANSTED,ATHENS,209683,209683,0,208684,208684,0,0.47871
03/03/2019 11:05,2018,1,WESTERN EUROPE-EU,GREECE,1,STANSTED,CHANIA,31553,31553,0,24929,24929,0,26.57146
03/03/2019 11:05,2018,1,WESTERN EUROPE-EU,GREECE,1,STANSTED,CORFU,86222,70930,15292,68427,53516,14911,26.00582
03/03/2019 11:05,2018,1,WESTERN EUROPE-EU,GREECE,1,STANSTED,HERAKLION,57580,41609,15971,46911,31314,15597,22.74307
03/03/2019 11:05,2018,1,WESTERN EUROPE-EU,GREECE,1,STANSTED,KAVALA,182,182,0,162,162,0,12.34568
03/03/2019 11:05,2018,1,WESTERN EUROPE-EU,GREECE,1,STANSTED,KEFALLINIA,48874,40405,8469,28406,20331,8075,72.0552
03/03/2019 11:05,2018,1,WESTERN EUROPE-EU,GREECE,1,STANSTED,KOS,42626,33848,8778,36112,26682,9430,18.03833
03/03/2019 11:05,2018,1,WESTERN EUROPE-EU,GREECE,1,STANSTED,MIKONOS,0,0,0,76,0,76,-100
03/03/2019 11:05,2018,1,WESTERN EUROPE-EU,GREECE,1,STANSTED,PREVEZA,5780,0,5780,0,0,0,0
03/03/2019 11:05,2018,1,WESTERN EUROPE-EU,GREECE,1,STANSTED,RHODES,95025,77542,17483,80806,63535,17271,17.59647
03/03/2019 11:05,2018,1,WESTERN EUROPE-EU,GREECE,1,STANSTED,SALONIKA,128837,128837,0,117695,117695,0,9.46684
03/03/2019 11:05,2018,1,WESTERN EUROPE-EU,GREECE,1,STANSTED,SKIATHOS,8477,8477,0,8836,8836,0,-4.06292
03/03/2019 11:05,2018,1,WESTERN EUROPE-EU,GREECE,1,STANSTED,ZAKINTHOS,78162,70380,7782,65207,57740,7467,19.8675
03/03/2019 11:05,2018,1,WESTERN EUROPE-EU,GREECE,2,ABERDEEN,CORFU,8851,0,8851,6994,0,6994,26.55133
03/03/2019 11:05,2018,1,WESTERN EUROPE-EU,GREECE,2,BELFAST INTERNATIONAL,CORFU,7175,0,7175,7363,0,7363,-2.55331
03/03/2019 11:05,2018,1,WESTERN EUROPE-EU,GREECE,2,BELFAST INTERNATIONAL,HERAKLION,8979,8979,0,0,0,0,0
03/03/2019 11:05,2018,1,WESTERN EUROPE-EU,GREECE,2,BELFAST INTERNATIONAL,RHODES,15380,8988,6392,6666,0,6666,130.72307
03/03/2019 11:05,2018,1,WESTERN EUROPE-EU,GREECE,2,BELFAST INTERNATIONAL,ZAKINTHOS,6497,6497,0,6202,6202,0,4.75653
03/03/2019 11:05,2018,1,WESTERN EUROPE-EU,GREECE,2,BIRMINGHAM,ATHENS,0,0,0,8464,8464,0,-100
03/03/2019 11:05,2018,1,WESTERN EUROPE-EU,GREECE,2,BIRMINGHAM,CHANIA,31162,21874,9288,29612,20291,9321,5.23436
03/03/2019 11:05,2018,1,WESTERN EUROPE-EU,GREECE,2,BIRMINGHAM,CORFU,84382,45799,38583,69424,36910,32514,21.54586
03/03/2019 11:05,2018,1,WESTERN EUROPE-EU,GREECE,2,BIRMINGHAM,HERAKLION,74017,49280,24737,74793,56449,18344,-1.03753
03/03/2019 11:05,2018,1,WESTERN EUROPE-EU,GREECE,2,BIRMINGHAM,KALAMATA,7938,7938,0,6433,6433,0,23.39499
03/03/2019 11:05,2018,1,WESTERN EUROPE-EU,GREECE,2,BIRMINGHAM,KAVALA,6678,0,6678,6680,0,6680,-0.02994
03/03/2019 11:05,2018,1,WESTERN EUROPE-EU,GREECE,2,BIRMINGHAM,KEFALLINIA,28974,8719,20255,30430,9577,20853,-4.78475
03/03/2019 11:05,2018,1,WESTERN EUROPE-EU,GREECE,2,BIRMINGHAM,KOS,53116,35135,17981,39162,20807,18355,35.63148
03/03/2019 11:05,2018,1,WESTERN EUROPE-EU,GREECE,2,BIRMINGHAM,MYTILINI,8479,8479,0,8680,8680,0,-2.31567
03/03/2019 11:05,2018,1,WESTERN EUROPE-EU,GREECE,2,BIRMINGHAM,PREVEZA,2990,0,2990,10418,7616,2802,-71.29967
03/03/2019 11:05,2018,1,WESTERN EUROPE-EU,GREECE,2,BIRMINGHAM,RHODES,83600,46531,37069,70167,42614,27553,19.14433
03/03/2019 11:05,2018,1,WESTERN EUROPE-EU,GREECE,2,BIRMINGHAM,SALONIKA,13543,13543,0,0,0,0,0
03/03/2019 11:05,2018,1,WESTERN EUROPE-EU,GREECE,2,BIRMINGHAM,SKIATHOS,17454,0,17454,17174,0,17174,1.63037
03/03/2019 11:05,2018,1,WESTERN EUROPE-EU,GREECE,2,BIRMINGHAM,THIRA (SANTORINI),13426,6919,6507,13159,6810,6349,2.02903
03/03/2019 11:05,2018,1,WESTERN EUROPE-EU,GREECE,2,BIRMINGHAM,ZAKINTHOS,90465,63774,26691,65319,45872,19447,38.49722
03/03/2019 11:05,2018,1,WESTERN EUROPE-EU,GREECE,2,BOURNEMOUTH,CORFU,7788,0,7788,7978,186,7792,-2.38155
03/03/2019 11:05,2018,1,WESTERN EUROPE-EU,GREECE,2,BOURNEMOUTH,RHODES,8975,188,8787,9167,0,9167,-2.09447
03/03/2019 11:05,2018,1,WESTERN EUROPE-EU,GREECE,2,BRISTOL,ATHENS,35199,35199,0,4578,4578,0,668.87287
03/03/2019 11:05,2018,1,WESTERN EUROPE-EU,GREECE,2,BRISTOL,CHANIA,27660,21021,6639,32277,23903,8374,-14.3043
03/03/2019 11:05,2018,1,WESTERN EUROPE-EU,GREECE,2,BRISTOL,CORFU,68444,46511,21933,66420,46511,19909,3.04727
03/03/2019 11:05,2018,1,WESTERN EUROPE-EU,GREECE,2,BRISTOL,HERAKLION,44660,29387,15273,51968,32686,19282,-14.0625
03/03/2019 11:05,2018,1,WESTERN EUROPE-EU,GREECE,2,BRISTOL,KEFALLINIA,30987,24655,6332,32927,23856,9071,-5.89182
03/03/2019 11:05,2018,1,WESTERN EUROPE-EU,GREECE,2,BRISTOL,KOS,22660,9543,13117,11423,0,11423,98.37171
03/03/2019 11:05,2018,1,WESTERN EUROPE-EU,GREECE,2,BRISTOL,PREVEZA,6916,6916,0,0,0,0,0
03/03/2019 11:05,2018,1,WESTERN EUROPE-EU,GREECE,2,BRISTOL,RHODES,29923,7512,22411,29387,8035,21352,1.82394
03/03/2019 11:05,2018,1,WESTERN EUROPE-EU,GREECE,2,BRISTOL,SKIATHOS,12233,8093,4140,8170,8170,0,49.73072
03/03/2019 11:05,2018,1,WESTERN EUROPE-EU,GREECE,2,BRISTOL,THIRA (SANTORINI),6107,0,6107,7941,0,7941,-23.09533
03/03/2019 11:05,2018,1,WESTERN EUROPE-EU,GREECE,2,BRISTOL,ZAKINTHOS,66844,44435,22409,54172,36972,17200,23.39216
03/03/2019 11:05,2018,1,WESTERN EUROPE-EU,GREECE,2,CARDIFF WALES,ATHENS,174,174,0,0,0,0,0
03/03/2019 11:05,2018,1,WESTERN EUROPE-EU,GREECE,2,CARDIFF WALES,CHANIA,184,0,184,0,0,0,0
03/03/2019 11:05,2018,1,WESTERN EUROPE-EU,GREECE,2,CARDIFF WALES,CORFU,9332,0,9332,9360,0,9360,-0.29915
03/03/2019 11:05,2018,1,WESTERN EUROPE-EU,GREECE,2,CARDIFF WALES,HERAKLION,9404,0,9404,9612,0,9612,-2.16396
03/03/2019 11:05,2018,1,WESTERN EUROPE-EU,GREECE,2,CARDIFF WALES,KEFALLINIA,7553,0,7553,7617,0,7617,-0.84023
03/03/2019 11:05,2018,1,WESTERN EUROPE-EU,GREECE,2,CARDIFF WALES,KOS,7667,0,7667,8336,0,8336,-8.02543
03/03/2019 11:05,2018,1,WESTERN EUROPE-EU,GREECE,2,CARDIFF WALES,RHODES,17438,0,17438,16829,0,16829,3.61875
03/03/2019 11:05,2018,1,WESTERN EUROPE-EU,GREECE,2,CARDIFF WALES,ZAKINTHOS,21638,0,21638,20916,0,20916,3.4519
03/03/2019 11:05,2018,1,WESTERN EUROPE-EU,GREECE,2,DONCASTER SHEFFIELD,CORFU,16614,0,16614,17374,0,17374,-4.37435
03/03/2019 11:05,2018,1,WESTERN EUROPE-EU,GREECE,2,DONCASTER SHEFFIELD,HERAKLION,6690,0,6690,7656,0,7656,-12.61755
03/03/2019 11:05,2018,1,WESTERN EUROPE-EU,GREECE,2,DONCASTER SHEFFIELD,KEFALLINIA,7321,188,7133,0,0,0,0
03/03/2019 11:05,2018,1,WESTERN EUROPE-EU,GREECE,2,DONCASTER SHEFFIELD,RHODES,9386,185,9201,9642,0,9642,-2.65505
03/03/2019 11:05,2018,1,WESTERN EUROPE-EU,GREECE,2,DONCASTER SHEFFIELD,ZAKINTHOS,8040,0,8040,7907,0,7907,1.68205
03/03/2019 11:05,2018,1,WESTERN EUROPE-EU,GREECE,2,EAST MIDLANDS INTERNATIONAL,CHANIA,10391,10391,0,17408,17408,0,-40.30905
03/03/2019 11:05,2018,1,WESTERN EUROPE-EU,GREECE,2,EAST MIDLANDS INTERNATIONAL,CORFU,74899,59786,15113,61013,45524,15489,22.75908
03/03/2019 11:05,2018,1,WESTERN EUROPE-EU,GREECE,2,EAST MIDLANDS INTERNATIONAL,HERAKLION,43250,20815,22435,42220,26711,15509,2.4396
03/03/2019 11:05,2018,1,WESTERN EUROPE-EU,GREECE,2,EAST MIDLANDS INTERNATIONAL,KAVALA,3906,3906,0,4102,4102,0,-4.77816
03/03/2019 11:05,2018,1,WESTERN EUROPE-EU,GREECE,2,EAST MIDLANDS INTERNATIONAL,KEFALLINIA,12333,5890,6443,12624,5257,7367,-2.30513
03/03/2019 11:05,2018,1,WESTERN EUROPE-EU,GREECE,2,EAST MIDLANDS INTERNATIONAL,KOS,24911,8598,16313,25116,8944,16172,-0.81621
03/03/2019 11:05,2018,1,WESTERN EUROPE-EU,GREECE,2,EAST MIDLANDS INTERNATIONAL,RHODES,62483,39536,22947,56091,38169,17922,11.39577
03/03/2019 11:05,2018,1,WESTERN EUROPE-EU,GREECE,2,EAST MIDLANDS INTERNATIONAL,SALONIKA,13530,6107,7423,12182,4758,7424,11.06551
03/03/2019 11:05,2018,1,WESTERN EUROPE-EU,GREECE,2,EAST MIDLANDS INTERNATIONAL,SKIATHOS,4913,4913,0,4747,4747,0,3.49695
03/03/2019 11:05,2018,1,WESTERN EUROPE-EU,GREECE,2,EAST MIDLANDS INTERNATIONAL,ZAKINTHOS,69936,46262,23674,61096,38653,22443,14.46903
03/03/2019 11:05,2018,1,WESTERN EUROPE-EU,GREECE,2,EDINBURGH,ATHENS,53332,53332,0,52609,52609,0,1.37429
03/03/2019 11:05,2018,1,WESTERN EUROPE-EU,GREECE,2,EDINBURGH,CORFU,19698,10520,9178,20917,11771,9146,-5.8278
03/03/2019 11:05,2018,1,WESTERN EUROPE-EU,GREECE,2,EDINBURGH,HERAKLION,37110,37110,0,36648,36648,0,1.26064
03/03/2019 11:05,2018,1,WESTERN EUROPE-EU,GREECE,2,EDINBURGH,KALAMATA,56,0,56,0,0,0,0
03/03/2019 11:05,2018,1,WESTERN EUROPE-EU,GREECE,2,EDINBURGH,KEFALLINIA,6086,6086,0,5367,5367,0,13.39668
03/03/2019 11:05,2018,1,WESTERN EUROPE-EU,GREECE,2,EDINBURGH,KOS,8166,8166,0,0,0,0,0
03/03/2019 11:05,2018,1,WESTERN EUROPE-EU,GREECE,2,EDINBURGH,RHODES,17772,8754,9018,17771,8685,9086,0.00563
03/03/2019 11:05,2018,1,WESTERN EUROPE-EU,GREECE,2,EDINBURGH,SALONIKA,6819,6819,0,4943,4943,0,37.95266
03/03/2019 11:05,2018,1,WESTERN EUROPE-EU,GREECE,2,EDINBURGH,ZAKINTHOS,14093,14093,0,11861,11861,0,18.81797
03/03/2019 11:05,2018,1,WESTERN EUROPE-EU,GREECE,2,EXETER,CORFU,9259,0,9259,8935,0,8935,3.62619
03/03/2019 11:05,2018,1,WESTERN EUROPE-EU,GREECE,2,EXETER,RHODES,7376,0,7376,7733,0,7733,-4.61658
03/03/2019 11:05,2018,1,WESTERN EUROPE-EU,GREECE,2,GLASGOW,ATHENS,275,0,275,0,0,0,0
03/03/2019 11:05,2018,1,WESTERN EUROPE-EU,GREECE,2,GLASGOW,CHANIA,10143,10143,0,9951,9951,0,1.92945
03/03/2019 11:05,2018,1,WESTERN EUROPE-EU,GREECE,2,GLASGOW,CORFU,32426,22780,9646,33034,16814,16220,-1.84053
03/03/2019 11:05,2018,1,WESTERN EUROPE-EU,GREECE,2,GLASGOW,HERAKLION,52685,43030,9655,49333,35657,13676,6.79464
03/03/2019 11:05,2018,1,WESTERN EUROPE-EU,GREECE,2,GLASGOW,KEFALLINIA,6777,6777,0,0,0,0,0
03/03/2019 11:05,2018,1,WESTERN EUROPE-EU,GREECE,2,GLASGOW,KOS,27846,27846,0,17891,17891,0,55.6425
03/03/2019 11:05,2018,1,WESTERN EUROPE-EU,GREECE,2,GLASGOW,RHODES,27479,27479,0,28331,15305,13026,-3.00731
03/03/2019 11:05,2018,1,WESTERN EUROPE-EU,GREECE,2,GLASGOW,SALONIKA,5808,5808,0,0,0,0,0
03/03/2019 11:05,2018,1,WESTERN EUROPE-EU,GREECE,2,GLASGOW,ZAKINTHOS,34685,25855,8830,33838,19842,13996,2.5031
03/03/2019 11:05,2018,1,WESTERN EUROPE-EU,GREECE,2,LEEDS BRADFORD,CHANIA,20472,20472,0,20381,20381,0,0.44649
03/03/2019 11:05,2018,1,WESTERN EUROPE-EU,GREECE,2,LEEDS BRADFORD,CORFU,41864,29118,12746,30311,21579,8732,38.11488
03/03/2019 11:05,2018,1,WESTERN EUROPE-EU,GREECE,2,LEEDS BRADFORD,HERAKLION,31923,31734,189,32662,32657,5,-2.26257
03/03/2019 11:05,2018,1,WESTERN EUROPE-EU,GREECE,2,LEEDS BRADFORD,KEFALLINIA,13092,13092,0,7189,7189,0,82.11156
03/03/2019 11:05,2018,1,WESTERN EUROPE-EU,GREECE,2,LEEDS BRADFORD,KOS,18709,18709,0,9356,9356,0,99.96794
03/03/2019 11:05,2018,1,WESTERN EUROPE-EU,GREECE,2,LEEDS BRADFORD,RHODES,35732,26741,8991,32324,23285,9039,10.54325
03/03/2019 11:05,2018,1,WESTERN EUROPE-EU,GREECE,2,LEEDS BRADFORD,SALONIKA,10220,10220,0,4472,4472,0,128.53309
03/03/2019 11:05,2018,1,WESTERN EUROPE-EU,GREECE,2,LEEDS BRADFORD,ZAKINTHOS,17513,17513,0,17353,17353,0,0.92203
03/03/2019 11:05,2018,1,WESTERN EUROPE-EU,GREECE,2,LIVERPOOL (JOHN LENNON),CHANIA,186,186,0,0,0,0,0
03/03/2019 11:05,2018,1,WESTERN EUROPE-EU,GREECE,2,LIVERPOOL (JOHN LENNON),KAVALA,0,0,0,218,218,0,-100
03/03/2019 11:05,2018,1,WESTERN EUROPE-EU,GREECE,2,LIVERPOOL (JOHN LENNON),MIKONOS,181,181,0,0,0,0,0
03/03/2019 11:05,2018,1,WESTERN EUROPE-EU,GREECE,2,LIVERPOOL (JOHN LENNON),RHODES,17690,17690,0,28291,28291,0,-37.47128
03/03/2019 11:05,2018,1,WESTERN EUROPE-EU,GREECE,2,LIVERPOOL (JOHN LENNON),ZAKINTHOS,16583,16583,0,16086,16086,0,3.08964
03/03/2019 11:05,2018,1,WESTERN EUROPE-EU,GREECE,2,MANCHESTER,ATHENS,97573,97274,299,109270,106895,2375,-10.70468
03/03/2019 11:05,2018,1,WESTERN EUROPE-EU,GREECE,2,MANCHESTER,CHANIA,55083,29522,25561,45892,23201,22691,20.02746
03/03/2019 11:05,2018,1,WESTERN EUROPE-EU,GREECE,2,MANCHESTER,CORFU,172981,122611,50370,173193,119227,53966,-0.12241
03/03/2019 11:05,2018,1,WESTERN EUROPE-EU,GREECE,2,MANCHESTER,HERAKLION,188327,131298,57029,191753,126512,65241,-1.78667
03/03/2019 11:05,2018,1,WESTERN EUROPE-EU,GREECE,2,MANCHESTER,KALAMATA,17938,17938,0,10990,10990,0,63.22111
03/03/2019 11:05,2018,1,WESTERN EUROPE-EU,GREECE,2,MANCHESTER,KAVALA,21901,13715,8186,17152,9937,7215,27.68773
03/03/2019 11:05,2018,1,WESTERN EUROPE-EU,GREECE,2,MANCHESTER,KEFALLINIA,93771,56401,37370,89299,51984,37315,5.00789
03/03/2019 11:05,2018,1,WESTERN EUROPE-EU,GREECE,2,MANCHESTER,KOS,115045,65046,49999,107799,57677,50122,6.72177
03/03/2019 11:05,2018,1,WESTERN EUROPE-EU,GREECE,2,MANCHESTER,MIKONOS,28198,28198,0,35147,35147,0,-19.77125
03/03/2019 11:05,2018,1,WESTERN EUROPE-EU,GREECE,2,MANCHESTER,MYTILINI,8463,8463,0,0,0,0,0
03/03/2019 11:05,2018,1,WESTERN EUROPE-EU,GREECE,2,MANCHESTER,PREVEZA,50130,34608,15522,57264,39937,17327,-12.45809
03/03/2019 11:05,2018,1,WESTERN EUROPE-EU,GREECE,2,MANCHESTER,RHODES,156904,89316,67588,147126,80977,66149,6.646
03/03/2019 11:05,2018,1,WESTERN EUROPE-EU,GREECE,2,MANCHESTER,SALONIKA,87744,73750,13994,66632,51440,15192,31.68448
03/03/2019 11:05,2018,1,WESTERN EUROPE-EU,GREECE,2,MANCHESTER,SKIATHOS,49290,25931,23359,48902,25790,23112,0.79342
03/03/2019 11:05,2018,1,WESTERN EUROPE-EU,GREECE,2,MANCHESTER,THIRA (SANTORINI),71775,55170,16605,55427,46690,8737,29.49465
03/03/2019 11:05,2018,1,WESTERN EUROPE-EU,GREECE,2,MANCHESTER,ZAKINTHOS,125131,73658,51473,129785,78198,51587,-3.58593
03/03/2019 11:05,2018,1,WESTERN EUROPE-EU,GREECE,2,NEWCASTLE,ATHENS,0,0,0,126,0,126,-100
03/03/2019 11:05,2018,1,WESTERN EUROPE-EU,GREECE,2,NEWCASTLE,CORFU,51486,51486,0,48267,48267,0,6.66915
03/03/2019 11:05,2018,1,WESTERN EUROPE-EU,GREECE,2,NEWCASTLE,HERAKLION,34276,34276,0,35088,35088,0,-2.31418
03/03/2019 11:05,2018,1,WESTERN EUROPE-EU,GREECE,2,NEWCASTLE,KAVALA,1614,1614,0,0,0,0,0
03/03/2019 11:05,2018,1,WESTERN EUROPE-EU,GREECE,2,NEWCASTLE,KEFALLINIA,12604,12604,0,12523,12523,0,0.64681
03/03/2019 11:05,2018,1,WESTERN EUROPE-EU,GREECE,2,NEWCASTLE,KOS,24034,24034,0,18243,18243,0,31.74368
03/03/2019 11:05,2018,1,WESTERN EUROPE-EU,GREECE,2,NEWCASTLE,RHODES,45365,45365,0,48219,48034,185,-5.91883
03/03/2019 11:05,2018,1,WESTERN EUROPE-EU,GREECE,2,NEWCASTLE,SALONIKA,10918,10918,0,0,0,0,0
03/03/2019 11:05,2018,1,WESTERN EUROPE-EU,GREECE,2,NEWCASTLE,SKIATHOS,6891,6891,0,8857,8857,0,-22.19713
03/03/2019 11:05,2018,1,WESTERN EUROPE-EU,GREECE,2,NEWCASTLE,THIRA (SANTORINI),8482,8482,0,8704,8704,0,-2.55055
03/03/2019 11:05,2018,1,WESTERN EUROPE-EU,GREECE,2,NEWCASTLE,ZAKINTHOS,41380,41380,0,42118,42118,0,-1.75222
03/03/2019 11:05,2018,1,WESTERN EUROPE-EU,GREECE,2,NORWICH,CORFU,8983,0,8983,9032,0,9032,-0.54252
03/03/2019 11:05,2018,1,WESTERN EUROPE-EU,GREECE,2,NORWICH,HERAKLION,9358,0,9358,0,0,0,0
03/03/2019 11:05,2018,1,WESTERN EUROPE-EU,GREECE,2,NORWICH,RHODES,9183,0,9183,9109,0,9109,0.81238
03/03/2019 11:05,2018,1,WESTERN EUROPE-EU,GREECE,2,PRESTWICK,CORFU,0,0,0,5706,5706,0,-100
03/03/2019 11:05,2018,1,WESTERN EUROPE-EU,GREECE,2,SOUTHAMPTON,SKIATHOS,1465,0,1465,0,0,0,0
03/03/2019 11:05,2018,1,WESTERN EUROPE-EU,IRISH REPUBLIC,1,GATWICK,CORK,122810,122810,0,124950,124950,0,-1.71269
03/03/2019 11:05,2018,1,WESTERN EUROPE-EU,IRISH REPUBLIC,1,GATWICK,DUBLIN,1347017,1346905,112,1367300,1366599,701,-1.48343
03/03/2019 11:05,2018,1,WESTERN EUROPE-EU,IRISH REPUBLIC,1,GATWICK,IRELAND WEST(KNOCK),83636,83636,0,79837,79837,0,4.75845
03/03/2019 11:05,2018,1,WESTERN EUROPE-EU,IRISH REPUBLIC,1,GATWICK,SHANNON,115697,115695,2,114852,114837,15,0.73573
03/03/2019 11:05,2018,1,WESTERN EUROPE-EU,IRISH REPUBLIC,1,HEATHROW,CORK,403542,403542,0,401601,401601,0,0.48332
03/03/2019 11:05,2018,1,WESTERN EUROPE-EU,IRISH REPUBLIC,1,HEATHROW,DUBLIN,1809396,1809396,0,1803497,1803497,0,0.32709
03/03/2019 11:05,2018,1,WESTERN EUROPE-EU,IRISH REPUBLIC,1,HEATHROW,SHANNON,274143,274143,0,270079,270079,0,1.50474
03/03/2019 11:05,2018,1,WESTERN EUROPE-EU,IRISH REPUBLIC,1,LONDON CITY,CORK,0,0,0,22,0,22,-100
03/03/2019 11:05,2018,1,WESTERN EUROPE-EU,IRISH REPUBLIC,1,LONDON CITY,DUBLIN,484467,484406,61,470563,470563,0,2.95476
03/03/2019 11:05,2018,1,WESTERN EUROPE-EU,IRISH REPUBLIC,1,LONDON CITY,SHANNON,44,0,44,0,0,0,0
03/03/2019 11:05,2018,1,WESTERN EUROPE-EU,IRISH REPUBLIC,1,LUTON,CORK,13253,13253,0,0,0,0,0
03/03/2019 11:05,2018,1,WESTERN EUROPE-EU,IRISH REPUBLIC,1,LUTON,DUBLIN,356814,356814,0,358631,358295,336,-0.50665
03/03/2019 11:05,2018,1,WESTERN EUROPE-EU,IRISH REPUBLIC,1,LUTON,IRELAND WEST(KNOCK),134530,134530,0,134889,134889,0,-0.26614
03/03/2019 11:05,2018,1,WESTERN EUROPE-EU,IRISH REPUBLIC,1,LUTON,KERRY COUNTY,112148,112148,0,113539,113539,0,-1.22513
03/03/2019 11:05,2018,1,WESTERN EUROPE-EU,IRISH REPUBLIC,1,LUTON,SHANNON,90,90,0,0,0,0,0
03/03/2019 11:05,2018,1,WESTERN EUROPE-EU,IRISH REPUBLIC,1,SOUTHEND,DUBLIN,122214,122214,0,19249,19249,0,534.9109
03/03/2019 11:05,2018,1,WESTERN EUROPE-EU,IRISH REPUBLIC,1,STANSTED,CORK,347080,347080,0,351914,351914,0,-1.37363
03/03/2019 11:05,2018,1,WESTERN EUROPE-EU,IRISH REPUBLIC,1,STANSTED,DUBLIN,898295,898295,0,890741,890502,239,0.84806
03/03/2019 11:05,2018,1,WESTERN EUROPE-EU,IRISH REPUBLIC,1,STANSTED,IRELAND WEST(KNOCK),158349,158349,0,160276,160276,0,-1.2023
03/03/2019 11:05,2018,1,WESTERN EUROPE-EU,IRISH REPUBLIC,1,STANSTED,KERRY COUNTY,81186,81186,0,78661,78661,0,3.20998
03/03/2019 11:05,2018,1,WESTERN EUROPE-EU,IRISH REPUBLIC,1,STANSTED,SHANNON,201589,201459,130,198935,198935,0,1.3341
03/03/2019 11:05,2018,1,WESTERN EUROPE-EU,IRISH REPUBLIC,2,ABERDEEN,DUBLIN,49903,49903,0,47473,47473,0,5.1187
03/03/2019 11:05,2018,1,WESTERN EUROPE-EU,IRISH REPUBLIC,2,BELFAST CITY (GEORGE BEST),DUBLIN,0,0,0,65,65,0,-100
03/03/2019 11:05,2018,1,WESTERN EUROPE-EU,IRISH REPUBLIC,2,BELFAST CITY (GEORGE BEST),IRELAND WEST(KNOCK),60,60,0,39,39,0,53.84615
03/03/2019 11:05,2018,1,WESTERN EUROPE-EU,IRISH REPUBLIC,2,BELFAST INTERNATIONAL,DUBLIN,875,0,875,0,0,0,0
03/03/2019 11:05,2018,1,WESTERN EUROPE-EU,IRISH REPUBLIC,2,BIRMINGHAM,CORK,76832,76832,0,77157,77157,0,-0.42122
03/03/2019 11:05,2018,1,WESTERN EUROPE-EU,IRISH REPUBLIC,2,BIRMINGHAM,DUBLIN,923343,923161,182,906714,906567,147,1.83399
03/03/2019 11:05,2018,1,WESTERN EUROPE-EU,IRISH REPUBLIC,2,BIRMINGHAM,IRELAND WEST(KNOCK),33410,33410,0,29813,29813,0,12.06521
03/03/2019 11:05,2018,1,WESTERN EUROPE-EU,IRISH REPUBLIC,2,BIRMINGHAM,SHANNON,38013,37863,150,37677,37632,45,0.89179
03/03/2019 11:05,2018,1,WESTERN EUROPE-EU,IRISH REPUBLIC,2,BOURNEMOUTH,DUBLIN,0,0,0,149,149,0,-100
03/03/2019 11:05,2018,1,WESTERN EUROPE-EU,IRISH REPUBLIC,2,BRISTOL,CORK,40493,40493,0,43130,43130,0,-6.11407
03/03/2019 11:05,2018,1,WESTERN EUROPE-EU,IRISH REPUBLIC,2,BRISTOL,DUBLIN,429127,428850,277,429794,429340,454,-0.15519
03/03/2019 11:05,2018,1,WESTERN EUROPE-EU,IRISH REPUBLIC,2,BRISTOL,IRELAND WEST(KNOCK),35454,35454,0,28117,28117,0,26.09453
03/03/2019 11:05,2018,1,WESTERN EUROPE-EU,IRISH REPUBLIC,2,BRISTOL,SHANNON,13011,13011,0,0,0,0,0
03/03/2019 11:05,2018,1,WESTERN EUROPE-EU,IRISH REPUBLIC,2,CARDIFF WALES,CORK,14589,14502,87,15428,15309,119,-5.43816
03/03/2019 11:05,2018,1,WESTERN EUROPE-EU,IRISH REPUBLIC,2,CARDIFF WALES,DUBLIN,108275,104890,3385,100973,97808,3165,7.23164
03/03/2019 11:05,2018,1,WESTERN EUROPE-EU,IRISH REPUBLIC,2,CARDIFF WALES,IRELAND WEST(KNOCK),0,0,0,40,0,40,-100
03/03/2019 11:05,2018,1,WESTERN EUROPE-EU,IRISH REPUBLIC,2,CARDIFF WALES,SHANNON,115,0,115,333,0,333,-65.46547
03/03/2019 11:05,2018,1,WESTERN EUROPE-EU,IRISH REPUBLIC,2,CITY OF DERRY (EGLINTON),DONEGAL,0,0,0,18,18,0,-100
03/03/2019 11:05,2018,1,WESTERN EUROPE-EU,IRISH REPUBLIC,2,CITY OF DERRY (EGLINTON),DUBLIN,13,13,0,41,41,0,-68.29268
03/03/2019 11:05,2018,1,WESTERN EUROPE-EU,IRISH REPUBLIC,2,DONCASTER SHEFFIELD,DUBLIN,33659,33562,97,34886,34808,78,-3.51717
03/03/2019 11:05,2018,1,WESTERN EUROPE-EU,IRISH REPUBLIC,2,EAST MIDLANDS INTERNATIONAL,DUBLIN,204772,204772,0,218802,218802,0,-6.41219
03/03/2019 11:05,2018,1,WESTERN EUROPE-EU,IRISH REPUBLIC,2,EAST MIDLANDS INTERNATIONAL,IRELAND WEST(KNOCK),70223,70223,0,70686,70686,0,-0.65501
03/03/2019 11:05,2018,1,WESTERN EUROPE-EU,IRISH REPUBLIC,2,EAST MIDLANDS INTERNATIONAL,SHANNON,0,0,0,92,0,92,-100
03/03/2019 11:05,2018,1,WESTERN EUROPE-EU,IRISH REPUBLIC,2,EDINBURGH,CORK,50259,50259,0,47081,47081,0,6.75007
03/03/2019 11:05,2018,1,WESTERN EUROPE-EU,IRISH REPUBLIC,2,EDINBURGH,DUBLIN,627537,625566,1971,617909,617149,760,1.55816
03/03/2019 11:05,2018,1,WESTERN EUROPE-EU,IRISH REPUBLIC,2,EDINBURGH,IRELAND WEST(KNOCK),28776,28776,0,25360,25360,0,13.47003
03/03/2019 11:05,2018,1,WESTERN EUROPE-EU,IRISH REPUBLIC,2,EDINBURGH,SHANNON,28802,28477,325,28839,28721,118,-0.1283
03/03/2019 11:05,2018,1,WESTERN EUROPE-EU,IRISH REPUBLIC,2,EXETER,CORK,108,0,108,0,0,0,0
03/03/2019 11:05,2018,1,WESTERN EUROPE-EU,IRISH REPUBLIC,2,EXETER,DUBLIN,35587,35587,0,38041,37886,155,-6.45093
03/03/2019 11:05,2018,1,WESTERN EUROPE-EU,IRISH REPUBLIC,2,EXETER,SHANNON,293,0,293,0,0,0,0
03/03/2019 11:05,2018,1,WESTERN EUROPE-EU,IRISH REPUBLIC,2,GLASGOW,CORK,25481,25481,0,25246,25246,0,0.93084
03/03/2019 11:05,2018,1,WESTERN EUROPE-EU,IRISH REPUBLIC,2,GLASGOW,DONEGAL,8335,8335,0,11496,11496,0,-27.49652
03/03/2019 11:05,2018,1,WESTERN EUROPE-EU,IRISH REPUBLIC,2,GLASGOW,DUBLIN,494340,493911,429,492705,491999,706,0.33184
03/03/2019 11:05,2018,1,WESTERN EUROPE-EU,IRISH REPUBLIC,2,GLASGOW,SHANNON,41,0,41,189,0,189,-78.30688
03/03/2019 11:05,2018,1,WESTERN EUROPE-EU,IRISH REPUBLIC,2,INVERNESS,DUBLIN,12881,12881,0,17576,17576,0,-26.71256
03/03/2019 11:05,2018,1,WESTERN EUROPE-EU,IRISH REPUBLIC,2,ISLE OF MAN,DUBLIN,43302,43302,0,45293,45246,47,-4.39582
03/03/2019 11:05,2018,1,WESTERN EUROPE-EU,IRISH REPUBLIC,2,JERSEY,CORK,0,0,0,271,271,0,-100
03/03/2019 11:05,2018,1,WESTERN EUROPE-EU,IRISH REPUBLIC,2,JERSEY,DUBLIN,14774,14774,0,13827,13813,14,6.84892
03/03/2019 11:05,2018,1,WESTERN EUROPE-EU,IRISH REPUBLIC,2,LEEDS BRADFORD,CORK,0,0,0,38,38,0,-100
03/03/2019 11:05,2018,1,WESTERN EUROPE-EU,IRISH REPUBLIC,2,LEEDS BRADFORD,DUBLIN,289963,289963,0,297598,297598,0,-2.56554
03/03/2019 11:05,2018,1,WESTERN EUROPE-EU,IRISH REPUBLIC,2,LIVERPOOL (JOHN LENNON),CORK,71757,71757,0,72380,72380,0,-0.86074
03/03/2019 11:05,2018,1,WESTERN EUROPE-EU,IRISH REPUBLIC,2,LIVERPOOL (JOHN LENNON),DUBLIN,380437,380382,55,401394,401298,96,-5.22105
03/03/2019 11:05,2018,1,WESTERN EUROPE-EU,IRISH REPUBLIC,2,LIVERPOOL (JOHN LENNON),IRELAND WEST(KNOCK),85738,85738,0,85631,85631,0,0.12495
03/03/2019 11:05,2018,1,WESTERN EUROPE-EU,IRISH REPUBLIC,2,LIVERPOOL (JOHN LENNON),SHANNON,15067,15067,0,0,0,0,0
03/03/2019 11:05,2018,1,WESTERN EUROPE-EU,IRISH REPUBLIC,2,MANCHESTER,CORK,105782,105740,42,104792,104792,0,0.94473
03/03/2019 11:05,2018,1,WESTERN EUROPE-EU,IRISH REPUBLIC,2,MANCHESTER,DUBLIN,980158,979240,918,974979,973472,1507,0.53119
03/03/2019 11:05,2018,1,WESTERN EUROPE-EU,IRISH REPUBLIC,2,MANCHESTER,IRELAND WEST(KNOCK),37299,37299,0,29439,29439,0,26.69928
03/03/2019 11:05,2018,1,WESTERN EUROPE-EU,IRISH REPUBLIC,2,MANCHESTER,SHANNON,84283,84283,0,72960,72960,0,15.51946
03/03/2019 11:05,2018,1,WESTERN EUROPE-EU,IRISH REPUBLIC,2,NEWCASTLE,CORK,8973,8973,0,12195,12195,0,-26.42066
03/03/2019 11:05,2018,1,WESTERN EUROPE-EU,IRISH REPUBLIC,2,NEWCASTLE,DUBLIN,227780,227671,109,264398,264347,51,-13.84958
03/03/2019 11:05,2018,1,WESTERN EUROPE-EU,IRISH REPUBLIC,2,NEWQUAY,CORK,3581,3581,0,3558,3558,0,0.64643
03/03/2019 11:05,2018,1,WESTERN EUROPE-EU,IRISH REPUBLIC,2,NEWQUAY,DUBLIN,29156,29156,0,24028,24028,0,21.34177
03/03/2019 11:05,2018,1,WESTERN EUROPE-EU,IRISH REPUBLIC,2,NORWICH,DUBLIN,0,0,0,39,0,39,-100
03/03/2019 11:05,2018,1,WESTERN EUROPE-EU,IRISH REPUBLIC,2,OXFORD (KIDLINGTON),DUBLIN,100,100,0,0,0,0,0
03/03/2019 11:05,2018,1,WESTERN EUROPE-EU,IRISH REPUBLIC,2,PRESTWICK,DUBLIN,0,0,0,326,0,326,-100
03/03/2019 11:05,2018,1,WESTERN EUROPE-EU,IRISH REPUBLIC,2,SOUTHAMPTON,CORK,24190,24190,0,24119,24071,48,0.29437
03/03/2019 11:05,2018,1,WESTERN EUROPE-EU,IRISH REPUBLIC,2,SOUTHAMPTON,DUBLIN,154846,154846,0,140752,140752,0,10.01336
03/03/2019 11:05,2018,1,WESTERN EUROPE-EU,ITALY,1,GATWICK,ALGHERO (FERTILIA),8440,0,8440,8355,0,8355,1.01735
03/03/2019 11:05,2018,1,WESTERN EUROPE-EU,ITALY,1,GATWICK,ANCONA,6176,6176,0,0,0,0,0
03/03/2019 11:05,2018,1,WESTERN EUROPE-EU,ITALY,1,GATWICK,BARI (PALESE),92968,92968,0,83618,83618,0,11.1818
03/03/2019 11:05,2018,1,WESTERN EUROPE-EU,ITALY,1,GATWICK,BERGAMO,0,0,0,241,0,241,-100
03/03/2019 11:05,2018,1,WESTERN EUROPE-EU,ITALY,1,GATWICK,BOLOGNA,97239,97239,0,98657,98657,0,-1.4373
03/03/2019 11:05,2018,1,WESTERN EUROPE-EU,ITALY,1,GATWICK,BRINDISI,17436,17436,0,17109,17109,0,1.91127
03/03/2019 11:05,2018,1,WESTERN EUROPE-EU,ITALY,1,GATWICK,CAGLIARI (ELMAS),36263,36237,26,33886,33886,0,7.0147
03/03/2019 11:05,2018,1,WESTERN EUROPE-EU,ITALY,1,GATWICK,CATANIA (FONTANAROSSA),206029,193652,12377,205997,193757,12240,0.01553
03/03/2019 11:05,2018,1,WESTERN EUROPE-EU,ITALY,1,GATWICK,FLORENCE,96458,96458,0,86676,86676,0,11.28571
03/03/2019 11:05,2018,1,WESTERN EUROPE-EU,ITALY,1,GATWICK,GENOA,76750,76723,27,73772,73772,0,4.03676
03/03/2019 11:05,2018,1,WESTERN EUROPE-EU,ITALY,1,GATWICK,MILAN (LINATE),302431,302431,0,305599,305599,0,-1.03665
03/03/2019 11:05,2018,1,WESTERN EUROPE-EU,ITALY,1,GATWICK,MILAN (MALPENSA),577949,577830,119,568120,568120,0,1.73009
03/03/2019 11:05,2018,1,WESTERN EUROPE-EU,ITALY,1,GATWICK,NAPLES,417951,388881,29070,432334,403042,29292,-3.32683
03/03/2019 11:05,2018,1,WESTERN EUROPE-EU,ITALY,1,GATWICK,OLBIA,103160,94351,8809,104704,103964,740,-1.47463
03/03/2019 11:05,2018,1,WESTERN EUROPE-EU,ITALY,1,GATWICK,PALERMO,65170,65170,0,65865,65865,0,-1.05519
03/03/2019 11:05,2018,1,WESTERN EUROPE-EU,ITALY,1,GATWICK,PISA,266199,266199,0,253863,253863,0,4.85931
03/03/2019 11:05,2018,1,WESTERN EUROPE-EU,ITALY,1,GATWICK,ROME (FIUMICINO),695278,691260,4018,705708,705155,553,-1.47795
03/03/2019 11:05,2018,1,WESTERN EUROPE-EU,ITALY,1,GATWICK,TREVISO,0,0,0,160,160,0,-100
03/03/2019 11:05,2018,1,WESTERN EUROPE-EU,ITALY,1,GATWICK,TURIN,183844,160996,22848,170415,150710,19705,7.88017
03/03/2019 11:05,2018,1,WESTERN EUROPE-EU,ITALY,1,GATWICK,VENICE,704520,697273,7247,751512,744190,7322,-6.25299
03/03/2019 11:05,2018,1,WESTERN EUROPE-EU,ITALY,1,GATWICK,VERONA VILLAFRANCA,281950,262190,19760,273664,254841,18823,3.0278
03/03/2019 11:05,2018,1,WESTERN EUROPE-EU,ITALY,1,HEATHROW,BOLOGNA,295711,295711,0,273415,273415,0,8.15464
03/03/2019 11:05,2018,1,WESTERN EUROPE-EU,ITALY,1,HEATHROW,BRINDISI,10846,10846,0,10786,10786,0,0.55628
03/03/2019 11:05,2018,1,WESTERN EUROPE-EU,ITALY,1,HEATHROW,CAGLIARI (ELMAS),7587,0,7587,8325,165,8160,-8.86486
03/03/2019 11:05,2018,1,WESTERN EUROPE-EU,ITALY,1,HEATHROW,LAMETIA-TERME,8409,0,8409,0,0,0,0
03/03/2019 11:05,2018,1,WESTERN EUROPE-EU,ITALY,1,HEATHROW,MILAN (LINATE),672959,672959,0,657343,657343,0,2.37562
03/03/2019 11:05,2018,1,WESTERN EUROPE-EU,ITALY,1,HEATHROW,MILAN (MALPENSA),248131,248131,0,245175,245175,0,1.20567
03/03/2019 11:05,2018,1,WESTERN EUROPE-EU,ITALY,1,HEATHROW,OLBIA,33355,24271,9084,30325,18523,11802,9.99176
03/03/2019 11:05,2018,1,WESTERN EUROPE-EU,ITALY,1,HEATHROW,PALERMO,30845,30845,0,28992,28992,0,6.39142
03/03/2019 11:05,2018,1,WESTERN EUROPE-EU,ITALY,1,HEATHROW,PISA,130957,130957,0,118593,118593,0,10.42557
03/03/2019 11:05,2018,1,WESTERN EUROPE-EU,ITALY,1,HEATHROW,ROME (FIUMICINO),1076489,1073620,2869,976106,972783,3323,10.28403
03/03/2019 11:05,2018,1,WESTERN EUROPE-EU,ITALY,1,HEATHROW,TREVISO,455,0,455,0,0,0,0
03/03/2019 11:05,2018,1,WESTERN EUROPE-EU,ITALY,1,HEATHROW,TRIESTE (RONCHI DEI LEGIONARI),0,0,0,507,0,507,-100
03/03/2019 11:05,2018,1,WESTERN EUROPE-EU,ITALY,1,HEATHROW,TURIN,5550,5550,0,2025,2025,0,174.07407
03/03/2019 11:05,2018,1,WESTERN EUROPE-EU,ITALY,1,HEATHROW,VENICE,200412,199962,450,196126,193621,2505,2.18533
03/03/2019 11:05,2018,1,WESTERN EUROPE-EU,ITALY,1,LONDON CITY,BOLOGNA,532,532,0,272,272,0,95.58824
03/03/2019 11:05,2018,1,WESTERN EUROPE-EU,ITALY,1,LONDON CITY,FLORENCE,94648,94648,0,96945,96945,0,-2.36938
03/03/2019 11:05,2018,1,WESTERN EUROPE-EU,ITALY,1,LONDON CITY,MILAN (LINATE),362960,362960,0,248071,248071,0,46.31295
03/03/2019 11:05,2018,1,WESTERN EUROPE-EU,ITALY,1,LONDON CITY,MILAN (MALPENSA),0,0,0,147,0,147,-100
03/03/2019 11:05,2018,1,WESTERN EUROPE-EU,ITALY,1,LONDON CITY,PISA,138,138,0,727,727,0,-81.01788
03/03/2019 11:05,2018,1,WESTERN EUROPE-EU,ITALY,1,LONDON CITY,ROME (FIUMICINO),15043,15043,0,46534,46534,0,-67.6731
03/03/2019 11:05,2018,1,WESTERN EUROPE-EU,ITALY,1,LONDON CITY,VENICE,20897,20897,0,20465,20465,0,2.11092
03/03/2019 11:05,2018,1,WESTERN EUROPE-EU,ITALY,1,LUTON,ALGHERO (FERTILIA),30421,30421,0,2575,2575,0,1081.39806
03/03/2019 11:05,2018,1,WESTERN EUROPE-EU,ITALY,1,LUTON,BARI (PALESE),43630,43630,0,13,0,13,335515.38462
03/03/2019 11:05,2018,1,WESTERN EUROPE-EU,ITALY,1,LUTON,BERGAMO,0,0,0,167,0,167,-100
03/03/2019 11:05,2018,1,WESTERN EUROPE-EU,ITALY,1,LUTON,BOLOGNA,20500,20500,0,6,0,6,341566.66667
03/03/2019 11:05,2018,1,WESTERN EUROPE-EU,ITALY,1,LUTON,CAGLIARI (ELMAS),0,0,0,7694,7694,0,-100
03/03/2019 11:05,2018,1,WESTERN EUROPE-EU,ITALY,1,LUTON,CATANIA (FONTANAROSSA),57011,57011,0,51441,51251,190,10.82794
03/03/2019 11:05,2018,1,WESTERN EUROPE-EU,ITALY,1,LUTON,FLORENCE,23168,23168,0,18968,18958,10,22.14256
03/03/2019 11:05,2018,1,WESTERN EUROPE-EU,ITALY,1,LUTON,GENOA,19418,19418,0,0,0,0,0
03/03/2019 11:05,2018,1,WESTERN EUROPE-EU,ITALY,1,LUTON,LAMETIA-TERME,0,0,0,181,181,0,-100
03/03/2019 11:05,2018,1,WESTERN EUROPE-EU,ITALY,1,LUTON,MILAN (LINATE),117,117,0,0,0,0,0
03/03/2019 11:05,2018,1,WESTERN EUROPE-EU,ITALY,1,LUTON,MILAN (MALPENSA),171832,171591,241,166292,165772,520,3.33149
03/03/2019 11:05,2018,1,WESTERN EUROPE-EU,ITALY,1,LUTON,NAPLES,133038,125214,7824,124863,115160,9703,6.54718
03/03/2019 11:05,2018,1,WESTERN EUROPE-EU,ITALY,1,LUTON,OLBIA,18305,18305,0,20713,20699,14,-11.62555
03/03/2019 11:05,2018,1,WESTERN EUROPE-EU,ITALY,1,LUTON,PALERMO,29270,29270,0,237,182,55,12250.21097
03/03/2019 11:05,2018,1,WESTERN EUROPE-EU,ITALY,1,LUTON,PISA,95821,95761,60,83328,83328,0,14.99256
03/03/2019 11:05,2018,1,WESTERN EUROPE-EU,ITALY,1,LUTON,ROME (CIAMPINO),0,0,0,186,186,0,-100
03/03/2019 11:05,2018,1,WESTERN EUROPE-EU,ITALY,1,LUTON,ROME (FIUMICINO),123515,123223,292,129159,128942,217,-4.36981
03/03/2019 11:05,2018,1,WESTERN EUROPE-EU,ITALY,1,LUTON,SALERNO COSTA AMALFI,0,0,0,12,0,12,-100
03/03/2019 11:05,2018,1,WESTERN EUROPE-EU,ITALY,1,LUTON,TREVISO,0,0,0,184,184,0,-100
03/03/2019 11:05,2018,1,WESTERN EUROPE-EU,ITALY,1,LUTON,TURIN,38682,38682,0,49654,48880,774,-22.09691
03/03/2019 11:05,2018,1,WESTERN EUROPE-EU,ITALY,1,LUTON,VENICE,96105,96105,0,93303,93303,0,3.00312
03/03/2019 11:05,2018,1,WESTERN EUROPE-EU,ITALY,1,LUTON,VERONA VILLAFRANCA,1779,1411,368,315,0,315,464.7619
03/03/2019 11:05,2018,1,WESTERN EUROPE-EU,ITALY,1,SOUTHEND,CAGLIARI (ELMAS),11514,11514,0,0,0,0,0
03/03/2019 11:05,2018,1,WESTERN EUROPE-EU,ITALY,1,SOUTHEND,CATANIA (FONTANAROSSA),17909,17909,0,0,0,0,0
03/03/2019 11:05,2018,1,WESTERN EUROPE-EU,ITALY,1,SOUTHEND,FLORENCE,0,0,0,374,374,0,-100
03/03/2019 11:05,2018,1,WESTERN EUROPE-EU,ITALY,1,SOUTHEND,MILAN (LINATE),43,43,0,0,0,0,0
03/03/2019 11:05,2018,1,WESTERN EUROPE-EU,ITALY,1,SOUTHEND,MILAN (MALPENSA),16286,16286,0,16422,16422,0,-0.82816
03/03/2019 11:05,2018,1,WESTERN EUROPE-EU,ITALY,1,SOUTHEND,PISA,0,0,0,254,254,0,-100
03/03/2019 11:05,2018,1,WESTERN EUROPE-EU,ITALY,1,SOUTHEND,VENICE,0,0,0,5346,5346,0,-100
03/03/2019 11:05,2018,1,WESTERN EUROPE-EU,ITALY,1,STANSTED,ALGHERO (FERTILIA),31057,31057,0,36832,36832,0,-15.6793
03/03/2019 11:05,2018,1,WESTERN EUROPE-EU,ITALY,1,STANSTED,ANCONA,112199,112199,0,109200,109200,0,2.74634
03/03/2019 11:05,2018,1,WESTERN EUROPE-EU,ITALY,1,STANSTED,BARI (PALESE),123400,122662,738,128535,128535,0,-3.99502
03/03/2019 11:05,2018,1,WESTERN EUROPE-EU,ITALY,1,STANSTED,BERGAMO,476531,476531,0,472393,472393,0,0.87597
03/03/2019 11:05,2018,1,WESTERN EUROPE-EU,ITALY,1,STANSTED,BOLOGNA,222938,222938,0,223568,223568,0,-0.28179
03/03/2019 11:05,2018,1,WESTERN EUROPE-EU,ITALY,1,STANSTED,BRINDISI,84402,84402,0,79581,79581,0,6.05798
03/03/2019 11:05,2018,1,WESTERN EUROPE-EU,ITALY,1,STANSTED,CAGLIARI (ELMAS),131422,131422,0,123799,123799,0,6.15756
03/03/2019 11:05,2018,1,WESTERN EUROPE-EU,ITALY,1,STANSTED,CATANIA (FONTANAROSSA),0,0,0,245,245,0,-100
03/03/2019 11:05,2018,1,WESTERN EUROPE-EU,ITALY,1,STANSTED,COMISO,20781,20781,0,20800,20800,0,-0.09135
03/03/2019 11:05,2018,1,WESTERN EUROPE-EU,ITALY,1,STANSTED,FLORENCE,7626,7626,0,7664,7664,0,-0.49582
03/03/2019 11:05,2018,1,WESTERN EUROPE-EU,ITALY,1,STANSTED,GENOA,82233,82233,0,83690,83690,0,-1.74095
03/03/2019 11:05,2018,1,WESTERN EUROPE-EU,ITALY,1,STANSTED,LAMETIA-TERME,61928,61928,0,60431,60431,0,2.47721
03/03/2019 11:05,2018,1,WESTERN EUROPE-EU,ITALY,1,STANSTED,MILAN (LINATE),11470,11470,0,8638,8638,0,32.78537
03/03/2019 11:05,2018,1,WESTERN EUROPE-EU,ITALY,1,STANSTED,MILAN (MALPENSA),217422,217366,56,222586,222586,0,-2.32
03/03/2019 11:05,2018,1,WESTERN EUROPE-EU,ITALY,1,STANSTED,NAPLES,319553,319553,0,224989,224546,443,42.0305
03/03/2019 11:05,2018,1,WESTERN EUROPE-EU,ITALY,1,STANSTED,PALERMO,108074,108074,0,111690,111690,0,-3.23753
03/03/2019 11:05,2018,1,WESTERN EUROPE-EU,ITALY,1,STANSTED,PERUGIA,96227,96227,0,92992,92992,0,3.47879
03/03/2019 11:05,2018,1,WESTERN EUROPE-EU,ITALY,1,STANSTED,PESCARA,91024,91024,0,89859,89859,0,1.29648
03/03/2019 11:05,2018,1,WESTERN EUROPE-EU,ITALY,1,STANSTED,PISA,308557,308557,0,328318,328318,0,-6.01886
03/03/2019 11:05,2018,1,WESTERN EUROPE-EU,ITALY,1,STANSTED,RIMINI,20775,20775,0,0,0,0,0
03/03/2019 11:05,2018,1,WESTERN EUROPE-EU,ITALY,1,STANSTED,ROME (CIAMPINO),622875,622875,0,616558,616558,0,1.02456
03/03/2019 11:05,2018,1,WESTERN EUROPE-EU,ITALY,1,STANSTED,ROME (FIUMICINO),3050,2066,984,1341,38,1303,127.44221
03/03/2019 11:05,2018,1,WESTERN EUROPE-EU,ITALY,1,STANSTED,TREVISO,320800,320800,0,323953,323953,0,-0.97329
03/03/2019 11:05,2018,1,WESTERN EUROPE-EU,ITALY,1,STANSTED,TRIESTE (RONCHI DEI LEGIONARI),63765,63765,0,64651,64651,0,-1.37044
03/03/2019 11:05,2018,1,WESTERN EUROPE-EU,ITALY,1,STANSTED,TURIN,133865,126529,7336,128491,122784,5707,4.18239
03/03/2019 11:05,2018,1,WESTERN EUROPE-EU,ITALY,1,STANSTED,VENICE,538,538,0,13789,13573,216,-96.09834
03/03/2019 11:05,2018,1,WESTERN EUROPE-EU,ITALY,1,STANSTED,VERONA VILLAFRANCA,84866,84866,0,73675,73556,119,15.18968
03/03/2019 11:05,2018,1,WESTERN EUROPE-EU,ITALY,2,ABERDEEN,CATANIA (FONTANAROSSA),182,182,0,0,0,0,0
03/03/2019 11:05,2018,1,WESTERN EUROPE-EU,ITALY,2,ABERDEEN,MILAN (MALPENSA),0,0,0,168,0,168,-100
03/03/2019 11:05,2018,1,WESTERN EUROPE-EU,ITALY,2,ABERDEEN,NAPLES,0,0,0,142,0,142,-100
03/03/2019 11:05,2018,1,WESTERN EUROPE-EU,ITALY,2,ABERDEEN,TREVISO,0,0,0,53,0,53,-100
03/03/2019 11:05,2018,1,WESTERN EUROPE-EU,ITALY,2,ABERDEEN,VENICE,0,0,0,49,0,49,-100
03/03/2019 11:05,2018,1,WESTERN EUROPE-EU,ITALY,2,ABERDEEN,VERONA VILLAFRANCA,0,0,0,168,0,168,-100
03/03/2019 11:05,2018,1,WESTERN EUROPE-EU,ITALY,2,BELFAST CITY (GEORGE BEST),VERONA VILLAFRANCA,0,0,0,2118,0,2118,-100
03/03/2019 11:05,2018,1,WESTERN EUROPE-EU,ITALY,2,BELFAST INTERNATIONAL,BERGAMO,32078,32078,0,31033,31033,0,3.36738
03/03/2019 11:05,2018,1,WESTERN EUROPE-EU,ITALY,2,BELFAST INTERNATIONAL,NAPLES,17617,17617,0,0,0,0,0
03/03/2019 11:05,2018,1,WESTERN EUROPE-EU,ITALY,2,BELFAST INTERNATIONAL,RIMINI,0,0,0,135,0,135,-100
03/03/2019 11:05,2018,1,WESTERN EUROPE-EU,ITALY,2,BELFAST INTERNATIONAL,ROME (CIAMPINO),0,0,0,121,0,121,-100
03/03/2019 11:05,2018,1,WESTERN EUROPE-EU,ITALY,2,BELFAST INTERNATIONAL,ROME (FIUMICINO),824,0,824,123,0,123,569.9187
03/03/2019 11:05,2018,1,WESTERN EUROPE-EU,ITALY,2,BELFAST INTERNATIONAL,TREVISO,43,0,43,0,0,0,0
03/03/2019 11:05,2018,1,WESTERN EUROPE-EU,ITALY,2,BELFAST INTERNATIONAL,VENICE,16746,16487,259,126,0,126,13190.47619
03/03/2019 11:05,2018,1,WESTERN EUROPE-EU,ITALY,2,BELFAST INTERNATIONAL,VERONA VILLAFRANCA,8665,0,8665,5755,0,5755,50.56473
03/03/2019 11:05,2018,1,WESTERN EUROPE-EU,ITALY,2,BIRMINGHAM,ALGHERO (FERTILIA),7802,182,7620,7681,0,7681,1.57532
03/03/2019 11:05,2018,1,WESTERN EUROPE-EU,ITALY,2,BIRMINGHAM,BARI (PALESE),689,0,689,0,0,0,0
03/03/2019 11:05,2018,1,WESTERN EUROPE-EU,ITALY,2,BIRMINGHAM,BERGAMO,211,0,211,737,526,211,-71.37042
03/03/2019 11:05,2018,1,WESTERN EUROPE-EU,ITALY,2,BIRMINGHAM,BOLOGNA,186,0,186,175,0,175,6.28571
03/03/2019 11:05,2018,1,WESTERN EUROPE-EU,ITALY,2,BIRMINGHAM,CATANIA (FONTANAROSSA),8250,0,8250,6430,0,6430,28.30482
03/03/2019 11:05,2018,1,WESTERN EUROPE-EU,ITALY,2,BIRMINGHAM,COMISO,8194,8194,0,8066,8066,0,1.58691
03/03/2019 11:05,2018,1,WESTERN EUROPE-EU,ITALY,2,BIRMINGHAM,FLORENCE,3945,3945,0,3174,3174,0,24.29112
03/03/2019 11:05,2018,1,WESTERN EUROPE-EU,ITALY,2,BIRMINGHAM,MILAN (LINATE),60,60,0,0,0,0,0
03/03/2019 11:05,2018,1,WESTERN EUROPE-EU,ITALY,2,BIRMINGHAM,MILAN (MALPENSA),59604,59530,74,84570,84570,0,-29.52111
03/03/2019 11:05,2018,1,WESTERN EUROPE-EU,ITALY,2,BIRMINGHAM,NAPLES,45755,19857,25898,37146,16183,20963,23.17612
03/03/2019 11:05,2018,1,WESTERN EUROPE-EU,ITALY,2,BIRMINGHAM,PARMA,0,0,0,187,0,187,-100
03/03/2019 11:05,2018,1,WESTERN EUROPE-EU,ITALY,2,BIRMINGHAM,PISA,16089,16089,0,80,80,0,20011.25
03/03/2019 11:05,2018,1,WESTERN EUROPE-EU,ITALY,2,BIRMINGHAM,ROME (CIAMPINO),502,502,0,83,0,83,504.81928
03/03/2019 11:05,2018,1,WESTERN EUROPE-EU,ITALY,2,BIRMINGHAM,ROME (FIUMICINO),58270,56430,1840,72044,71716,328,-19.11887
03/03/2019 11:05,2018,1,WESTERN EUROPE-EU,ITALY,2,BIRMINGHAM,TREVISO,42,0,42,0,0,0,0
03/03/2019 11:05,2018,1,WESTERN EUROPE-EU,ITALY,2,BIRMINGHAM,TURIN,13994,8155,5839,13335,5035,8300,4.94188
03/03/2019 11:05,2018,1,WESTERN EUROPE-EU,ITALY,2,BIRMINGHAM,VENICE,16512,16512,0,43128,42597,531,-61.71397
03/03/2019 11:05,2018,1,WESTERN EUROPE-EU,ITALY,2,BIRMINGHAM,VERONA VILLAFRANCA,56951,35209,21742,56117,35733,20384,1.48618
03/03/2019 11:05,2018,1,WESTERN EUROPE-EU,ITALY,2,BOURNEMOUTH,BARI (PALESE),0,0,0,159,159,0,-100
03/03/2019 11:05,2018,1,WESTERN EUROPE-EU,ITALY,2,BOURNEMOUTH,NAPLES,8926,0,8926,8991,0,8991,-0.72295
03/03/2019 11:05,2018,1,WESTERN EUROPE-EU,ITALY,2,BOURNEMOUTH,TURIN,2292,140,2152,3003,0,3003,-23.67632
03/03/2019 11:05,2018,1,WESTERN EUROPE-EU,ITALY,2,BOURNEMOUTH,VENICE,0,0,0,146,0,146,-100
03/03/2019 11:05,2018,1,WESTERN EUROPE-EU,ITALY,2,BOURNEMOUTH,VERONA VILLAFRANCA,0,0,0,286,0,286,-100
03/03/2019 11:05,2018,1,WESTERN EUROPE-EU,ITALY,2,BRISTOL,BERGAMO,50945,50945,0,51081,51081,0,-0.26624
03/03/2019 11:05,2018,1,WESTERN EUROPE-EU,ITALY,2,BRISTOL,BOLOGNA,19690,19690,0,21069,21069,0,-6.54516
03/03/2019 11:05,2018,1,WESTERN EUROPE-EU,ITALY,2,BRISTOL,CAGLIARI (ELMAS),0,0,0,447,0,447,-100
03/03/2019 11:05,2018,1,WESTERN EUROPE-EU,ITALY,2,BRISTOL,CATANIA (FONTANAROSSA),22466,22466,0,13201,13201,0,70.18408
03/03/2019 11:05,2018,1,WESTERN EUROPE-EU,ITALY,2,BRISTOL,FLORENCE,3065,3010,55,3143,3143,0,-2.48171
03/03/2019 11:05,2018,1,WESTERN EUROPE-EU,ITALY,2,BRISTOL,GENOA,11691,11691,0,0,0,0,0
03/03/2019 11:05,2018,1,WESTERN EUROPE-EU,ITALY,2,BRISTOL,MILAN (MALPENSA),5187,5187,0,9922,9922,0,-47.72223
03/03/2019 11:05,2018,1,WESTERN EUROPE-EU,ITALY,2,BRISTOL,NAPLES,48537,34596,13941,45811,26093,19718,5.95054
03/03/2019 11:05,2018,1,WESTERN EUROPE-EU,ITALY,2,BRISTOL,OLBIA,25218,23679,1539,18897,18897,0,33.44975
03/03/2019 11:05,2018,1,WESTERN EUROPE-EU,ITALY,2,BRISTOL,PISA,76899,76899,0,62342,62342,0,23.35023
03/03/2019 11:05,2018,1,WESTERN EUROPE-EU,ITALY,2,BRISTOL,ROME (FIUMICINO),113402,112653,749,112464,112269,195,0.83404
03/03/2019 11:05,2018,1,WESTERN EUROPE-EU,ITALY,2,BRISTOL,TURIN,10775,4652,6123,10822,4834,5988,-0.4343
03/03/2019 11:05,2018,1,WESTERN EUROPE-EU,ITALY,2,BRISTOL,VENICE,157044,157044,0,133577,133407,170,17.56814
03/03/2019 11:05,2018,1,WESTERN EUROPE-EU,ITALY,2,BRISTOL,VERONA VILLAFRANCA,11543,0,11543,694,0,694,1563.25648
03/03/2019 11:05,2018,1,WESTERN EUROPE-EU,ITALY,2,CARDIFF WALES,BERGAMO,146,146,0,511,0,511,-71.42857
03/03/2019 11:05,2018,1,WESTERN EUROPE-EU,ITALY,2,CARDIFF WALES,BOLOGNA,0,0,0,338,0,338,-100
03/03/2019 11:05,2018,1,WESTERN EUROPE-EU,ITALY,2,CARDIFF WALES,CATANIA (FONTANAROSSA),0,0,0,339,0,339,-100
03/03/2019 11:05,2018,1,WESTERN EUROPE-EU,ITALY,2,CARDIFF WALES,GENOA,0,0,0,51,0,51,-100
03/03/2019 11:05,2018,1,WESTERN EUROPE-EU,ITALY,2,CARDIFF WALES,MILAN (MALPENSA),21483,21445,38,31133,26195,4938,-30.99605
03/03/2019 11:05,2018,1,WESTERN EUROPE-EU,ITALY,2,CARDIFF WALES,PARMA,267,0,267,76,0,76,251.31579
03/03/2019 11:05,2018,1,WESTERN EUROPE-EU,ITALY,2,CARDIFF WALES,PISA,0,0,0,36,0,36,-100
03/03/2019 11:05,2018,1,WESTERN EUROPE-EU,ITALY,2,CARDIFF WALES,ROME (FIUMICINO),17584,17584,0,20211,14457,5754,-12.99787
03/03/2019 11:05,2018,1,WESTERN EUROPE-EU,ITALY,2,CARDIFF WALES,TREVISO,80,0,80,122,0,122,-34.42623
03/03/2019 11:05,2018,1,WESTERN EUROPE-EU,ITALY,2,CARDIFF WALES,TURIN,0,0,0,5978,0,5978,-100
03/03/2019 11:05,2018,1,WESTERN EUROPE-EU,ITALY,2,CARDIFF WALES,VENICE,8467,8467,0,652,0,652,1198.61963
03/03/2019 11:05,2018,1,WESTERN EUROPE-EU,ITALY,2,CARDIFF WALES,VERONA VILLAFRANCA,8180,8180,0,9556,8874,682,-14.39933
03/03/2019 11:05,2018,1,WESTERN EUROPE-EU,ITALY,2,DONCASTER SHEFFIELD,NAPLES,6802,0,6802,0,0,0,0
03/03/2019 11:05,2018,1,WESTERN EUROPE-EU,ITALY,2,DONCASTER SHEFFIELD,TURIN,2297,0,2297,2965,0,2965,-22.52951
03/03/2019 11:05,2018,1,WESTERN EUROPE-EU,ITALY,2,DURHAM TEES VALLEY,BERGAMO,0,0,0,168,0,168,-100
03/03/2019 11:05,2018,1,WESTERN EUROPE-EU,ITALY,2,DURHAM TEES VALLEY,NAPLES,0,0,0,441,218,223,-100
03/03/2019 11:05,2018,1,WESTERN EUROPE-EU,ITALY,2,DURHAM TEES VALLEY,VENICE,0,0,0,333,170,163,-100
03/03/2019 11:05,2018,1,WESTERN EUROPE-EU,ITALY,2,DURHAM TEES VALLEY,VERONA VILLAFRANCA,0,0,0,95,0,95,-100
03/03/2019 11:05,2018,1,WESTERN EUROPE-EU,ITALY,2,EAST MIDLANDS INTERNATIONAL,BERGAMO,53280,53280,0,53389,53389,0,-0.20416
03/03/2019 11:05,2018,1,WESTERN EUROPE-EU,ITALY,2,EAST MIDLANDS INTERNATIONAL,BRINDISI,181,0,181,0,0,0,0
03/03/2019 11:05,2018,1,WESTERN EUROPE-EU,ITALY,2,EAST MIDLANDS INTERNATIONAL,MILAN (MALPENSA),0,0,0,197,0,197,-100
03/03/2019 11:05,2018,1,WESTERN EUROPE-EU,ITALY,2,EAST MIDLANDS INTERNATIONAL,NAPLES,47738,30452,17286,47646,29892,17754,0.19309
03/03/2019 11:05,2018,1,WESTERN EUROPE-EU,ITALY,2,EAST MIDLANDS INTERNATIONAL,OLBIA,0,0,0,175,175,0,-100
03/03/2019 11:05,2018,1,WESTERN EUROPE-EU,ITALY,2,EAST MIDLANDS INTERNATIONAL,PISA,26714,26714,0,26924,26924,0,-0.77997
03/03/2019 11:05,2018,1,WESTERN EUROPE-EU,ITALY,2,EAST MIDLANDS INTERNATIONAL,ROME (CIAMPINO),32755,32755,0,48069,48069,0,-31.85837
03/03/2019 11:05,2018,1,WESTERN EUROPE-EU,ITALY,2,EAST MIDLANDS INTERNATIONAL,ROME (FIUMICINO),0,0,0,133,0,133,-100
03/03/2019 11:05,2018,1,WESTERN EUROPE-EU,ITALY,2,EAST MIDLANDS INTERNATIONAL,TREVISO,44264,44264,0,53045,53045,0,-16.55387
03/03/2019 11:05,2018,1,WESTERN EUROPE-EU,ITALY,2,EAST MIDLANDS INTERNATIONAL,VENICE,0,0,0,2780,2780,0,-100
03/03/2019 11:05,2018,1,WESTERN EUROPE-EU,ITALY,2,EAST MIDLANDS INTERNATIONAL,VERONA VILLAFRANCA,6445,6445,0,4643,4643,0,38.81111
03/03/2019 11:05,2018,1,WESTERN EUROPE-EU,ITALY,2,EDINBURGH,BERGAMO,84950,84792,158,65536,65536,0,29.62341
03/03/2019 11:05,2018,1,WESTERN EUROPE-EU,ITALY,2,EDINBURGH,BOLOGNA,34516,34516,0,36347,36347,0,-5.03755
03/03/2019 11:05,2018,1,WESTERN EUROPE-EU,ITALY,2,EDINBURGH,FLORENCE,3499,3499,0,0,0,0,0
03/03/2019 11:05,2018,1,WESTERN EUROPE-EU,ITALY,2,EDINBURGH,MILAN (MALPENSA),164921,164921,0,157232,157093,139,4.89023
03/03/2019 11:05,2018,1,WESTERN EUROPE-EU,ITALY,2,EDINBURGH,NAPLES,46838,46838,0,29118,29118,0,60.85583
03/03/2019 11:05,2018,1,WESTERN EUROPE-EU,ITALY,2,EDINBURGH,PISA,32428,32428,0,33874,33874,0,-4.26876
03/03/2019 11:05,2018,1,WESTERN EUROPE-EU,ITALY,2,EDINBURGH,ROME (CIAMPINO),87245,87245,0,88854,88854,0,-1.81084
03/03/2019 11:05,2018,1,WESTERN EUROPE-EU,ITALY,2,EDINBURGH,ROME (FIUMICINO),3442,684,2758,23766,20888,2878,-85.51713
03/03/2019 11:05,2018,1,WESTERN EUROPE-EU,ITALY,2,EDINBURGH,TREVISO,49630,49630,0,8174,8174,0,507.16907
03/03/2019 11:05,2018,1,WESTERN EUROPE-EU,ITALY,2,EDINBURGH,TURIN,3823,3823,0,4049,3762,287,-5.58163
03/03/2019 11:05,2018,1,WESTERN EUROPE-EU,ITALY,2,EDINBURGH,VENICE,77974,77974,0,83412,83365,47,-6.51945
03/03/2019 11:05,2018,1,WESTERN EUROPE-EU,ITALY,2,EDINBURGH,VERONA VILLAFRANCA,14337,12041,2296,9138,9043,95,56.89429
03/03/2019 11:05,2018,1,WESTERN EUROPE-EU,ITALY,2,EXETER,MILAN (MALPENSA),31,31,0,23,0,23,34.78261
03/03/2019 11:05,2018,1,WESTERN EUROPE-EU,ITALY,2,EXETER,NAPLES,0,0,0,118,0,118,-100
03/03/2019 11:05,2018,1,WESTERN EUROPE-EU,ITALY,2,EXETER,VENICE,0,0,0,52,0,52,-100
03/03/2019 11:05,2018,1,WESTERN EUROPE-EU,ITALY,2,GLASGOW,GENOA,3406,0,3406,0,0,0,0
03/03/2019 11:05,2018,1,WESTERN EUROPE-EU,ITALY,2,GLASGOW,GROSETTO,0,0,0,218,0,218,-100
03/03/2019 11:05,2018,1,WESTERN EUROPE-EU,ITALY,2,GLASGOW,MILAN (MALPENSA),35384,33381,2003,40859,38990,1869,-13.39974
03/03/2019 11:05,2018,1,WESTERN EUROPE-EU,ITALY,2,GLASGOW,NAPLES,12629,0,12629,13149,0,13149,-3.95467
03/03/2019 11:05,2018,1,WESTERN EUROPE-EU,ITALY,2,GLASGOW,ROME (FIUMICINO),30518,29743,775,25801,25801,0,18.28224
03/03/2019 11:05,2018,1,WESTERN EUROPE-EU,ITALY,2,GLASGOW,TRIESTE (RONCHI DEI LEGIONARI),173,173,0,0,0,0,0
03/03/2019 11:05,2018,1,WESTERN EUROPE-EU,ITALY,2,GLASGOW,TURIN,5315,0,5315,5952,0,5952,-10.70228
03/03/2019 11:05,2018,1,WESTERN EUROPE-EU,ITALY,2,GLASGOW,VENICE,8006,4449,3557,3487,0,3487,129.59564
03/03/2019 11:05,2018,1,WESTERN EUROPE-EU,ITALY,2,GLASGOW,VERONA VILLAFRANCA,12186,158,12028,12649,0,12649,-3.66037
03/03/2019 11:05,2018,1,WESTERN EUROPE-EU,ITALY,2,GLOUCESTERSHIRE,TURIN,0,0,0,60,0,60,-100
03/03/2019 11:05,2018,1,WESTERN EUROPE-EU,ITALY,2,GUERNSEY,FLORENCE,92,0,92,0,0,0,0
03/03/2019 11:05,2018,1,WESTERN EUROPE-EU,ITALY,2,HUMBERSIDE,BERGAMO,0,0,0,340,0,340,-100
03/03/2019 11:05,2018,1,WESTERN EUROPE-EU,ITALY,2,HUMBERSIDE,NAPLES,0,0,0,659,0,659,-100
03/03/2019 11:05,2018,1,WESTERN EUROPE-EU,ITALY,2,HUMBERSIDE,VENICE,168,0,168,756,0,756,-77.77778
03/03/2019 11:05,2018,1,WESTERN EUROPE-EU,ITALY,2,HUMBERSIDE,VERONA VILLAFRANCA,0,0,0,284,0,284,-100
03/03/2019 11:05,2018,1,WESTERN EUROPE-EU,ITALY,2,ISLE OF MAN,CATANIA (FONTANAROSSA),0,0,0,252,0,252,-100
03/03/2019 11:05,2018,1,WESTERN EUROPE-EU,ITALY,2,ISLE OF MAN,NAPLES,0,0,0,74,0,74,-100
03/03/2019 11:05,2018,1,WESTERN EUROPE-EU,ITALY,2,ISLE OF MAN,VENICE,0,0,0,370,0,370,-100
03/03/2019 11:05,2018,1,WESTERN EUROPE-EU,ITALY,2,ISLE OF MAN,VERONA VILLAFRANCA,0,0,0,284,0,284,-100
03/03/2019 11:05,2018,1,WESTERN EUROPE-EU,ITALY,2,JERSEY,VENICE,0,0,0,290,0,290,-100
03/03/2019 11:05,2018,1,WESTERN EUROPE-EU,ITALY,2,JERSEY,VERONA VILLAFRANCA,0,0,0,263,0,263,-100
03/03/2019 11:05,2018,1,WESTERN EUROPE-EU,ITALY,2,LEEDS BRADFORD,NAPLES,15235,15235,0,23084,22674,410,-34.00191
03/03/2019 11:05,2018,1,WESTERN EUROPE-EU,ITALY,2,LEEDS BRADFORD,PISA,38879,38879,0,39809,39809,0,-2.33616
03/03/2019 11:05,2018,1,WESTERN EUROPE-EU,ITALY,2,LEEDS BRADFORD,ROME (FIUMICINO),28726,28526,200,25686,25686,0,11.83524
03/03/2019 11:05,2018,1,WESTERN EUROPE-EU,ITALY,2,LEEDS BRADFORD,TREVISO,20453,20453,0,19311,19253,58,5.91373
03/03/2019 11:05,2018,1,WESTERN EUROPE-EU,ITALY,2,LEEDS BRADFORD,TURIN,288,288,0,0,0,0,0
03/03/2019 11:05,2018,1,WESTERN EUROPE-EU,ITALY,2,LEEDS BRADFORD,VENICE,16953,16953,0,18528,18528,0,-8.50065
03/03/2019 11:05,2018,1,WESTERN EUROPE-EU,ITALY,2,LEEDS BRADFORD,VERONA VILLAFRANCA,6345,6345,0,250,250,0,2438
03/03/2019 11:05,2018,1,WESTERN EUROPE-EU,ITALY,2,LIVERPOOL (JOHN LENNON),BARI (PALESE),21060,21060,0,20157,20157,0,4.47983
03/03/2019 11:05,2018,1,WESTERN EUROPE-EU,ITALY,2,LIVERPOOL (JOHN LENNON),BERGAMO,17242,17242,0,27279,24937,2342,-36.79387
03/03/2019 11:05,2018,1,WESTERN EUROPE-EU,ITALY,2,LIVERPOOL (JOHN LENNON),MILAN (MALPENSA),46624,46624,0,9135,7778,1357,410.38862
03/03/2019 11:05,2018,1,WESTERN EUROPE-EU,ITALY,2,LIVERPOOL (JOHN LENNON),NAPLES,24022,23111,911,22929,22929,0,4.76689
03/03/2019 11:05,2018,1,WESTERN EUROPE-EU,ITALY,2,LIVERPOOL (JOHN LENNON),PALERMO,8115,8115,0,0,0,0,0
03/03/2019 11:05,2018,1,WESTERN EUROPE-EU,ITALY,2,LIVERPOOL (JOHN LENNON),PARMA,0,0,0,769,0,769,-100
03/03/2019 11:05,2018,1,WESTERN EUROPE-EU,ITALY,2,LIVERPOOL (JOHN LENNON),PISA,20418,20418,0,28699,28699,0,-28.85466
03/03/2019 11:05,2018,1,WESTERN EUROPE-EU,ITALY,2,LIVERPOOL (JOHN LENNON),RIMINI,102,0,102,0,0,0,0
03/03/2019 11:05,2018,1,WESTERN EUROPE-EU,ITALY,2,LIVERPOOL (JOHN LENNON),ROME (CIAMPINO),0,0,0,184,184,0,-100
03/03/2019 11:05,2018,1,WESTERN EUROPE-EU,ITALY,2,LIVERPOOL (JOHN LENNON),ROME (FIUMICINO),56308,52100,4208,51900,51900,0,8.49326
03/03/2019 11:05,2018,1,WESTERN EUROPE-EU,ITALY,2,LIVERPOOL (JOHN LENNON),TURIN,136,0,136,211,155,56,-35.54502
03/03/2019 11:05,2018,1,WESTERN EUROPE-EU,ITALY,2,LIVERPOOL (JOHN LENNON),VENICE,33055,33055,0,4927,4927,0,570.89507
03/03/2019 11:05,2018,1,WESTERN EUROPE-EU,ITALY,2,MANCHESTER,ALGHERO (FERTILIA),7961,0,7961,8264,0,8264,-3.66651
03/03/2019 11:05,2018,1,WESTERN EUROPE-EU,ITALY,2,MANCHESTER,BARI (PALESE),266,0,266,0,0,0,0
03/03/2019 11:05,2018,1,WESTERN EUROPE-EU,ITALY,2,MANCHESTER,BERGAMO,151178,151178,0,156044,156044,0,-3.11835
03/03/2019 11:05,2018,1,WESTERN EUROPE-EU,ITALY,2,MANCHESTER,BOLOGNA,52588,52588,0,33386,33386,0,57.51513
03/03/2019 11:05,2018,1,WESTERN EUROPE-EU,ITALY,2,MANCHESTER,BRINDISI,21185,21185,0,20873,20873,0,1.49475
03/03/2019 11:05,2018,1,WESTERN EUROPE-EU,ITALY,2,MANCHESTER,CAGLIARI (ELMAS),14112,14112,0,724,0,724,1849.17127
03/03/2019 11:05,2018,1,WESTERN EUROPE-EU,ITALY,2,MANCHESTER,CATANIA (FONTANAROSSA),65737,54653,11084,60217,50459,9758,9.16685
03/03/2019 11:05,2018,1,WESTERN EUROPE-EU,ITALY,2,MANCHESTER,FLORENCE,3384,3384,0,0,0,0,0
03/03/2019 11:05,2018,1,WESTERN EUROPE-EU,ITALY,2,MANCHESTER,GENOA,22473,22473,0,303,303,0,7316.83168
03/03/2019 11:05,2018,1,WESTERN EUROPE-EU,ITALY,2,MANCHESTER,MILAN (MALPENSA),151543,151438,105,170270,170270,0,-10.99841
03/03/2019 11:05,2018,1,WESTERN EUROPE-EU,ITALY,2,MANCHESTER,NAPLES,123883,92614,31269,130014,99057,30957,-4.71565
03/03/2019 11:05,2018,1,WESTERN EUROPE-EU,ITALY,2,MANCHESTER,OLBIA,37115,26727,10388,24394,16431,7963,52.14807
03/03/2019 11:05,2018,1,WESTERN EUROPE-EU,ITALY,2,MANCHESTER,PALERMO,15219,15219,0,0,0,0,0
03/03/2019 11:05,2018,1,WESTERN EUROPE-EU,ITALY,2,MANCHESTER,PISA,84883,84883,0,82951,82951,0,2.32909
03/03/2019 11:05,2018,1,WESTERN EUROPE-EU,ITALY,2,MANCHESTER,RIMINI,0,0,0,70,0,70,-100
03/03/2019 11:05,2018,1,WESTERN EUROPE-EU,ITALY,2,MANCHESTER,ROME (CIAMPINO),166294,166294,0,170537,170537,0,-2.48802
03/03/2019 11:05,2018,1,WESTERN EUROPE-EU,ITALY,2,MANCHESTER,ROME (FIUMICINO),98769,94826,3943,112166,110193,1973,-11.9439
03/03/2019 11:05,2018,1,WESTERN EUROPE-EU,ITALY,2,MANCHESTER,TREVISO,29386,29386,0,0,0,0,0
03/03/2019 11:05,2018,1,WESTERN EUROPE-EU,ITALY,2,MANCHESTER,TRIESTE (RONCHI DEI LEGIONARI),0,0,0,669,0,669,-100
03/03/2019 11:05,2018,1,WESTERN EUROPE-EU,ITALY,2,MANCHESTER,TURIN,33561,20647,12914,31975,20683,11292,4.96013
03/03/2019 11:05,2018,1,WESTERN EUROPE-EU,ITALY,2,MANCHESTER,VENICE,124134,115756,8378,167718,157578,10140,-25.98648
03/03/2019 11:05,2018,1,WESTERN EUROPE-EU,ITALY,2,MANCHESTER,VERONA VILLAFRANCA,43142,14483,28659,50829,23731,27098,-15.12326
03/03/2019 11:05,2018,1,WESTERN EUROPE-EU,ITALY,2,NEWCASTLE,NAPLES,17651,17651,0,18290,18290,0,-3.49371
03/03/2019 11:05,2018,1,WESTERN EUROPE-EU,ITALY,2,NEWCASTLE,PISA,10732,10732,0,10476,10476,0,2.44368
03/03/2019 11:05,2018,1,WESTERN EUROPE-EU,ITALY,2,NEWCASTLE,ROME (CIAMPINO),0,0,0,179,0,179,-100
03/03/2019 11:05,2018,1,WESTERN EUROPE-EU,ITALY,2,NEWCASTLE,ROME (FIUMICINO),18075,18075,0,16951,16779,172,6.63088
03/03/2019 11:05,2018,1,WESTERN EUROPE-EU,ITALY,2,NEWCASTLE,TURIN,4848,4848,0,3571,3571,0,35.76029
03/03/2019 11:05,2018,1,WESTERN EUROPE-EU,ITALY,2,NEWCASTLE,VENICE,0,0,0,184,184,0,-100
03/03/2019 11:05,2018,1,WESTERN EUROPE-EU,ITALY,2,NEWCASTLE,VERONA VILLAFRANCA,14416,14416,0,13893,13803,90,3.76449
03/03/2019 11:05,2018,1,WESTERN EUROPE-EU,ITALY,2,NEWQUAY,NAPLES,0,0,0,278,0,278,-100
03/03/2019 11:05,2018,1,WESTERN EUROPE-EU,ITALY,2,NEWQUAY,VENICE,0,0,0,433,0,433,-100
03/03/2019 11:05,2018,1,WESTERN EUROPE-EU,ITALY,2,NEWQUAY,VERONA VILLAFRANCA,0,0,0,147,0,147,-100
03/03/2019 11:05,2018,1,WESTERN EUROPE-EU,ITALY,2,NORWICH,BERGAMO,0,0,0,134,0,134,-100
03/03/2019 11:05,2018,1,WESTERN EUROPE-EU,ITALY,2,NORWICH,MILAN (MALPENSA),0,0,0,150,0,150,-100
03/03/2019 11:05,2018,1,WESTERN EUROPE-EU,ITALY,2,NORWICH,NAPLES,0,0,0,279,0,279,-100
03/03/2019 11:05,2018,1,WESTERN EUROPE-EU,ITALY,2,NORWICH,VENICE,0,0,0,271,0,271,-100
03/03/2019 11:05,2018,1,WESTERN EUROPE-EU,ITALY,2,PRESTWICK,BERGAMO,130,0,130,0,0,0,0
03/03/2019 11:05,2018,1,WESTERN EUROPE-EU,ITALY,2,PRESTWICK,PISA,20029,20029,0,20504,20504,0,-2.31662
03/03/2019 11:05,2018,1,WESTERN EUROPE-EU,ITALY,2,PRESTWICK,ROME (CIAMPINO),21663,21663,0,21525,21525,0,0.64111
03/03/2019 11:05,2018,1,WESTERN EUROPE-EU,ITALY,2,SOUTHAMPTON,MILAN (MALPENSA),0,0,0,47,47,0,-100
03/03/2019 11:05,2018,1,WESTERN EUROPE-EU,ITALY,2,SOUTHAMPTON,TURIN,0,0,0,118,118,0,-100
03/03/2019 11:05,2018,1,WESTERN EUROPE-EU,ITALY,2,SOUTHAMPTON,VERONA VILLAFRANCA,7741,7741,0,7397,7397,0,4.65053
03/03/2019 11:05,2018,1,WESTERN EUROPE-EU,LUXEMBOURG,1,GATWICK,LUXEMBOURG,65487,65487,0,65067,65066,1,0.64549
03/03/2019 11:05,2018,1,WESTERN EUROPE-EU,LUXEMBOURG,1,HEATHROW,LUXEMBOURG,168605,168605,0,154673,154673,0,9.00739
03/03/2019 11:05,2018,1,WESTERN EUROPE-EU,LUXEMBOURG,1,LONDON CITY,LUXEMBOURG,184068,184068,0,174026,174026,0,5.7704
03/03/2019 11:05,2018,1,WESTERN EUROPE-EU,LUXEMBOURG,1,LUTON,LUXEMBOURG,192,192,0,165,122,43,16.36364
03/03/2019 11:05,2018,1,WESTERN EUROPE-EU,LUXEMBOURG,1,SOUTHEND,LUXEMBOURG,0,0,0,396,396,0,-100
03/03/2019 11:05,2018,1,WESTERN EUROPE-EU,LUXEMBOURG,1,STANSTED,LUXEMBOURG,108122,108122,0,108681,108563,118,-0.51435
03/03/2019 11:05,2018,1,WESTERN EUROPE-EU,LUXEMBOURG,2,BIRMINGHAM,LUXEMBOURG,0,0,0,19497,19497,0,-100
03/03/2019 11:05,2018,1,WESTERN EUROPE-EU,LUXEMBOURG,2,EDINBURGH,LUXEMBOURG,25,0,25,0,0,0,0
03/03/2019 11:05,2018,1,WESTERN EUROPE-EU,LUXEMBOURG,2,GLASGOW,LUXEMBOURG,25,0,25,828,0,828,-96.98068
03/03/2019 11:05,2018,1,WESTERN EUROPE-EU,LUXEMBOURG,2,GUERNSEY,LUXEMBOURG,0,0,0,249,0,249,-100
03/03/2019 11:05,2018,1,WESTERN EUROPE-EU,LUXEMBOURG,2,JERSEY,LUXEMBOURG,470,0,470,140,140,0,235.71429
03/03/2019 11:05,2018,1,WESTERN EUROPE-EU,LUXEMBOURG,2,MANCHESTER,LUXEMBOURG,28318,28318,0,27470,27470,0,3.087
03/03/2019 11:05,2018,1,WESTERN EUROPE-EU,LUXEMBOURG,2,PRESTWICK,LUXEMBOURG,0,0,0,4,4,0,-100
03/03/2019 11:05,2018,1,WESTERN EUROPE-EU,MALTA,1,GATWICK,MALTA,395639,368954,26685,381154,352448,28706,3.8003
03/03/2019 11:05,2018,1,WESTERN EUROPE-EU,MALTA,1,HEATHROW,MALTA,209863,209863,0,194604,194604,0,7.84105
03/03/2019 11:05,2018,1,WESTERN EUROPE-EU,MALTA,1,LUTON,MALTA,116793,116793,0,122169,122165,4,-4.40046
03/03/2019 11:05,2018,1,WESTERN EUROPE-EU,MALTA,1,SOUTHEND,MALTA,58673,58673,0,5632,5632,0,941.77912
03/03/2019 11:05,2018,1,WESTERN EUROPE-EU,MALTA,1,STANSTED,MALTA,110964,110633,331,87106,87106,0,27.38962
03/03/2019 11:05,2018,1,WESTERN EUROPE-EU,MALTA,2,ABERDEEN,MALTA,20269,20269,0,0,0,0,0
03/03/2019 11:05,2018,1,WESTERN EUROPE-EU,MALTA,2,BELFAST INTERNATIONAL,MALTA,39746,39746,0,4684,4684,0,748.54825
03/03/2019 11:05,2018,1,WESTERN EUROPE-EU,MALTA,2,BIRMINGHAM,MALTA,91738,81926,9812,79668,69162,10506,15.15037
03/03/2019 11:05,2018,1,WESTERN EUROPE-EU,MALTA,2,BOURNEMOUTH,MALTA,34748,34748,0,31829,31829,0,9.17088
03/03/2019 11:05,2018,1,WESTERN EUROPE-EU,MALTA,2,BRISTOL,MALTA,67576,63180,4396,68396,61678,6718,-1.1989
03/03/2019 11:05,2018,1,WESTERN EUROPE-EU,MALTA,2,DONCASTER SHEFFIELD,MALTA,0,0,0,118,0,118,-100
03/03/2019 11:05,2018,1,WESTERN EUROPE-EU,MALTA,2,EAST MIDLANDS INTERNATIONAL,MALTA,64733,64733,0,63000,63000,0,2.75079
03/03/2019 11:05,2018,1,WESTERN EUROPE-EU,MALTA,2,EDINBURGH,MALTA,58141,58141,0,60155,59978,177,-3.34802
03/03/2019 11:05,2018,1,WESTERN EUROPE-EU,MALTA,2,GLASGOW,MALTA,19748,19748,0,19636,19636,0,0.57038
03/03/2019 11:05,2018,1,WESTERN EUROPE-EU,MALTA,2,ISLE OF MAN,MALTA,0,0,0,170,0,170,-100
03/03/2019 11:05,2018,1,WESTERN EUROPE-EU,MALTA,2,LEEDS BRADFORD,MALTA,54502,54502,0,47892,47892,0,13.80189
03/03/2019 11:05,2018,1,WESTERN EUROPE-EU,MALTA,2,LIVERPOOL (JOHN LENNON),MALTA,35534,35534,0,38588,38588,0,-7.91438
03/03/2019 11:05,2018,1,WESTERN EUROPE-EU,MALTA,2,MANCHESTER,MALTA,233514,204148,29366,214351,185430,28921,8.94001
03/03/2019 11:05,2018,1,WESTERN EUROPE-EU,MALTA,2,NEWCASTLE,MALTA,44468,44468,0,42565,42565,0,4.47081
03/03/2019 11:05,2018,1,WESTERN EUROPE-EU,MALTA,2,PRESTWICK,MALTA,16493,16493,0,16520,16520,0,-0.16344
03/03/2019 11:05,2018,1,WESTERN EUROPE-EU,NETHERLANDS,1,GATWICK,AMSTERDAM,1085024,1085023,1,1074208,1074132,76,1.00688
03/03/2019 11:05,2018,1,WESTERN EUROPE-EU,NETHERLANDS,1,GATWICK,ROTTERDAM,0,0,0,87,87,0,-100
03/03/2019 11:05,2018,1,WESTERN EUROPE-EU,NETHERLANDS,1,HEATHROW,AMSTERDAM,1746528,1746528,0,1689924,1689924,0,3.3495
03/03/2019 11:05,2018,1,WESTERN EUROPE-EU,NETHERLANDS,1,LONDON CITY,AMSTERDAM,624965,624904,61,598424,598424,0,4.43515
03/03/2019 11:05,2018,1,WESTERN EUROPE-EU,NETHERLANDS,1,LONDON CITY,ROTTERDAM,173208,173208,0,178253,178253,0,-2.83025
03/03/2019 11:05,2018,1,WESTERN EUROPE-EU,NETHERLANDS,1,LUTON,AMSTERDAM,808549,808549,0,785646,785539,107,2.91518
03/03/2019 11:05,2018,1,WESTERN EUROPE-EU,NETHERLANDS,1,LUTON,EINDHOVEN,544,0,544,0,0,0,0
03/03/2019 11:05,2018,1,WESTERN EUROPE-EU,NETHERLANDS,1,LUTON,MAASTRICHT,63,0,63,135,0,135,-53.33333
03/03/2019 11:05,2018,1,WESTERN EUROPE-EU,NETHERLANDS,1,LUTON,ROTTERDAM,0,0,0,26,0,26,-100
03/03/2019 11:05,2018,1,WESTERN EUROPE-EU,NETHERLANDS,1,SOUTHEND,AMSTERDAM,193652,193652,0,190836,190836,0,1.47561
03/03/2019 11:05,2018,1,WESTERN EUROPE-EU,NETHERLANDS,1,SOUTHEND,GRONINGEN,55140,55140,0,27215,27215,0,102.60886
03/03/2019 11:05,2018,1,WESTERN EUROPE-EU,NETHERLANDS,1,SOUTHEND,ROTTERDAM,0,0,0,235,235,0,-100
03/03/2019 11:05,2018,1,WESTERN EUROPE-EU,NETHERLANDS,1,STANSTED,AMSTERDAM,358127,358127,0,338839,338244,595,5.69238
03/03/2019 11:05,2018,1,WESTERN EUROPE-EU,NETHERLANDS,1,STANSTED,EINDHOVEN,259398,259398,0,264387,264387,0,-1.88701
03/03/2019 11:05,2018,1,WESTERN EUROPE-EU,NETHERLANDS,1,STANSTED,GRONINGEN,171,0,171,0,0,0,0
03/03/2019 11:05,2018,1,WESTERN EUROPE-EU,NETHERLANDS,1,STANSTED,MAASTRICHT,0,0,0,98,0,98,-100
03/03/2019 11:05,2018,1,WESTERN EUROPE-EU,NETHERLANDS,1,STANSTED,ROTTERDAM,182,0,182,317,57,260,-42.58675
03/03/2019 11:05,2018,1,WESTERN EUROPE-EU,NETHERLANDS,2,ABERDEEN,AMSTERDAM,291139,291139,0,263400,263207,193,10.53113
03/03/2019 11:05,2018,1,WESTERN EUROPE-EU,NETHERLANDS,2,ABERDEEN,ROTTERDAM,0,0,0,132,0,132,-100
03/03/2019 11:05,2018,1,WESTERN EUROPE-EU,NETHERLANDS,2,BELFAST CITY (GEORGE BEST),AMSTERDAM,49648,49605,43,46528,46528,0,6.70564
03/03/2019 11:05,2018,1,WESTERN EUROPE-EU,NETHERLANDS,2,BELFAST CITY (GEORGE BEST),MAASTRICHT,75,0,75,0,0,0,0
03/03/2019 11:05,2018,1,WESTERN EUROPE-EU,NETHERLANDS,2,BELFAST INTERNATIONAL,AMSTERDAM,131014,130957,57,122389,122389,0,7.0472
03/03/2019 11:05,2018,1,WESTERN EUROPE-EU,NETHERLANDS,2,BELFAST INTERNATIONAL,MAASTRICHT,0,0,0,93,0,93,-100
03/03/2019 11:05,2018,1,WESTERN EUROPE-EU,NETHERLANDS,2,BIRMINGHAM,AMSTERDAM,703047,703047,0,675427,675427,0,4.08927
03/03/2019 11:05,2018,1,WESTERN EUROPE-EU,NETHERLANDS,2,BIRMINGHAM,EINDHOVEN,148,148,0,0,0,0,0
03/03/2019 11:05,2018,1,WESTERN EUROPE-EU,NETHERLANDS,2,BIRMINGHAM,GRONINGEN,241,0,241,0,0,0,0
03/03/2019 11:05,2018,1,WESTERN EUROPE-EU,NETHERLANDS,2,BIRMINGHAM,ROTTERDAM,70,70,0,644,644,0,-89.13043
03/03/2019 11:05,2018,1,WESTERN EUROPE-EU,NETHERLANDS,2,BOURNEMOUTH,AMSTERDAM,0,0,0,70,70,0,-100
03/03/2019 11:05,2018,1,WESTERN EUROPE-EU,NETHERLANDS,2,BRISTOL,AMSTERDAM,433802,433802,0,410341,410300,41,5.71744
03/03/2019 11:05,2018,1,WESTERN EUROPE-EU,NETHERLANDS,2,CARDIFF WALES,AMSTERDAM,146058,146058,0,134095,134095,0,8.92129
03/03/2019 11:05,2018,1,WESTERN EUROPE-EU,NETHERLANDS,2,DONCASTER SHEFFIELD,AMSTERDAM,58262,58262,0,55608,55608,0,4.77269
03/03/2019 11:05,2018,1,WESTERN EUROPE-EU,NETHERLANDS,2,DURHAM TEES VALLEY,AMSTERDAM,110754,110684,70,97833,97833,0,13.2072
03/03/2019 11:05,2018,1,WESTERN EUROPE-EU,NETHERLANDS,2,EAST MIDLANDS INTERNATIONAL,AMSTERDAM,48408,48408,0,43554,43554,0,11.14479
03/03/2019 11:05,2018,1,WESTERN EUROPE-EU,NETHERLANDS,2,EAST MIDLANDS INTERNATIONAL,MAASTRICHT,66,0,66,1,0,1,6500
03/03/2019 11:05,2018,1,WESTERN EUROPE-EU,NETHERLANDS,2,EAST MIDLANDS INTERNATIONAL,ROTTERDAM,0,0,0,51,51,0,-100
03/03/2019 11:05,2018,1,WESTERN EUROPE-EU,NETHERLANDS,2,EDINBURGH,AMSTERDAM,679148,679051,97,681601,681601,0,-0.35989
03/03/2019 11:05,2018,1,WESTERN EUROPE-EU,NETHERLANDS,2,EDINBURGH,EINDHOVEN,49722,49722,0,15725,15725,0,216.19714
03/03/2019 11:05,2018,1,WESTERN EUROPE-EU,NETHERLANDS,2,EXETER,AMSTERDAM,52725,52620,105,44752,44586,166,17.81596
03/03/2019 11:05,2018,1,WESTERN EUROPE-EU,NETHERLANDS,2,EXETER,ROTTERDAM,0,0,0,103,103,0,-100
03/03/2019 11:05,2018,1,WESTERN EUROPE-EU,NETHERLANDS,2,GLASGOW,AMSTERDAM,418067,418067,0,448287,448267,20,-6.74122
03/03/2019 11:05,2018,1,WESTERN EUROPE-EU,NETHERLANDS,2,GLASGOW,EINDHOVEN,356,0,356,0,0,0,0
03/03/2019 11:05,2018,1,WESTERN EUROPE-EU,NETHERLANDS,2,GLASGOW,GRONINGEN,29,0,29,0,0,0,0
03/03/2019 11:05,2018,1,WESTERN EUROPE-EU,NETHERLANDS,2,GLASGOW,MAASTRICHT,62,0,62,154,0,154,-59.74026
03/03/2019 11:05,2018,1,WESTERN EUROPE-EU,NETHERLANDS,2,GLASGOW,ROTTERDAM,122,0,122,0,0,0,0
03/03/2019 11:05,2018,1,WESTERN EUROPE-EU,NETHERLANDS,2,GUERNSEY,ROTTERDAM,1682,0,1682,2007,2007,0,-16.19332
03/03/2019 11:05,2018,1,WESTERN EUROPE-EU,NETHERLANDS,2,HUMBERSIDE,AMSTERDAM,127090,127090,0,118129,118129,0,7.58577
03/03/2019 11:05,2018,1,WESTERN EUROPE-EU,NETHERLANDS,2,HUMBERSIDE,ROTTERDAM,71,0,71,0,0,0,0
03/03/2019 11:05,2018,1,WESTERN EUROPE-EU,NETHERLANDS,2,INVERNESS,AMSTERDAM,81047,81047,0,75252,75252,0,7.70079
03/03/2019 11:05,2018,1,WESTERN EUROPE-EU,NETHERLANDS,2,JERSEY,ROTTERDAM,258,0,258,1120,1076,44,-76.96429
03/03/2019 11:05,2018,1,WESTERN EUROPE-EU,NETHERLANDS,2,LEEDS BRADFORD,AMSTERDAM,252180,251885,295,241819,241669,150,4.28461
03/03/2019 11:05,2018,1,WESTERN EUROPE-EU,NETHERLANDS,2,LIVERPOOL (JOHN LENNON),AMSTERDAM,220517,220170,347,220990,220990,0,-0.21404
03/03/2019 11:05,2018,1,WESTERN EUROPE-EU,NETHERLANDS,2,LIVERPOOL (JOHN LENNON),EINDHOVEN,0,0,0,179,179,0,-100
03/03/2019 11:05,2018,1,WESTERN EUROPE-EU,NETHERLANDS,2,LIVERPOOL (JOHN LENNON),ENSCHEDE (TWENTE),0,0,0,106,0,106,-100
03/03/2019 11:05,2018,1,WESTERN EUROPE-EU,NETHERLANDS,2,LIVERPOOL (JOHN LENNON),GRONINGEN,0,0,0,59,0,59,-100
03/03/2019 11:05,2018,1,WESTERN EUROPE-EU,NETHERLANDS,2,LIVERPOOL (JOHN LENNON),MAASTRICHT,0,0,0,50,0,50,-100
03/03/2019 11:05,2018,1,WESTERN EUROPE-EU,NETHERLANDS,2,MANCHESTER,AMSTERDAM,1035637,1035592,45,1041792,1041430,362,-0.59081
03/03/2019 11:05,2018,1,WESTERN EUROPE-EU,NETHERLANDS,2,MANCHESTER,EINDHOVEN,72129,72129,0,73426,73426,0,-1.7664
03/03/2019 11:05,2018,1,WESTERN EUROPE-EU,NETHERLANDS,2,MANCHESTER,MAASTRICHT,0,0,0,63,0,63,-100
03/03/2019 11:05,2018,1,WESTERN EUROPE-EU,NETHERLANDS,2,MANCHESTER,ROTTERDAM,0,0,0,1159,193,966,-100
03/03/2019 11:05,2018,1,WESTERN EUROPE-EU,NETHERLANDS,2,NEWCASTLE,AMSTERDAM,347776,347369,407,367002,366668,334,-5.23866
03/03/2019 11:05,2018,1,WESTERN EUROPE-EU,NETHERLANDS,2,NORWICH,AMSTERDAM,147040,146945,95,140162,121283,18879,4.90718
03/03/2019 11:05,2018,1,WESTERN EUROPE-EU,NETHERLANDS,2,NORWICH,DEN HELDER,38,38,0,0,0,0,0
03/03/2019 11:05,2018,1,WESTERN EUROPE-EU,NETHERLANDS,2,PRESTWICK,AMSTERDAM,96,0,96,25,0,25,284
03/03/2019 11:05,2018,1,WESTERN EUROPE-EU,NETHERLANDS,2,SOUTHAMPTON,AMSTERDAM,233700,233532,168,229184,229184,0,1.97047
03/03/2019 11:05,2018,1,WESTERN EUROPE-EU,NETHERLANDS,2,SOUTHAMPTON,ROTTERDAM,0,0,0,73,0,73,-100
03/03/2019 11:05,2018,1,WESTERN EUROPE-EU,PORTUGAL(EXCLUDING MADEIRA),1,GATWICK,AZORES LAJES TERCEIRA ISLAND,0,0,0,205,205,0,-100
03/03/2019 11:05,2018,1,WESTERN EUROPE-EU,PORTUGAL(EXCLUDING MADEIRA),1,GATWICK,AZORES PONTA DELGADA,4516,4516,0,5383,5382,1,-16.10626
03/03/2019 11:05,2018,1,WESTERN EUROPE-EU,PORTUGAL(EXCLUDING MADEIRA),1,GATWICK,FARO,700128,662809,37319,809771,773292,36479,-13.54
03/03/2019 11:05,2018,1,WESTERN EUROPE-EU,PORTUGAL(EXCLUDING MADEIRA),1,GATWICK,LISBON,349181,348545,636,417182,416293,889,-16.30008
03/03/2019 11:05,2018,1,WESTERN EUROPE-EU,PORTUGAL(EXCLUDING MADEIRA),1,GATWICK,OPORTO (PORTUGAL),364152,364152,0,339649,339322,327,7.21421
03/03/2019 11:05,2018,1,WESTERN EUROPE-EU,PORTUGAL(EXCLUDING MADEIRA),1,HEATHROW,FARO,32846,32846,0,20414,20414,0,60.89938
03/03/2019 11:05,2018,1,WESTERN EUROPE-EU,PORTUGAL(EXCLUDING MADEIRA),1,HEATHROW,LISBON,853048,853048,0,865043,865043,0,-1.38664
03/03/2019 11:05,2018,1,WESTERN EUROPE-EU,PORTUGAL(EXCLUDING MADEIRA),1,LONDON CITY,FARO,12186,12186,0,11017,10967,50,10.61087
03/03/2019 11:05,2018,1,WESTERN EUROPE-EU,PORTUGAL(EXCLUDING MADEIRA),1,LONDON CITY,LISBON,83211,83211,0,12731,12731,0,553.6093
03/03/2019 11:05,2018,1,WESTERN EUROPE-EU,PORTUGAL(EXCLUDING MADEIRA),1,LONDON CITY,OPORTO (PORTUGAL),30420,30420,0,0,0,0,0
03/03/2019 11:05,2018,1,WESTERN EUROPE-EU,PORTUGAL(EXCLUDING MADEIRA),1,LUTON,FARO,289729,272353,17376,323394,303201,20193,-10.4099
03/03/2019 11:05,2018,1,WESTERN EUROPE-EU,PORTUGAL(EXCLUDING MADEIRA),1,LUTON,LISBON,301094,300923,171,253450,253450,0,18.79819
03/03/2019 11:05,2018,1,WESTERN EUROPE-EU,PORTUGAL(EXCLUDING MADEIRA),1,LUTON,OPORTO (PORTUGAL),59302,58440,862,80744,80233,511,-26.55553
03/03/2019 11:05,2018,1,WESTERN EUROPE-EU,PORTUGAL(EXCLUDING MADEIRA),1,SOUTHEND,FARO,95963,95963,0,107905,107905,0,-11.06714
03/03/2019 11:05,2018,1,WESTERN EUROPE-EU,PORTUGAL(EXCLUDING MADEIRA),1,STANSTED,AZORES PONTA DELGADA,17521,17521,0,13397,13397,0,30.78301
03/03/2019 11:05,2018,1,WESTERN EUROPE-EU,PORTUGAL(EXCLUDING MADEIRA),1,STANSTED,FARO,365274,345085,20189,326420,306350,20070,11.90307
03/03/2019 11:05,2018,1,WESTERN EUROPE-EU,PORTUGAL(EXCLUDING MADEIRA),1,STANSTED,LISBON,365819,365514,305,353212,353212,0,3.56924
03/03/2019 11:05,2018,1,WESTERN EUROPE-EU,PORTUGAL(EXCLUDING MADEIRA),1,STANSTED,OPORTO (PORTUGAL),322504,322504,0,304720,304720,0,5.83618
03/03/2019 11:05,2018,1,WESTERN EUROPE-EU,PORTUGAL(EXCLUDING MADEIRA),2,ABERDEEN,FARO,22115,22115,0,22318,17160,5158,-0.90958
03/03/2019 11:05,2018,1,WESTERN EUROPE-EU,PORTUGAL(EXCLUDING MADEIRA),2,BELFAST CITY (GEORGE BEST),FARO,39674,39674,0,56236,56236,0,-29.45089
03/03/2019 11:05,2018,1,WESTERN EUROPE-EU,PORTUGAL(EXCLUDING MADEIRA),2,BELFAST INTERNATIONAL,FARO,186267,186267,0,164738,164738,0,13.06863
03/03/2019 11:05,2018,1,WESTERN EUROPE-EU,PORTUGAL(EXCLUDING MADEIRA),2,BIRMINGHAM,FARO,253213,225124,28089,306305,274643,31662,-17.33305
03/03/2019 11:05,2018,1,WESTERN EUROPE-EU,PORTUGAL(EXCLUDING MADEIRA),2,BIRMINGHAM,LISBON,355,355,0,47379,47320,59,-99.25072
03/03/2019 11:05,2018,1,WESTERN EUROPE-EU,PORTUGAL(EXCLUDING MADEIRA),2,BIRMINGHAM,OPORTO (PORTUGAL),21967,21967,0,37645,37645,0,-41.64697
03/03/2019 11:05,2018,1,WESTERN EUROPE-EU,PORTUGAL(EXCLUDING MADEIRA),2,BOURNEMOUTH,FARO,56589,56589,0,53928,53928,0,4.93436
03/03/2019 11:05,2018,1,WESTERN EUROPE-EU,PORTUGAL(EXCLUDING MADEIRA),2,BOURNEMOUTH,LISBON,94,0,94,0,0,0,0
03/03/2019 11:05,2018,1,WESTERN EUROPE-EU,PORTUGAL(EXCLUDING MADEIRA),2,BRISTOL,FARO,299906,292146,7760,304906,293964,10942,-1.63985
03/03/2019 11:05,2018,1,WESTERN EUROPE-EU,PORTUGAL(EXCLUDING MADEIRA),2,BRISTOL,LISBON,76538,76538,0,71589,71589,0,6.91307
03/03/2019 11:05,2018,1,WESTERN EUROPE-EU,PORTUGAL(EXCLUDING MADEIRA),2,BRISTOL,OPORTO (PORTUGAL),43120,43120,0,45260,45260,0,-4.72824
03/03/2019 11:05,2018,1,WESTERN EUROPE-EU,PORTUGAL(EXCLUDING MADEIRA),2,CARDIFF WALES,FARO,64036,56290,7746,57066,49121,7945,12.21393
03/03/2019 11:05,2018,1,WESTERN EUROPE-EU,PORTUGAL(EXCLUDING MADEIRA),2,CARDIFF WALES,LISBON,141,141,0,0,0,0,0
03/03/2019 11:05,2018,1,WESTERN EUROPE-EU,PORTUGAL(EXCLUDING MADEIRA),2,DONCASTER SHEFFIELD,FARO,31611,13249,18362,36508,17960,18548,-13.4135
03/03/2019 11:05,2018,1,WESTERN EUROPE-EU,PORTUGAL(EXCLUDING MADEIRA),2,EAST MIDLANDS INTERNATIONAL,FARO,244844,244844,0,247635,238764,8871,-1.12706
03/03/2019 11:05,2018,1,WESTERN EUROPE-EU,PORTUGAL(EXCLUDING MADEIRA),2,EDINBURGH,FARO,122750,122750,0,121256,121256,0,1.2321
03/03/2019 11:05,2018,1,WESTERN EUROPE-EU,PORTUGAL(EXCLUDING MADEIRA),2,EDINBURGH,LISBON,53497,53497,0,50194,50194,0,6.58047
03/03/2019 11:05,2018,1,WESTERN EUROPE-EU,PORTUGAL(EXCLUDING MADEIRA),2,EDINBURGH,OPORTO (PORTUGAL),35155,35155,0,26680,26680,0,31.76537
03/03/2019 11:05,2018,1,WESTERN EUROPE-EU,PORTUGAL(EXCLUDING MADEIRA),2,EXETER,FARO,23685,15269,8416,22856,14159,8697,3.62706
03/03/2019 11:05,2018,1,WESTERN EUROPE-EU,PORTUGAL(EXCLUDING MADEIRA),2,EXETER,LISBON,0,0,0,151,0,151,-100
03/03/2019 11:05,2018,1,WESTERN EUROPE-EU,PORTUGAL(EXCLUDING MADEIRA),2,GLASGOW,FARO,120864,117277,3587,124037,120303,3734,-2.55811
03/03/2019 11:05,2018,1,WESTERN EUROPE-EU,PORTUGAL(EXCLUDING MADEIRA),2,GLASGOW,LISBON,27359,27226,133,27153,27018,135,0.75866
03/03/2019 11:05,2018,1,WESTERN EUROPE-EU,PORTUGAL(EXCLUDING MADEIRA),2,HUMBERSIDE,FARO,0,0,0,188,0,188,-100
03/03/2019 11:05,2018,1,WESTERN EUROPE-EU,PORTUGAL(EXCLUDING MADEIRA),2,JERSEY,FARO,420,131,289,1017,756,261,-58.70206
03/03/2019 11:05,2018,1,WESTERN EUROPE-EU,PORTUGAL(EXCLUDING MADEIRA),2,JERSEY,OPORTO (PORTUGAL),0,0,0,268,268,0,-100
03/03/2019 11:05,2018,1,WESTERN EUROPE-EU,PORTUGAL(EXCLUDING MADEIRA),2,LEEDS BRADFORD,FARO,197124,197124,0,240026,232194,7832,-17.8739
03/03/2019 11:05,2018,1,WESTERN EUROPE-EU,PORTUGAL(EXCLUDING MADEIRA),2,LEEDS BRADFORD,OPORTO (PORTUGAL),0,0,0,133,133,0,-100
03/03/2019 11:05,2018,1,WESTERN EUROPE-EU,PORTUGAL(EXCLUDING MADEIRA),2,LIVERPOOL (JOHN LENNON),FARO,197740,197624,116,187288,187288,0,5.58071
03/03/2019 11:05,2018,1,WESTERN EUROPE-EU,PORTUGAL(EXCLUDING MADEIRA),2,LIVERPOOL (JOHN LENNON),LISBON,47185,47185,0,51669,51669,0,-8.67832
03/03/2019 11:05,2018,1,WESTERN EUROPE-EU,PORTUGAL(EXCLUDING MADEIRA),2,LIVERPOOL (JOHN LENNON),OPORTO (PORTUGAL),36742,35680,1062,34263,34263,0,7.23521
03/03/2019 11:05,2018,1,WESTERN EUROPE-EU,PORTUGAL(EXCLUDING MADEIRA),2,MANCHESTER,AZORES PONTA DELGADA,6434,6434,0,0,0,0,0
03/03/2019 11:05,2018,1,WESTERN EUROPE-EU,PORTUGAL(EXCLUDING MADEIRA),2,MANCHESTER,FARO,458246,427355,30891,500089,466190,33899,-8.36711
03/03/2019 11:05,2018,1,WESTERN EUROPE-EU,PORTUGAL(EXCLUDING MADEIRA),2,MANCHESTER,LISBON,247476,247052,424,242702,239823,2879,1.96702
03/03/2019 11:05,2018,1,WESTERN EUROPE-EU,PORTUGAL(EXCLUDING MADEIRA),2,MANCHESTER,OPORTO (PORTUGAL),78904,78067,837,68842,68709,133,14.61608
03/03/2019 11:05,2018,1,WESTERN EUROPE-EU,PORTUGAL(EXCLUDING MADEIRA),2,NEWCASTLE,FARO,172176,171983,193,172240,172052,188,-0.03716
03/03/2019 11:05,2018,1,WESTERN EUROPE-EU,PORTUGAL(EXCLUDING MADEIRA),2,NEWCASTLE,OPORTO (PORTUGAL),90,0,90,0,0,0,0
03/03/2019 11:05,2018,1,WESTERN EUROPE-EU,PORTUGAL(EXCLUDING MADEIRA),2,NEWQUAY,FARO,20868,20868,0,20698,20698,0,0.82134
03/03/2019 11:05,2018,1,WESTERN EUROPE-EU,PORTUGAL(EXCLUDING MADEIRA),2,PRESTWICK,FARO,59086,59086,0,64507,64507,0,-8.40374
03/03/2019 11:05,2018,1,WESTERN EUROPE-EU,PORTUGAL(EXCLUDING MADEIRA),2,SOUTHAMPTON,FARO,19364,19364,0,20851,20851,0,-7.13155
03/03/2019 11:05,2018,1,WESTERN EUROPE-EU,PORTUGAL(MADEIRA),1,GATWICK,FUNCHAL,264426,234240,30186,301453,263867,37586,-12.28284
03/03/2019 11:05,2018,1,WESTERN EUROPE-EU,PORTUGAL(MADEIRA),1,GATWICK,PORTO SANTO,9090,76,9014,9366,346,9020,-2.94683
03/03/2019 11:05,2018,1,WESTERN EUROPE-EU,PORTUGAL(MADEIRA),1,LUTON,FUNCHAL,8831,0,8831,8983,0,8983,-1.69209
03/03/2019 11:05,2018,1,WESTERN EUROPE-EU,PORTUGAL(MADEIRA),1,STANSTED,FUNCHAL,43450,43450,0,24949,24949,0,74.15528
03/03/2019 11:05,2018,1,WESTERN EUROPE-EU,PORTUGAL(MADEIRA),2,BELFAST INTERNATIONAL,FUNCHAL,10197,10197,0,0,0,0,0
03/03/2019 11:05,2018,1,WESTERN EUROPE-EU,PORTUGAL(MADEIRA),2,BIRMINGHAM,FUNCHAL,35510,19569,15941,48178,28735,19443,-26.29416
03/03/2019 11:05,2018,1,WESTERN EUROPE-EU,PORTUGAL(MADEIRA),2,BIRMINGHAM,PORTO SANTO,7106,0,7106,7364,0,7364,-3.50353
03/03/2019 11:05,2018,1,WESTERN EUROPE-EU,PORTUGAL(MADEIRA),2,BOURNEMOUTH,FUNCHAL,314,172,142,0,0,0,0
03/03/2019 11:05,2018,1,WESTERN EUROPE-EU,PORTUGAL(MADEIRA),2,BRISTOL,FUNCHAL,39613,39613,0,40810,40810,0,-2.9331
03/03/2019 11:05,2018,1,WESTERN EUROPE-EU,PORTUGAL(MADEIRA),2,BRISTOL,PORTO SANTO,0,0,0,145,145,0,-100
03/03/2019 11:05,2018,1,WESTERN EUROPE-EU,PORTUGAL(MADEIRA),2,CARDIFF WALES,FUNCHAL,183,183,0,0,0,0,0
03/03/2019 11:05,2018,1,WESTERN EUROPE-EU,PORTUGAL(MADEIRA),2,EAST MIDLANDS INTERNATIONAL,FUNCHAL,33887,17172,16715,32371,17033,15338,4.6832
03/03/2019 11:05,2018,1,WESTERN EUROPE-EU,PORTUGAL(MADEIRA),2,EDINBURGH,FUNCHAL,18152,18152,0,29990,29990,0,-39.47316
03/03/2019 11:05,2018,1,WESTERN EUROPE-EU,PORTUGAL(MADEIRA),2,EDINBURGH,PORTO SANTO,0,0,0,150,150,0,-100
03/03/2019 11:05,2018,1,WESTERN EUROPE-EU,PORTUGAL(MADEIRA),2,EXETER,FUNCHAL,70,0,70,0,0,0,0
03/03/2019 11:05,2018,1,WESTERN EUROPE-EU,PORTUGAL(MADEIRA),2,GLASGOW,FUNCHAL,17832,17832,0,22312,17024,5288,-20.07888
03/03/2019 11:05,2018,1,WESTERN EUROPE-EU,PORTUGAL(MADEIRA),2,HUMBERSIDE,FUNCHAL,226,0,226,0,0,0,0
03/03/2019 11:05,2018,1,WESTERN EUROPE-EU,PORTUGAL(MADEIRA),2,ISLE OF MAN,FUNCHAL,221,0,221,0,0,0,0
03/03/2019 11:05,2018,1,WESTERN EUROPE-EU,PORTUGAL(MADEIRA),2,JERSEY,FUNCHAL,6857,2573,4284,10943,10943,0,-37.33894
03/03/2019 11:05,2018,1,WESTERN EUROPE-EU,PORTUGAL(MADEIRA),2,JERSEY,PORTO SANTO,0,0,0,14,14,0,-100
03/03/2019 11:05,2018,1,WESTERN EUROPE-EU,PORTUGAL(MADEIRA),2,LEEDS BRADFORD,FUNCHAL,18541,18541,0,20287,20287,0,-8.6065
03/03/2019 11:05,2018,1,WESTERN EUROPE-EU,PORTUGAL(MADEIRA),2,MANCHESTER,FUNCHAL,124205,96002,28203,128992,94076,34916,-3.71108
03/03/2019 11:05,2018,1,WESTERN EUROPE-EU,PORTUGAL(MADEIRA),2,MANCHESTER,PORTO SANTO,8588,0,8588,9127,0,9127,-5.90555
03/03/2019 11:05,2018,1,WESTERN EUROPE-EU,PORTUGAL(MADEIRA),2,NEWCASTLE,FUNCHAL,16733,16733,0,15929,15929,0,5.0474
03/03/2019 11:05,2018,1,WESTERN EUROPE-EU,PORTUGAL(MADEIRA),2,NORWICH,FUNCHAL,254,0,254,0,0,0,0
03/03/2019 11:05,2018,1,WESTERN EUROPE-EU,SLOVENIA,1,GATWICK,LJUBLJANA,63032,63032,0,62589,62521,68,0.70779
03/03/2019 11:05,2018,1,WESTERN EUROPE-EU,SLOVENIA,1,LUTON,LJUBLJANA,66047,66047,0,64321,64056,265,2.68342
03/03/2019 11:05,2018,1,WESTERN EUROPE-EU,SLOVENIA,1,STANSTED,LJUBLJANA,118043,118043,0,112911,112911,0,4.54517
03/03/2019 11:05,2018,1,WESTERN EUROPE-EU,SLOVENIA,2,BELFAST INTERNATIONAL,LJUBLJANA,93,0,93,0,0,0,0
03/03/2019 11:05,2018,1,WESTERN EUROPE-EU,SLOVENIA,2,BIRMINGHAM,LJUBLJANA,0,0,0,26,0,26,-100
03/03/2019 11:05,2018,1,WESTERN EUROPE-EU,SLOVENIA,2,GLASGOW,LJUBLJANA,0,0,0,881,0,881,-100
03/03/2019 11:05,2018,1,WESTERN EUROPE-EU,SLOVENIA,2,GLASGOW,MARIBOR,582,0,582,0,0,0,0
03/03/2019 11:05,2018,1,WESTERN EUROPE-EU,SLOVENIA,2,LIVERPOOL (JOHN LENNON),MARIBOR,0,0,0,909,0,909,-100
03/03/2019 11:05,2018,1,WESTERN EUROPE-EU,SLOVENIA,2,MANCHESTER,LJUBLJANA,2651,2255,396,5625,5625,0,-52.87111
03/03/2019 11:05,2018,1,WESTERN EUROPE-EU,SLOVENIA,2,PRESTWICK,LJUBLJANA,0,0,0,176,0,176,-100
03/03/2019 11:05,2018,1,WESTERN EUROPE-EU,SPAIN,1,GATWICK,ALICANTE,802860,751284,51576,884249,839813,44436,-9.20431
03/03/2019 11:05,2018,1,WESTERN EUROPE-EU,SPAIN,1,GATWICK,ALMERIA,123432,114582,8850,158486,149162,9324,-22.11804
03/03/2019 11:05,2018,1,WESTERN EUROPE-EU,SPAIN,1,GATWICK,ASTURIAS,34402,34402,0,38769,38769,0,-11.26415
03/03/2019 11:05,2018,1,WESTERN EUROPE-EU,SPAIN,1,GATWICK,BARCELONA,1555323,1553603,1720,1458522,1458005,517,6.63692
03/03/2019 11:05,2018,1,WESTERN EUROPE-EU,SPAIN,1,GATWICK,BILBAO,108931,108795,136,107913,107196,717,0.94335
03/03/2019 11:05,2018,1,WESTERN EUROPE-EU,SPAIN,1,GATWICK,GIRONA,14722,0,14722,15870,204,15666,-7.23377
03/03/2019 11:05,2018,1,WESTERN EUROPE-EU,SPAIN,1,GATWICK,GRANADA,45748,45748,0,43297,43297,0,5.6609
03/03/2019 11:05,2018,1,WESTERN EUROPE-EU,SPAIN,1,GATWICK,IBIZA,287019,222201,64818,331515,259516,71999,-13.42202
03/03/2019 11:05,2018,1,WESTERN EUROPE-EU,SPAIN,1,GATWICK,JEREZ,9055,0,9055,9161,0,9161,-1.15708
03/03/2019 11:05,2018,1,WESTERN EUROPE-EU,SPAIN,1,GATWICK,LIEIDA,7267,6056,1211,9271,607,8664,-21.61579
03/03/2019 11:05,2018,1,WESTERN EUROPE-EU,SPAIN,1,GATWICK,MADRID,1026627,1026606,21,1021320,1020121,1199,0.51962
03/03/2019 11:05,2018,1,WESTERN EUROPE-EU,SPAIN,1,GATWICK,MAHON,248486,177660,70826,278700,196874,81826,-10.84105
03/03/2019 11:05,2018,1,WESTERN EUROPE-EU,SPAIN,1,GATWICK,MALAGA,1089976,1023731,66245,1155520,1084436,71084,-5.67225
03/03/2019 11:05,2018,1,WESTERN EUROPE-EU,SPAIN,1,GATWICK,MURCIA SAN JAVIER,177396,177396,0,170365,170365,0,4.12702
03/03/2019 11:05,2018,1,WESTERN EUROPE-EU,SPAIN,1,GATWICK,PALMA DE MALLORCA,782401,644042,138359,856367,711847,144520,-8.63718
03/03/2019 11:05,2018,1,WESTERN EUROPE-EU,SPAIN,1,GATWICK,REUS,44849,17251,27598,42743,14237,28506,4.92712
03/03/2019 11:05,2018,1,WESTERN EUROPE-EU,SPAIN,1,GATWICK,SANTIAGO DE COMPOSTELA (SPAIN),34105,34105,0,67395,67395,0,-49.39536
03/03/2019 11:05,2018,1,WESTERN EUROPE-EU,SPAIN,1,GATWICK,SEVILLE,202384,202384,0,190855,190499,356,6.04071
03/03/2019 11:05,2018,1,WESTERN EUROPE-EU,SPAIN,1,GATWICK,VALENCIA,359889,359889,0,345733,345733,0,4.09449
03/03/2019 11:05,2018,1,WESTERN EUROPE-EU,SPAIN,1,GATWICK,VALLADOLID,0,0,0,286,0,286,-100
03/03/2019 11:05,2018,1,WESTERN EUROPE-EU,SPAIN,1,GATWICK,VIGO,47,0,47,0,0,0,0
03/03/2019 11:05,2018,1,WESTERN EUROPE-EU,SPAIN,1,GATWICK,VITORIA,0,0,0,507,139,368,-100
03/03/2019 11:05,2018,1,WESTERN EUROPE-EU,SPAIN,1,GATWICK,ZARAGOZA,94,0,94,0,0,0,0
03/03/2019 11:05,2018,1,WESTERN EUROPE-EU,SPAIN,1,HEATHROW,A CORUNA,113013,113013,0,101171,101171,0,11.70494
03/03/2019 11:05,2018,1,WESTERN EUROPE-EU,SPAIN,1,HEATHROW,ALMERIA,17759,17759,0,0,0,0,0
03/03/2019 11:05,2018,1,WESTERN EUROPE-EU,SPAIN,1,HEATHROW,ASTURIAS,18602,18602,0,35827,35827,0,-48.07826
03/03/2019 11:05,2018,1,WESTERN EUROPE-EU,SPAIN,1,HEATHROW,BARCELONA,764204,764204,0,683777,682969,808,11.76217
03/03/2019 11:05,2018,1,WESTERN EUROPE-EU,SPAIN,1,HEATHROW,BILBAO,167530,167530,0,171670,171670,0,-2.4116
03/03/2019 11:05,2018,1,WESTERN EUROPE-EU,SPAIN,1,HEATHROW,IBIZA,46815,46815,0,30688,30688,0,52.55149
03/03/2019 11:05,2018,1,WESTERN EUROPE-EU,SPAIN,1,HEATHROW,JEREZ,104,104,0,0,0,0,0
03/03/2019 11:05,2018,1,WESTERN EUROPE-EU,SPAIN,1,HEATHROW,MADRID,1417554,1417554,0,1382478,1382478,0,2.53718
03/03/2019 11:05,2018,1,WESTERN EUROPE-EU,SPAIN,1,HEATHROW,MAHON,12561,12561,0,22342,22342,0,-43.77853
03/03/2019 11:05,2018,1,WESTERN EUROPE-EU,SPAIN,1,HEATHROW,MALAGA,106567,106567,0,32875,32875,0,224.15817
03/03/2019 11:05,2018,1,WESTERN EUROPE-EU,SPAIN,1,HEATHROW,MURCIA SAN JAVIER,17334,17334,0,16810,16810,0,3.11719
03/03/2019 11:05,2018,1,WESTERN EUROPE-EU,SPAIN,1,HEATHROW,PALMA DE MALLORCA,127862,127862,0,82504,82504,0,54.97673
03/03/2019 11:05,2018,1,WESTERN EUROPE-EU,SPAIN,1,LONDON CITY,GRANADA,14641,14641,0,16696,16696,0,-12.30834
03/03/2019 11:05,2018,1,WESTERN EUROPE-EU,SPAIN,1,LONDON CITY,IBIZA,87787,87691,96,91146,91146,0,-3.6853
03/03/2019 11:05,2018,1,WESTERN EUROPE-EU,SPAIN,1,LONDON CITY,MADRID,99,99,0,4675,4675,0,-97.88235
03/03/2019 11:05,2018,1,WESTERN EUROPE-EU,SPAIN,1,LONDON CITY,MAHON,2854,2854,0,2602,2602,0,9.68486
03/03/2019 11:05,2018,1,WESTERN EUROPE-EU,SPAIN,1,LONDON CITY,MALAGA,62870,62870,0,67857,67857,0,-7.34928
03/03/2019 11:05,2018,1,WESTERN EUROPE-EU,SPAIN,1,LONDON CITY,PALMA DE MALLORCA,44903,44903,0,46528,46528,0,-3.49252
03/03/2019 11:05,2018,1,WESTERN EUROPE-EU,SPAIN,1,LUTON,ALICANTE,211781,211344,437,264625,263825,800,-19.96939
03/03/2019 11:05,2018,1,WESTERN EUROPE-EU,SPAIN,1,LUTON,ALMERIA,123,0,123,62,0,62,98.3871
03/03/2019 11:05,2018,1,WESTERN EUROPE-EU,SPAIN,1,LUTON,BARCELONA,403426,403271,155,506522,506518,4,-20.35371
03/03/2019 11:05,2018,1,WESTERN EUROPE-EU,SPAIN,1,LUTON,BILBAO,0,0,0,51,51,0,-100
03/03/2019 11:05,2018,1,WESTERN EUROPE-EU,SPAIN,1,LUTON,GIRONA,30002,30002,0,34086,33932,154,-11.98146
03/03/2019 11:05,2018,1,WESTERN EUROPE-EU,SPAIN,1,LUTON,IBIZA,94316,73422,20894,81045,56133,24912,16.37485
03/03/2019 11:05,2018,1,WESTERN EUROPE-EU,SPAIN,1,LUTON,MADRID,132794,132253,541,144644,144345,299,-8.19253
03/03/2019 11:05,2018,1,WESTERN EUROPE-EU,SPAIN,1,LUTON,MAHON,60100,45490,14610,92241,73146,19095,-34.84459
03/03/2019 11:05,2018,1,WESTERN EUROPE-EU,SPAIN,1,LUTON,MALAGA,303037,283091,19946,332077,308610,23467,-8.74496
03/03/2019 11:05,2018,1,WESTERN EUROPE-EU,SPAIN,1,LUTON,MURCIA SAN JAVIER,95447,95447,0,96715,96715,0,-1.31107
03/03/2019 11:05,2018,1,WESTERN EUROPE-EU,SPAIN,1,LUTON,PALMA DE MALLORCA,239991,199709,40282,291890,234196,57694,-17.78033
03/03/2019 11:05,2018,1,WESTERN EUROPE-EU,SPAIN,1,LUTON,REUS,25850,16273,9577,9576,0,9576,169.9457
03/03/2019 11:05,2018,1,WESTERN EUROPE-EU,SPAIN,1,LUTON,SAN SEBASTIAN,0,0,0,1063,1063,0,-100
03/03/2019 11:05,2018,1,WESTERN EUROPE-EU,SPAIN,1,LUTON,SEVILLE,50381,50381,0,7217,7106,111,598.08785
03/03/2019 11:05,2018,1,WESTERN EUROPE-EU,SPAIN,1,LUTON,VALENCIA,45698,45698,0,39549,39549,0,15.5478
03/03/2019 11:05,2018,1,WESTERN EUROPE-EU,SPAIN,1,LUTON,VIGO,2442,2442,0,3210,3210,0,-23.92523
03/03/2019 11:05,2018,1,WESTERN EUROPE-EU,SPAIN,1,SOUTHEND,ALICANTE,109963,109963,0,116142,116142,0,-5.32021
03/03/2019 11:05,2018,1,WESTERN EUROPE-EU,SPAIN,1,SOUTHEND,BARCELONA,45974,45974,0,42448,42448,0,8.30663
03/03/2019 11:05,2018,1,WESTERN EUROPE-EU,SPAIN,1,SOUTHEND,GIRONA,4,4,0,0,0,0,0
03/03/2019 11:05,2018,1,WESTERN EUROPE-EU,SPAIN,1,SOUTHEND,IBIZA,21004,21004,0,20415,20415,0,2.88513
03/03/2019 11:05,2018,1,WESTERN EUROPE-EU,SPAIN,1,SOUTHEND,MAHON,16529,16529,0,13578,13578,0,21.73369
03/03/2019 11:05,2018,1,WESTERN EUROPE-EU,SPAIN,1,SOUTHEND,MALAGA,95413,95413,0,86149,86149,0,10.75346
03/03/2019 11:05,2018,1,WESTERN EUROPE-EU,SPAIN,1,SOUTHEND,MURCIA SAN JAVIER,22255,22255,0,15031,15031,0,48.06067
03/03/2019 11:05,2018,1,WESTERN EUROPE-EU,SPAIN,1,SOUTHEND,PALMA DE MALLORCA,66485,66485,0,89692,89692,0,-25.8741
03/03/2019 11:05,2018,1,WESTERN EUROPE-EU,SPAIN,1,SOUTHEND,REUS,0,0,0,8477,8477,0,-100
03/03/2019 11:05,2018,1,WESTERN EUROPE-EU,SPAIN,1,STANSTED,ALICANTE,412693,412693,0,320486,320486,0,28.77099
03/03/2019 11:05,2018,1,WESTERN EUROPE-EU,SPAIN,1,STANSTED,ALMERIA,38504,38504,0,25867,25867,0,48.85375
03/03/2019 11:05,2018,1,WESTERN EUROPE-EU,SPAIN,1,STANSTED,ASTURIAS,46688,46688,0,76035,76035,0,-38.5967
03/03/2019 11:05,2018,1,WESTERN EUROPE-EU,SPAIN,1,STANSTED,BARCELONA,480917,479439,1478,464280,464111,169,3.5834
03/03/2019 11:05,2018,1,WESTERN EUROPE-EU,SPAIN,1,STANSTED,BILBAO,126710,125461,1249,127186,127060,126,-0.37426
03/03/2019 11:05,2018,1,WESTERN EUROPE-EU,SPAIN,1,STANSTED,CASTELLON COSTA AZAHAR,35082,35082,0,34037,34037,0,3.07019
03/03/2019 11:05,2018,1,WESTERN EUROPE-EU,SPAIN,1,STANSTED,CASTELLON DE LA PLANA AIRPORT,14783,14783,0,14723,14723,0,0.40753
03/03/2019 11:05,2018,1,WESTERN EUROPE-EU,SPAIN,1,STANSTED,GIRONA,81411,81347,64,71010,70843,167,14.64723
03/03/2019 11:05,2018,1,WESTERN EUROPE-EU,SPAIN,1,STANSTED,GRANADA,0,0,0,97,97,0,-100
03/03/2019 11:05,2018,1,WESTERN EUROPE-EU,SPAIN,1,STANSTED,IBIZA,282312,265770,16542,301243,275401,25842,-6.2843
03/03/2019 11:05,2018,1,WESTERN EUROPE-EU,SPAIN,1,STANSTED,JEREZ,57649,57649,0,59019,59019,0,-2.32129
03/03/2019 11:05,2018,1,WESTERN EUROPE-EU,SPAIN,1,STANSTED,LEON,341,0,341,0,0,0,0
03/03/2019 11:05,2018,1,WESTERN EUROPE-EU,SPAIN,1,STANSTED,LIEIDA,3115,0,3115,367,0,367,748.77384
03/03/2019 11:05,2018,1,WESTERN EUROPE-EU,SPAIN,1,STANSTED,MADRID,470157,470157,0,475209,474277,932,-1.06311
03/03/2019 11:05,2018,1,WESTERN EUROPE-EU,SPAIN,1,STANSTED,MAHON,82877,64690,18187,68811,51785,17026,20.4415
03/03/2019 11:05,2018,1,WESTERN EUROPE-EU,SPAIN,1,STANSTED,MALAGA,541450,541450,0,466283,466283,0,16.12047
03/03/2019 11:05,2018,1,WESTERN EUROPE-EU,SPAIN,1,STANSTED,MURCIA SAN JAVIER,130582,130582,0,131327,131327,0,-0.56729
03/03/2019 11:05,2018,1,WESTERN EUROPE-EU,SPAIN,1,STANSTED,PALMA DE MALLORCA,479582,460795,18787,448781,419939,28842,6.86326
03/03/2019 11:05,2018,1,WESTERN EUROPE-EU,SPAIN,1,STANSTED,REUS,83613,83448,165,83509,82669,840,0.12454
03/03/2019 11:05,2018,1,WESTERN EUROPE-EU,SPAIN,1,STANSTED,SALAMANCA,315,0,315,0,0,0,0
03/03/2019 11:05,2018,1,WESTERN EUROPE-EU,SPAIN,1,STANSTED,SANTANDER,81988,81988,0,80607,80607,0,1.71325
03/03/2019 11:05,2018,1,WESTERN EUROPE-EU,SPAIN,1,STANSTED,SANTIAGO DE COMPOSTELA (SPAIN),76599,76599,0,77121,77121,0,-0.67686
03/03/2019 11:05,2018,1,WESTERN EUROPE-EU,SPAIN,1,STANSTED,SEVILLE,142478,142292,186,144825,144672,153,-1.62058
03/03/2019 11:05,2018,1,WESTERN EUROPE-EU,SPAIN,1,STANSTED,VALENCIA,134314,134314,0,130358,130186,172,3.03472
03/03/2019 11:05,2018,1,WESTERN EUROPE-EU,SPAIN,1,STANSTED,VALLADOLID,175,0,175,0,0,0,0
03/03/2019 11:05,2018,1,WESTERN EUROPE-EU,SPAIN,1,STANSTED,ZARAGOZA,88202,88202,0,87056,87056,0,1.31639
03/03/2019 11:05,2018,1,WESTERN EUROPE-EU,SPAIN,2,ABERDEEN,ALICANTE,35536,35536,0,31832,31832,0,11.63609
03/03/2019 11:05,2018,1,WESTERN EUROPE-EU,SPAIN,2,ABERDEEN,BARCELONA,0,0,0,55,55,0,-100
03/03/2019 11:05,2018,1,WESTERN EUROPE-EU,SPAIN,2,ABERDEEN,IBIZA,8309,0,8309,5542,0,5542,49.92782
03/03/2019 11:05,2018,1,WESTERN EUROPE-EU,SPAIN,2,ABERDEEN,MALAGA,29247,29247,0,31484,31484,0,-7.1052
03/03/2019 11:05,2018,1,WESTERN EUROPE-EU,SPAIN,2,ABERDEEN,PALMA DE MALLORCA,23886,0,23886,23767,0,23767,0.50069
03/03/2019 11:05,2018,1,WESTERN EUROPE-EU,SPAIN,2,ABERDEEN,REUS,9203,0,9203,0,0,0,0
03/03/2019 11:05,2018,1,WESTERN EUROPE-EU,SPAIN,2,BELFAST CITY (GEORGE BEST),ALICANTE,0,0,0,13982,13982,0,-100
03/03/2019 11:05,2018,1,WESTERN EUROPE-EU,SPAIN,2,BELFAST CITY (GEORGE BEST),MALAGA,41041,40979,62,57175,57175,0,-28.21863
03/03/2019 11:05,2018,1,WESTERN EUROPE-EU,SPAIN,2,BELFAST CITY (GEORGE BEST),PALMA DE MALLORCA,0,0,0,17877,17877,0,-100
03/03/2019 11:05,2018,1,WESTERN EUROPE-EU,SPAIN,2,BELFAST INTERNATIONAL,ALICANTE,243475,243475,0,227397,227397,0,7.07045
03/03/2019 11:05,2018,1,WESTERN EUROPE-EU,SPAIN,2,BELFAST INTERNATIONAL,ALMERIA,9963,9963,0,0,0,0,0
03/03/2019 11:05,2018,1,WESTERN EUROPE-EU,SPAIN,2,BELFAST INTERNATIONAL,BARCELONA,48012,48012,0,55269,52203,3066,-13.13033
03/03/2019 11:05,2018,1,WESTERN EUROPE-EU,SPAIN,2,BELFAST INTERNATIONAL,GIRONA,29909,29909,0,28740,28740,0,4.0675
03/03/2019 11:05,2018,1,WESTERN EUROPE-EU,SPAIN,2,BELFAST INTERNATIONAL,IBIZA,42141,35250,6891,45362,29259,16103,-7.10066
03/03/2019 11:05,2018,1,WESTERN EUROPE-EU,SPAIN,2,BELFAST INTERNATIONAL,MAHON,17142,10833,6309,17725,11003,6722,-3.28914
03/03/2019 11:05,2018,1,WESTERN EUROPE-EU,SPAIN,2,BELFAST INTERNATIONAL,MALAGA,219439,212200,7239,209583,202158,7425,4.70267
03/03/2019 11:05,2018,1,WESTERN EUROPE-EU,SPAIN,2,BELFAST INTERNATIONAL,PALMA DE MALLORCA,195911,153916,41995,183383,140661,42722,6.8316
03/03/2019 11:05,2018,1,WESTERN EUROPE-EU,SPAIN,2,BELFAST INTERNATIONAL,REUS,62647,22996,39651,61870,22935,38935,1.25586
03/03/2019 11:05,2018,1,WESTERN EUROPE-EU,SPAIN,2,BELFAST INTERNATIONAL,SEVILLE,73,0,73,448,0,448,-83.70536
03/03/2019 11:05,2018,1,WESTERN EUROPE-EU,SPAIN,2,BELFAST INTERNATIONAL,VALENCIA,12077,12077,0,0,0,0,0
03/03/2019 11:05,2018,1,WESTERN EUROPE-EU,SPAIN,2,BIRMINGHAM,A CORUNA,0,0,0,72,0,72,-100
03/03/2019 11:05,2018,1,WESTERN EUROPE-EU,SPAIN,2,BIRMINGHAM,ALICANTE,357780,323082,34698,430601,395260,35341,-16.91148
03/03/2019 11:05,2018,1,WESTERN EUROPE-EU,SPAIN,2,BIRMINGHAM,ALMERIA,34832,34832,0,17106,17106,0,103.62446
03/03/2019 11:05,2018,1,WESTERN EUROPE-EU,SPAIN,2,BIRMINGHAM,BARCELONA,218425,218425,0,293629,293300,329,-25.61191
03/03/2019 11:05,2018,1,WESTERN EUROPE-EU,SPAIN,2,BIRMINGHAM,BILBAO,0,0,0,370,0,370,-100
03/03/2019 11:05,2018,1,WESTERN EUROPE-EU,SPAIN,2,BIRMINGHAM,GIRONA,75176,61787,13389,62623,49074,13549,20.04535
03/03/2019 11:05,2018,1,WESTERN EUROPE-EU,SPAIN,2,BIRMINGHAM,IBIZA,141764,91706,50058,149996,107340,42656,-5.48815
03/03/2019 11:05,2018,1,WESTERN EUROPE-EU,SPAIN,2,BIRMINGHAM,LIEIDA,87,0,87,1379,0,1379,-93.69108
03/03/2019 11:05,2018,1,WESTERN EUROPE-EU,SPAIN,2,BIRMINGHAM,MADRID,124071,124071,0,142299,140161,2138,-12.80965
03/03/2019 11:05,2018,1,WESTERN EUROPE-EU,SPAIN,2,BIRMINGHAM,MAHON,88627,49777,38850,87597,57576,30021,1.17584
03/03/2019 11:05,2018,1,WESTERN EUROPE-EU,SPAIN,2,BIRMINGHAM,MALAGA,367867,309624,58243,467074,411015,56059,-21.2401
03/03/2019 11:05,2018,1,WESTERN EUROPE-EU,SPAIN,2,BIRMINGHAM,MURCIA SAN JAVIER,58642,58642,0,56667,56667,0,3.48527
03/03/2019 11:05,2018,1,WESTERN EUROPE-EU,SPAIN,2,BIRMINGHAM,PALMA DE MALLORCA,383348,292266,91082,404680,295989,108691,-5.27133
03/03/2019 11:05,2018,1,WESTERN EUROPE-EU,SPAIN,2,BIRMINGHAM,REUS,62031,43908,18123,60585,41691,18894,2.38673
03/03/2019 11:05,2018,1,WESTERN EUROPE-EU,SPAIN,2,BIRMINGHAM,SANTANDER,185,185,0,64,64,0,189.0625
03/03/2019 11:05,2018,1,WESTERN EUROPE-EU,SPAIN,2,BIRMINGHAM,SEVILLE,268,268,0,182,182,0,47.25275
03/03/2019 11:05,2018,1,WESTERN EUROPE-EU,SPAIN,2,BIRMINGHAM,VALENCIA,45,0,45,9886,9748,138,-99.54481
03/03/2019 11:05,2018,1,WESTERN EUROPE-EU,SPAIN,2,BOURNEMOUTH,ALICANTE,61093,61093,0,53697,53607,90,13.77358
03/03/2019 11:05,2018,1,WESTERN EUROPE-EU,SPAIN,2,BOURNEMOUTH,BARCELONA,0,0,0,133,133,0,-100
03/03/2019 11:05,2018,1,WESTERN EUROPE-EU,SPAIN,2,BOURNEMOUTH,GIRONA,41641,41641,0,36094,36094,0,15.36821
03/03/2019 11:05,2018,1,WESTERN EUROPE-EU,SPAIN,2,BOURNEMOUTH,IBIZA,9116,189,8927,8971,0,8971,1.61632
03/03/2019 11:05,2018,1,WESTERN EUROPE-EU,SPAIN,2,BOURNEMOUTH,MADRID,0,0,0,242,154,88,-100
03/03/2019 11:05,2018,1,WESTERN EUROPE-EU,SPAIN,2,BOURNEMOUTH,MAHON,9177,0,9177,9466,0,9466,-3.05303
03/03/2019 11:05,2018,1,WESTERN EUROPE-EU,SPAIN,2,BOURNEMOUTH,MALAGA,78862,78862,0,73594,73495,99,7.15819
03/03/2019 11:05,2018,1,WESTERN EUROPE-EU,SPAIN,2,BOURNEMOUTH,MURCIA SAN JAVIER,41517,41517,0,36959,36959,0,12.33258
03/03/2019 11:05,2018,1,WESTERN EUROPE-EU,SPAIN,2,BOURNEMOUTH,PALMA DE MALLORCA,103608,66432,37176,95093,56836,38257,8.95439
03/03/2019 11:05,2018,1,WESTERN EUROPE-EU,SPAIN,2,BOURNEMOUTH,SANTIAGO DE COMPOSTELA (SPAIN),43,0,43,0,0,0,0
03/03/2019 11:05,2018,1,WESTERN EUROPE-EU,SPAIN,2,BOURNEMOUTH,SEVILLE,156,0,156,52,0,52,200
03/03/2019 11:05,2018,1,WESTERN EUROPE-EU,SPAIN,2,BOURNEMOUTH,VALENCIA,0,0,0,95,0,95,-100
03/03/2019 11:05,2018,1,WESTERN EUROPE-EU,SPAIN,2,BRISTOL,ALICANTE,340061,327269,12792,331043,317210,13833,2.72412
03/03/2019 11:05,2018,1,WESTERN EUROPE-EU,SPAIN,2,BRISTOL,ALMERIA,8162,8162,0,7696,7696,0,6.05509
03/03/2019 11:05,2018,1,WESTERN EUROPE-EU,SPAIN,2,BRISTOL,BARCELONA,201233,201233,0,190312,190072,240,5.73847
03/03/2019 11:05,2018,1,WESTERN EUROPE-EU,SPAIN,2,BRISTOL,BILBAO,35828,35828,0,28475,28475,0,25.82265
03/03/2019 11:05,2018,1,WESTERN EUROPE-EU,SPAIN,2,BRISTOL,CASTELLON DE LA PLANA AIRPORT,0,0,0,19175,19175,0,-100
03/03/2019 11:05,2018,1,WESTERN EUROPE-EU,SPAIN,2,BRISTOL,GIRONA,64459,59221,5238,59883,53282,6601,7.64157
03/03/2019 11:05,2018,1,WESTERN EUROPE-EU,SPAIN,2,BRISTOL,IBIZA,90905,66423,24482,100338,64145,36193,-9.40122
03/03/2019 11:05,2018,1,WESTERN EUROPE-EU,SPAIN,2,BRISTOL,LIEIDA,88,0,88,0,0,0,0
03/03/2019 11:05,2018,1,WESTERN EUROPE-EU,SPAIN,2,BRISTOL,MADRID,105874,105874,0,115513,105747,9766,-8.34452
03/03/2019 11:05,2018,1,WESTERN EUROPE-EU,SPAIN,2,BRISTOL,MAHON,63439,48359,15080,72871,53507,19364,-12.94342
03/03/2019 11:05,2018,1,WESTERN EUROPE-EU,SPAIN,2,BRISTOL,MALAGA,353430,328469,24961,347703,318179,29524,1.6471
03/03/2019 11:05,2018,1,WESTERN EUROPE-EU,SPAIN,2,BRISTOL,MURCIA SAN JAVIER,88795,88795,0,80465,80465,0,10.35233
03/03/2019 11:05,2018,1,WESTERN EUROPE-EU,SPAIN,2,BRISTOL,PALMA DE MALLORCA,348325,308536,39789,341400,294558,46842,2.02841
03/03/2019 11:05,2018,1,WESTERN EUROPE-EU,SPAIN,2,BRISTOL,REUS,10258,2770,7488,20792,11443,9349,-50.66372
03/03/2019 11:05,2018,1,WESTERN EUROPE-EU,SPAIN,2,BRISTOL,SANTIAGO DE COMPOSTELA (SPAIN),0,0,0,146,146,0,-100
03/03/2019 11:05,2018,1,WESTERN EUROPE-EU,SPAIN,2,BRISTOL,SEVILLE,27095,27095,0,0,0,0,0
03/03/2019 11:05,2018,1,WESTERN EUROPE-EU,SPAIN,2,BRISTOL,VALENCIA,26989,26989,0,6,6,0,449716.66667
03/03/2019 11:05,2018,1,WESTERN EUROPE-EU,SPAIN,2,CAMBRIDGE,MADRID,0,0,0,200,200,0,-100
03/03/2019 11:05,2018,1,WESTERN EUROPE-EU,SPAIN,2,CARDIFF WALES,ALICANTE,104211,66323,37888,105458,67735,37723,-1.18246
03/03/2019 11:05,2018,1,WESTERN EUROPE-EU,SPAIN,2,CARDIFF WALES,BARCELONA,24385,24361,24,25664,25546,118,-4.98363
03/03/2019 11:05,2018,1,WESTERN EUROPE-EU,SPAIN,2,CARDIFF WALES,BILBAO,347,0,347,0,0,0,0
03/03/2019 11:05,2018,1,WESTERN EUROPE-EU,SPAIN,2,CARDIFF WALES,GIRONA,0,0,0,211,0,211,-100
03/03/2019 11:05,2018,1,WESTERN EUROPE-EU,SPAIN,2,CARDIFF WALES,IBIZA,32568,0,32568,32534,0,32534,0.10451
03/03/2019 11:05,2018,1,WESTERN EUROPE-EU,SPAIN,2,CARDIFF WALES,MADRID,7654,7429,225,9738,9648,90,-21.4007
03/03/2019 11:05,2018,1,WESTERN EUROPE-EU,SPAIN,2,CARDIFF WALES,MAHON,15957,0,15957,23064,0,23064,-30.81426
03/03/2019 11:05,2018,1,WESTERN EUROPE-EU,SPAIN,2,CARDIFF WALES,MALAGA,88740,60774,27966,87195,59418,27777,1.77189
03/03/2019 11:05,2018,1,WESTERN EUROPE-EU,SPAIN,2,CARDIFF WALES,PALMA DE MALLORCA,108313,33121,75192,112069,33259,78810,-3.35151
03/03/2019 11:05,2018,1,WESTERN EUROPE-EU,SPAIN,2,CARDIFF WALES,REUS,15509,0,15509,16444,0,16444,-5.68596
03/03/2019 11:05,2018,1,WESTERN EUROPE-EU,SPAIN,2,CARDIFF WALES,SEVILLE,139,0,139,0,0,0,0
03/03/2019 11:05,2018,1,WESTERN EUROPE-EU,SPAIN,2,CARDIFF WALES,VALENCIA,108,108,0,48,0,48,125
03/03/2019 11:05,2018,1,WESTERN EUROPE-EU,SPAIN,2,CARDIFF WALES,VITORIA,265,0,265,0,0,0,0
03/03/2019 11:05,2018,1,WESTERN EUROPE-EU,SPAIN,2,CITY OF DERRY (EGLINTON),PALMA DE MALLORCA,2436,0,2436,2250,0,2250,8.26667
03/03/2019 11:05,2018,1,WESTERN EUROPE-EU,SPAIN,2,CITY OF DERRY (EGLINTON),SEVILLE,108,0,108,0,0,0,0
03/03/2019 11:05,2018,1,WESTERN EUROPE-EU,SPAIN,2,DONCASTER SHEFFIELD,ALICANTE,62529,22331,40198,75400,26658,48742,-17.07029
03/03/2019 11:05,2018,1,WESTERN EUROPE-EU,SPAIN,2,DONCASTER SHEFFIELD,GIRONA,49,0,49,0,0,0,0
03/03/2019 11:05,2018,1,WESTERN EUROPE-EU,SPAIN,2,DONCASTER SHEFFIELD,IBIZA,14326,0,14326,15882,0,15882,-9.79725
03/03/2019 11:05,2018,1,WESTERN EUROPE-EU,SPAIN,2,DONCASTER SHEFFIELD,MAHON,16830,0,16830,17227,0,17227,-2.30452
03/03/2019 11:05,2018,1,WESTERN EUROPE-EU,SPAIN,2,DONCASTER SHEFFIELD,MALAGA,48350,13845,34505,55703,21456,34247,-13.20037
03/03/2019 11:05,2018,1,WESTERN EUROPE-EU,SPAIN,2,DONCASTER SHEFFIELD,PALMA DE MALLORCA,52863,5547,47316,71712,8819,62893,-26.2843
03/03/2019 11:05,2018,1,WESTERN EUROPE-EU,SPAIN,2,DONCASTER SHEFFIELD,REUS,9233,0,9233,9283,0,9283,-0.53862
03/03/2019 11:05,2018,1,WESTERN EUROPE-EU,SPAIN,2,DONCASTER SHEFFIELD,SEVILLE,139,139,0,0,0,0,0
03/03/2019 11:05,2018,1,WESTERN EUROPE-EU,SPAIN,2,DURHAM TEES VALLEY,BARCELONA,0,0,0,40,0,40,-100
03/03/2019 11:05,2018,1,WESTERN EUROPE-EU,SPAIN,2,DURHAM TEES VALLEY,SEVILLE,256,0,256,0,0,0,0
03/03/2019 11:05,2018,1,WESTERN EUROPE-EU,SPAIN,2,EAST MIDLANDS INTERNATIONAL,ALICANTE,401789,370580,31209,400947,369671,31276,0.21
03/03/2019 11:05,2018,1,WESTERN EUROPE-EU,SPAIN,2,EAST MIDLANDS INTERNATIONAL,ALMERIA,13122,13122,0,7125,7125,0,84.16842
03/03/2019 11:05,2018,1,WESTERN EUROPE-EU,SPAIN,2,EAST MIDLANDS INTERNATIONAL,ASTURIAS,0,0,0,90,0,90,-100
03/03/2019 11:05,2018,1,WESTERN EUROPE-EU,SPAIN,2,EAST MIDLANDS INTERNATIONAL,BARCELONA,74471,74471,0,90312,90200,112,-17.5403
03/03/2019 11:05,2018,1,WESTERN EUROPE-EU,SPAIN,2,EAST MIDLANDS INTERNATIONAL,GIRONA,33710,33382,328,32985,32985,0,2.19797
03/03/2019 11:05,2018,1,WESTERN EUROPE-EU,SPAIN,2,EAST MIDLANDS INTERNATIONAL,IBIZA,101587,83136,18451,109873,82777,27096,-7.54143
03/03/2019 11:05,2018,1,WESTERN EUROPE-EU,SPAIN,2,EAST MIDLANDS INTERNATIONAL,LIEIDA,1714,133,1581,0,0,0,0
03/03/2019 11:05,2018,1,WESTERN EUROPE-EU,SPAIN,2,EAST MIDLANDS INTERNATIONAL,MADRID,327,327,0,2811,0,2811,-88.36713
03/03/2019 11:05,2018,1,WESTERN EUROPE-EU,SPAIN,2,EAST MIDLANDS INTERNATIONAL,MAHON,83643,66330,17313,82857,64663,18194,0.94862
03/03/2019 11:05,2018,1,WESTERN EUROPE-EU,SPAIN,2,EAST MIDLANDS INTERNATIONAL,MALAGA,297758,267948,29810,305176,276113,29063,-2.43073
03/03/2019 11:05,2018,1,WESTERN EUROPE-EU,SPAIN,2,EAST MIDLANDS INTERNATIONAL,MURCIA SAN JAVIER,98824,98824,0,96263,96263,0,2.66042
03/03/2019 11:05,2018,1,WESTERN EUROPE-EU,SPAIN,2,EAST MIDLANDS INTERNATIONAL,PALMA DE MALLORCA,326367,292453,33914,350209,292098,58111,-6.80793
03/03/2019 11:05,2018,1,WESTERN EUROPE-EU,SPAIN,2,EAST MIDLANDS INTERNATIONAL,REUS,40513,40227,286,38900,38654,246,4.14653
03/03/2019 11:05,2018,1,WESTERN EUROPE-EU,SPAIN,2,EAST MIDLANDS INTERNATIONAL,SEVILLE,32214,32214,0,6943,5651,1292,363.97811
03/03/2019 11:05,2018,1,WESTERN EUROPE-EU,SPAIN,2,EAST MIDLANDS INTERNATIONAL,VALENCIA,43132,43132,0,40364,40364,0,6.8576
03/03/2019 11:05,2018,1,WESTERN EUROPE-EU,SPAIN,2,EDINBURGH,ALICANTE,209016,209016,0,230503,230503,0,-9.32179
03/03/2019 11:05,2018,1,WESTERN EUROPE-EU,SPAIN,2,EDINBURGH,ALMERIA,13496,13496,0,6960,6960,0,93.90805
03/03/2019 11:05,2018,1,WESTERN EUROPE-EU,SPAIN,2,EDINBURGH,ASTURIAS,323,0,323,0,0,0,0
03/03/2019 11:05,2018,1,WESTERN EUROPE-EU,SPAIN,2,EDINBURGH,BARCELONA,186766,186766,0,186568,186568,0,0.10613
03/03/2019 11:05,2018,1,WESTERN EUROPE-EU,SPAIN,2,EDINBURGH,BILBAO,31105,31105,0,21584,21584,0,44.11138
03/03/2019 11:05,2018,1,WESTERN EUROPE-EU,SPAIN,2,EDINBURGH,GIRONA,34106,34106,0,33693,33693,0,1.22577
03/03/2019 11:05,2018,1,WESTERN EUROPE-EU,SPAIN,2,EDINBURGH,IBIZA,44917,44917,0,42621,42621,0,5.38702
03/03/2019 11:05,2018,1,WESTERN EUROPE-EU,SPAIN,2,EDINBURGH,LEON,0,0,0,157,0,157,-100
03/03/2019 11:05,2018,1,WESTERN EUROPE-EU,SPAIN,2,EDINBURGH,MADRID,169522,169192,330,180513,180211,302,-6.08876
03/03/2019 11:05,2018,1,WESTERN EUROPE-EU,SPAIN,2,EDINBURGH,MAHON,16328,12985,3343,17127,12462,4665,-4.66515
03/03/2019 11:05,2018,1,WESTERN EUROPE-EU,SPAIN,2,EDINBURGH,MALAGA,172196,168520,3676,195779,192159,3620,-12.04573
03/03/2019 11:05,2018,1,WESTERN EUROPE-EU,SPAIN,2,EDINBURGH,MURCIA SAN JAVIER,17030,17030,0,14481,14481,0,17.60238
03/03/2019 11:05,2018,1,WESTERN EUROPE-EU,SPAIN,2,EDINBURGH,PALMA DE MALLORCA,200566,162188,38378,204232,167632,36600,-1.79502
03/03/2019 11:05,2018,1,WESTERN EUROPE-EU,SPAIN,2,EDINBURGH,REUS,16917,16917,0,16867,16867,0,0.29644
03/03/2019 11:05,2018,1,WESTERN EUROPE-EU,SPAIN,2,EDINBURGH,SALAMANCA,0,0,0,173,0,173,-100
03/03/2019 11:05,2018,1,WESTERN EUROPE-EU,SPAIN,2,EDINBURGH,SANTANDER,33846,33846,0,37466,37466,0,-9.66209
03/03/2019 11:05,2018,1,WESTERN EUROPE-EU,SPAIN,2,EDINBURGH,SANTIAGO DE COMPOSTELA (SPAIN),0,0,0,148,0,148,-100
03/03/2019 11:05,2018,1,WESTERN EUROPE-EU,SPAIN,2,EDINBURGH,SEVILLE,32782,32782,0,0,0,0,0
03/03/2019 11:05,2018,1,WESTERN EUROPE-EU,SPAIN,2,EDINBURGH,VALENCIA,50730,50643,87,8253,8253,0,514.68557
03/03/2019 11:05,2018,1,WESTERN EUROPE-EU,SPAIN,2,EDINBURGH,VALLADOLID,0,0,0,729,0,729,-100
03/03/2019 11:05,2018,1,WESTERN EUROPE-EU,SPAIN,2,EDINBURGH,VIGO,20766,20766,0,20972,20972,0,-0.98226
03/03/2019 11:05,2018,1,WESTERN EUROPE-EU,SPAIN,2,EDINBURGH,ZARAGOZA,378,0,378,291,0,291,29.89691
03/03/2019 11:05,2018,1,WESTERN EUROPE-EU,SPAIN,2,EXETER,ALICANTE,37380,37380,0,34768,34768,0,7.51266
03/03/2019 11:05,2018,1,WESTERN EUROPE-EU,SPAIN,2,EXETER,IBIZA,8571,0,8571,8770,0,8770,-2.2691
03/03/2019 11:05,2018,1,WESTERN EUROPE-EU,SPAIN,2,EXETER,MAHON,15684,0,15684,17044,0,17044,-7.97935
03/03/2019 11:05,2018,1,WESTERN EUROPE-EU,SPAIN,2,EXETER,MALAGA,35957,35957,0,34173,34173,0,5.2205
03/03/2019 11:05,2018,1,WESTERN EUROPE-EU,SPAIN,2,EXETER,PALMA DE MALLORCA,51719,15552,36167,56972,13622,43350,-9.22032
03/03/2019 11:05,2018,1,WESTERN EUROPE-EU,SPAIN,2,GLASGOW,ALICANTE,296363,278235,18128,326125,280795,45330,-9.12595
03/03/2019 11:05,2018,1,WESTERN EUROPE-EU,SPAIN,2,GLASGOW,ALMERIA,0,0,0,6025,4034,1991,-100
03/03/2019 11:05,2018,1,WESTERN EUROPE-EU,SPAIN,2,GLASGOW,BARCELONA,44853,41201,3652,47511,43580,3931,-5.59449
03/03/2019 11:05,2018,1,WESTERN EUROPE-EU,SPAIN,2,GLASGOW,BILBAO,0,0,0,16,0,16,-100
03/03/2019 11:05,2018,1,WESTERN EUROPE-EU,SPAIN,2,GLASGOW,CASTELLON COSTA AZAHAR,902,0,902,0,0,0,0
03/03/2019 11:05,2018,1,WESTERN EUROPE-EU,SPAIN,2,GLASGOW,GIRONA,16731,16731,0,17100,17100,0,-2.15789
03/03/2019 11:05,2018,1,WESTERN EUROPE-EU,SPAIN,2,GLASGOW,IBIZA,79526,60250,19276,82028,52879,29149,-3.05018
03/03/2019 11:05,2018,1,WESTERN EUROPE-EU,SPAIN,2,GLASGOW,MADRID,55363,55187,176,10642,10642,0,420.23116
03/03/2019 11:05,2018,1,WESTERN EUROPE-EU,SPAIN,2,GLASGOW,MAHON,34570,31212,3358,34206,24741,9465,1.06414
03/03/2019 11:05,2018,1,WESTERN EUROPE-EU,SPAIN,2,GLASGOW,MALAGA,231524,214583,16941,254078,225872,28206,-8.8768
03/03/2019 11:05,2018,1,WESTERN EUROPE-EU,SPAIN,2,GLASGOW,PALMA DE MALLORCA,206673,164188,42485,233443,161518,71925,-11.46747
03/03/2019 11:05,2018,1,WESTERN EUROPE-EU,SPAIN,2,GLASGOW,REUS,62409,50116,12293,85236,41948,43288,-26.78094
03/03/2019 11:05,2018,1,WESTERN EUROPE-EU,SPAIN,2,GLASGOW,SANTIAGO DE COMPOSTELA (SPAIN),0,0,0,148,0,148,-100
03/03/2019 11:05,2018,1,WESTERN EUROPE-EU,SPAIN,2,GLASGOW,VALENCIA,28059,28059,0,25788,25788,0,8.80642
03/03/2019 11:05,2018,1,WESTERN EUROPE-EU,SPAIN,2,GLASGOW,ZARAGOZA,0,0,0,108,0,108,-100
03/03/2019 11:05,2018,1,WESTERN EUROPE-EU,SPAIN,2,GUERNSEY,MALAGA,102,102,0,0,0,0,0
03/03/2019 11:05,2018,1,WESTERN EUROPE-EU,SPAIN,2,HUMBERSIDE,ALICANTE,0,0,0,928,0,928,-100
03/03/2019 11:05,2018,1,WESTERN EUROPE-EU,SPAIN,2,HUMBERSIDE,PALMA DE MALLORCA,9292,0,9292,10205,0,10205,-8.94659
03/03/2019 11:05,2018,1,WESTERN EUROPE-EU,SPAIN,2,HUMBERSIDE,SEVILLE,133,0,133,0,0,0,0
03/03/2019 11:05,2018,1,WESTERN EUROPE-EU,SPAIN,2,ISLE OF MAN,MAHON,836,0,836,709,0,709,17.91255
03/03/2019 11:05,2018,1,WESTERN EUROPE-EU,SPAIN,2,ISLE OF MAN,PALMA DE MALLORCA,2108,75,2033,1929,0,1929,9.27942
03/03/2019 11:05,2018,1,WESTERN EUROPE-EU,SPAIN,2,JERSEY,BARCELONA,267,0,267,171,78,93,56.14035
03/03/2019 11:05,2018,1,WESTERN EUROPE-EU,SPAIN,2,JERSEY,MADRID,174,0,174,4,0,4,4250
03/03/2019 11:05,2018,1,WESTERN EUROPE-EU,SPAIN,2,JERSEY,MALAGA,1191,0,1191,885,881,4,34.57627
03/03/2019 11:05,2018,1,WESTERN EUROPE-EU,SPAIN,2,JERSEY,PALMA DE MALLORCA,4101,0,4101,3854,0,3854,6.40893
03/03/2019 11:05,2018,1,WESTERN EUROPE-EU,SPAIN,2,LEEDS BRADFORD,ALICANTE,317280,317280,0,328587,328185,402,-3.4411
03/03/2019 11:05,2018,1,WESTERN EUROPE-EU,SPAIN,2,LEEDS BRADFORD,ALMERIA,13348,13348,0,12170,12170,0,9.67954
03/03/2019 11:05,2018,1,WESTERN EUROPE-EU,SPAIN,2,LEEDS BRADFORD,BARCELONA,54732,54732,0,75404,75179,225,-27.41499
03/03/2019 11:05,2018,1,WESTERN EUROPE-EU,SPAIN,2,LEEDS BRADFORD,GIRONA,39327,39327,0,37401,37401,0,5.14959
03/03/2019 11:05,2018,1,WESTERN EUROPE-EU,SPAIN,2,LEEDS BRADFORD,IBIZA,94053,85618,8435,91680,84190,7490,2.58835
03/03/2019 11:05,2018,1,WESTERN EUROPE-EU,SPAIN,2,LEEDS BRADFORD,MADRID,0,0,0,337,337,0,-100
03/03/2019 11:05,2018,1,WESTERN EUROPE-EU,SPAIN,2,LEEDS BRADFORD,MAHON,42019,33438,8581,51313,42253,9060,-18.11237
03/03/2019 11:05,2018,1,WESTERN EUROPE-EU,SPAIN,2,LEEDS BRADFORD,MALAGA,282430,273156,9274,290468,289866,602,-2.76726
03/03/2019 11:05,2018,1,WESTERN EUROPE-EU,SPAIN,2,LEEDS BRADFORD,MURCIA SAN JAVIER,66225,66225,0,55510,55510,0,19.30283
03/03/2019 11:05,2018,1,WESTERN EUROPE-EU,SPAIN,2,LEEDS BRADFORD,PALMA DE MALLORCA,253567,206257,47310,265038,224992,40046,-4.32806
03/03/2019 11:05,2018,1,WESTERN EUROPE-EU,SPAIN,2,LEEDS BRADFORD,REUS,22603,22603,0,18788,18788,0,20.30551
03/03/2019 11:05,2018,1,WESTERN EUROPE-EU,SPAIN,2,LEEDS BRADFORD,SANTIAGO DE COMPOSTELA (SPAIN),0,0,0,153,153,0,-100
03/03/2019 11:05,2018,1,WESTERN EUROPE-EU,SPAIN,2,LIVERPOOL (JOHN LENNON),ALICANTE,287207,287207,0,260395,260395,0,10.29666
03/03/2019 11:05,2018,1,WESTERN EUROPE-EU,SPAIN,2,LIVERPOOL (JOHN LENNON),BARCELONA,240513,240513,0,230030,230030,0,4.55723
03/03/2019 11:05,2018,1,WESTERN EUROPE-EU,SPAIN,2,LIVERPOOL (JOHN LENNON),GIRONA,20679,20679,0,20238,20238,0,2.17907
03/03/2019 11:05,2018,1,WESTERN EUROPE-EU,SPAIN,2,LIVERPOOL (JOHN LENNON),IBIZA,36756,29469,7287,35494,29527,5967,3.55553
03/03/2019 11:05,2018,1,WESTERN EUROPE-EU,SPAIN,2,LIVERPOOL (JOHN LENNON),MADRID,67557,67557,0,91459,91459,0,-26.13411
03/03/2019 11:05,2018,1,WESTERN EUROPE-EU,SPAIN,2,LIVERPOOL (JOHN LENNON),MAHON,0,0,0,7193,7193,0,-100
03/03/2019 11:05,2018,1,WESTERN EUROPE-EU,SPAIN,2,LIVERPOOL (JOHN LENNON),MALAGA,268490,268329,161,246377,246377,0,8.97527
03/03/2019 11:05,2018,1,WESTERN EUROPE-EU,SPAIN,2,LIVERPOOL (JOHN LENNON),MURCIA SAN JAVIER,0,0,0,92,0,92,-100
03/03/2019 11:05,2018,1,WESTERN EUROPE-EU,SPAIN,2,LIVERPOOL (JOHN LENNON),PALMA DE MALLORCA,225682,216725,8957,217918,202969,14949,3.56281
03/03/2019 11:05,2018,1,WESTERN EUROPE-EU,SPAIN,2,LIVERPOOL (JOHN LENNON),REUS,20543,20543,0,21887,21887,0,-6.14063
03/03/2019 11:05,2018,1,WESTERN EUROPE-EU,SPAIN,2,LIVERPOOL (JOHN LENNON),SEVILLE,0,0,0,660,312,348,-100
03/03/2019 11:05,2018,1,WESTERN EUROPE-EU,SPAIN,2,LIVERPOOL (JOHN LENNON),VALENCIA,48,0,48,0,0,0,0
03/03/2019 11:05,2018,1,WESTERN EUROPE-EU,SPAIN,2,MANCHESTER,ALICANTE,748982,665785,83197,884825,797999,86826,-15.35253
03/03/2019 11:05,2018,1,WESTERN EUROPE-EU,SPAIN,2,MANCHESTER,ALMERIA,79770,70956,8814,99466,81336,18130,-19.80174
03/03/2019 11:05,2018,1,WESTERN EUROPE-EU,SPAIN,2,MANCHESTER,BARCELONA,391506,391450,56,448290,447250,1040,-12.6668
03/03/2019 11:05,2018,1,WESTERN EUROPE-EU,SPAIN,2,MANCHESTER,BILBAO,74933,74933,0,60244,60244,0,24.38251
03/03/2019 11:05,2018,1,WESTERN EUROPE-EU,SPAIN,2,MANCHESTER,GIRONA,86944,70629,16315,86515,63855,22660,0.49587
03/03/2019 11:05,2018,1,WESTERN EUROPE-EU,SPAIN,2,MANCHESTER,GRANADA,34116,34116,0,14927,14927,0,128.55229
03/03/2019 11:05,2018,1,WESTERN EUROPE-EU,SPAIN,2,MANCHESTER,IBIZA,297771,224103,73668,282881,214524,68357,5.2637
03/03/2019 11:05,2018,1,WESTERN EUROPE-EU,SPAIN,2,MANCHESTER,LIEIDA,6859,6008,851,6890,539,6351,-0.44993
03/03/2019 11:05,2018,1,WESTERN EUROPE-EU,SPAIN,2,MANCHESTER,MADRID,164358,164265,93,162056,161815,241,1.4205
03/03/2019 11:05,2018,1,WESTERN EUROPE-EU,SPAIN,2,MANCHESTER,MAHON,152318,72410,79908,181673,104003,77670,-16.15815
03/03/2019 11:05,2018,1,WESTERN EUROPE-EU,SPAIN,2,MANCHESTER,MALAGA,567747,491139,76608,696233,616915,79318,-18.45445
03/03/2019 11:05,2018,1,WESTERN EUROPE-EU,SPAIN,2,MANCHESTER,MURCIA SAN JAVIER,140937,140937,0,138722,138722,0,1.59672
03/03/2019 11:05,2018,1,WESTERN EUROPE-EU,SPAIN,2,MANCHESTER,PALMA DE MALLORCA,720393,600465,119928,745761,598777,146984,-3.40163
03/03/2019 11:05,2018,1,WESTERN EUROPE-EU,SPAIN,2,MANCHESTER,REUS,110129,73678,36451,98217,60426,37791,12.12825
03/03/2019 11:05,2018,1,WESTERN EUROPE-EU,SPAIN,2,MANCHESTER,SEVILLE,50582,49269,1313,5923,5923,0,753.99291
03/03/2019 11:05,2018,1,WESTERN EUROPE-EU,SPAIN,2,MANCHESTER,VALENCIA,49350,48084,1266,46866,46866,0,5.30022
03/03/2019 11:05,2018,1,WESTERN EUROPE-EU,SPAIN,2,MANCHESTER,VIGO,0,0,0,3067,0,3067,-100
03/03/2019 11:05,2018,1,WESTERN EUROPE-EU,SPAIN,2,NEWCASTLE,ALICANTE,368256,367664,592,379433,379433,0,-2.94571
03/03/2019 11:05,2018,1,WESTERN EUROPE-EU,SPAIN,2,NEWCASTLE,ALMERIA,12035,12035,0,12383,12383,0,-2.8103
03/03/2019 11:05,2018,1,WESTERN EUROPE-EU,SPAIN,2,NEWCASTLE,BARCELONA,72099,72099,0,77244,77244,0,-6.66071
03/03/2019 11:05,2018,1,WESTERN EUROPE-EU,SPAIN,2,NEWCASTLE,GIRONA,34540,34540,0,38848,38848,0,-11.08937
03/03/2019 11:05,2018,1,WESTERN EUROPE-EU,SPAIN,2,NEWCASTLE,IBIZA,83820,83820,0,82950,82950,0,1.04882
03/03/2019 11:05,2018,1,WESTERN EUROPE-EU,SPAIN,2,NEWCASTLE,MADRID,29119,29119,0,26088,25995,93,11.61837
03/03/2019 11:05,2018,1,WESTERN EUROPE-EU,SPAIN,2,NEWCASTLE,MAHON,40707,40707,0,47815,47815,0,-14.86563
03/03/2019 11:05,2018,1,WESTERN EUROPE-EU,SPAIN,2,NEWCASTLE,MALAGA,269622,269261,361,263658,263658,0,2.26202
03/03/2019 11:05,2018,1,WESTERN EUROPE-EU,SPAIN,2,NEWCASTLE,MURCIA SAN JAVIER,16885,16800,85,16772,16772,0,0.67374
03/03/2019 11:05,2018,1,WESTERN EUROPE-EU,SPAIN,2,NEWCASTLE,PALMA DE MALLORCA,304453,304453,0,325697,325519,178,-6.52263
03/03/2019 11:05,2018,1,WESTERN EUROPE-EU,SPAIN,2,NEWCASTLE,REUS,56347,56347,0,62137,62137,0,-9.31812
03/03/2019 11:05,2018,1,WESTERN EUROPE-EU,SPAIN,2,NEWQUAY,ALICANTE,27163,27163,0,21298,21298,0,27.5378
03/03/2019 11:05,2018,1,WESTERN EUROPE-EU,SPAIN,2,NEWQUAY,SEVILLE,144,0,144,0,0,0,0
03/03/2019 11:05,2018,1,WESTERN EUROPE-EU,SPAIN,2,NORWICH,ALICANTE,18230,18230,0,18443,18443,0,-1.15491
03/03/2019 11:05,2018,1,WESTERN EUROPE-EU,SPAIN,2,NORWICH,IBIZA,8408,0,8408,8628,0,8628,-2.54984
03/03/2019 11:05,2018,1,WESTERN EUROPE-EU,SPAIN,2,NORWICH,MAHON,8720,0,8720,9055,0,9055,-3.69961
03/03/2019 11:05,2018,1,WESTERN EUROPE-EU,SPAIN,2,NORWICH,MALAGA,17428,17428,0,16898,16898,0,3.13647
03/03/2019 11:05,2018,1,WESTERN EUROPE-EU,SPAIN,2,NORWICH,PALMA DE MALLORCA,26942,0,26942,26913,179,26734,0.10775
03/03/2019 11:05,2018,1,WESTERN EUROPE-EU,SPAIN,2,NORWICH,SEVILLE,234,0,234,0,0,0,0
03/03/2019 11:05,2018,1,WESTERN EUROPE-EU,SPAIN,2,PRESTWICK,ALICANTE,74869,74600,269,80924,80432,492,-7.48233
03/03/2019 11:05,2018,1,WESTERN EUROPE-EU,SPAIN,2,PRESTWICK,BARCELONA,80584,80584,0,88388,88388,0,-8.82925
03/03/2019 11:05,2018,1,WESTERN EUROPE-EU,SPAIN,2,PRESTWICK,GIRONA,19677,19677,0,19313,19313,0,1.88474
03/03/2019 11:05,2018,1,WESTERN EUROPE-EU,SPAIN,2,PRESTWICK,IBIZA,19205,19205,0,21735,21735,0,-11.64021
03/03/2019 11:05,2018,1,WESTERN EUROPE-EU,SPAIN,2,PRESTWICK,MALAGA,77399,77399,0,78826,78826,0,-1.81032
03/03/2019 11:05,2018,1,WESTERN EUROPE-EU,SPAIN,2,PRESTWICK,MURCIA SAN JAVIER,21643,21643,0,22832,22832,0,-5.2076
03/03/2019 11:05,2018,1,WESTERN EUROPE-EU,SPAIN,2,PRESTWICK,PALMA DE MALLORCA,61689,61689,0,61407,61407,0,0.45923
03/03/2019 11:05,2018,1,WESTERN EUROPE-EU,SPAIN,2,PRESTWICK,REUS,0,0,0,11174,11174,0,-100
03/03/2019 11:05,2018,1,WESTERN EUROPE-EU,SPAIN,2,SOUTHAMPTON,ALICANTE,38637,38637,0,34813,34813,0,10.9844
03/03/2019 11:05,2018,1,WESTERN EUROPE-EU,SPAIN,2,SOUTHAMPTON,IBIZA,4462,1349,3113,4153,4153,0,7.4404
03/03/2019 11:05,2018,1,WESTERN EUROPE-EU,SPAIN,2,SOUTHAMPTON,MAHON,2253,74,2179,0,0,0,0
03/03/2019 11:05,2018,1,WESTERN EUROPE-EU,SPAIN,2,SOUTHAMPTON,MALAGA,26478,26427,51,30652,30652,0,-13.61738
03/03/2019 11:05,2018,1,WESTERN EUROPE-EU,SPAIN,2,SOUTHAMPTON,PALMA DE MALLORCA,22768,15866,6902,29195,29195,0,-22.01404
03/03/2019 11:05,2018,1,WESTERN EUROPE-EU,SPAIN,2,SOUTHAMPTON,VIGO,49,0,49,0,0,0,0
03/03/2019 11:05,2018,1,WESTERN EUROPE-EU,SPAIN(CANARY ISLANDS),1,GATWICK,ARRECIFE,377218,301068,76150,476254,393718,82536,-20.79479
03/03/2019 11:05,2018,1,WESTERN EUROPE-EU,SPAIN(CANARY ISLANDS),1,GATWICK,FUERTEVENTURA,232071,177386,54685,254548,199215,55333,-8.83016
03/03/2019 11:05,2018,1,WESTERN EUROPE-EU,SPAIN(CANARY ISLANDS),1,GATWICK,LAS PALMAS,290729,204201,86528,339899,245250,94649,-14.46606
03/03/2019 11:05,2018,1,WESTERN EUROPE-EU,SPAIN(CANARY ISLANDS),1,GATWICK,SANTA CRUZ DE LA PALMA,40349,22633,17716,45521,21351,24170,-11.36179
03/03/2019 11:05,2018,1,WESTERN EUROPE-EU,SPAIN(CANARY ISLANDS),1,GATWICK,TENERIFE (SURREINA SOFIA),710343,565026,145317,817588,646705,170883,-13.11724
03/03/2019 11:05,2018,1,WESTERN EUROPE-EU,SPAIN(CANARY ISLANDS),1,HEATHROW,LAS PALMAS,16584,16584,0,46764,46764,0,-64.53682
03/03/2019 11:05,2018,1,WESTERN EUROPE-EU,SPAIN(CANARY ISLANDS),1,HEATHROW,TENERIFE (NORTE LOS RODEOS),0,0,0,211,211,0,-100
03/03/2019 11:05,2018,1,WESTERN EUROPE-EU,SPAIN(CANARY ISLANDS),1,HEATHROW,TENERIFE (SURREINA SOFIA),14382,14382,0,2916,2916,0,393.20988
03/03/2019 11:05,2018,1,WESTERN EUROPE-EU,SPAIN(CANARY ISLANDS),1,LUTON,ARRECIFE,107480,76943,30537,126018,95209,30809,-14.7106
03/03/2019 11:05,2018,1,WESTERN EUROPE-EU,SPAIN(CANARY ISLANDS),1,LUTON,FUERTEVENTURA,49197,34087,15110,54433,35250,19183,-9.61916
03/03/2019 11:05,2018,1,WESTERN EUROPE-EU,SPAIN(CANARY ISLANDS),1,LUTON,LAS PALMAS,41482,22510,18972,50353,32540,17813,-17.61762
03/03/2019 11:05,2018,1,WESTERN EUROPE-EU,SPAIN(CANARY ISLANDS),1,LUTON,TENERIFE (SURREINA SOFIA),129868,90372,39496,188093,149457,38636,-30.95543
03/03/2019 11:05,2018,1,WESTERN EUROPE-EU,SPAIN(CANARY ISLANDS),1,SOUTHEND,ARRECIFE,13430,13430,0,16510,16510,0,-18.65536
03/03/2019 11:05,2018,1,WESTERN EUROPE-EU,SPAIN(CANARY ISLANDS),1,SOUTHEND,LAS PALMAS,0,0,0,6481,6481,0,-100
03/03/2019 11:05,2018,1,WESTERN EUROPE-EU,SPAIN(CANARY ISLANDS),1,SOUTHEND,TENERIFE (SURREINA SOFIA),13589,13589,0,16700,16700,0,-18.62874
03/03/2019 11:05,2018,1,WESTERN EUROPE-EU,SPAIN(CANARY ISLANDS),1,STANSTED,ARRECIFE,239016,228685,10331,200295,190118,10177,19.33199
03/03/2019 11:05,2018,1,WESTERN EUROPE-EU,SPAIN(CANARY ISLANDS),1,STANSTED,FUERTEVENTURA,162361,143587,18774,148815,131566,17249,9.10258
03/03/2019 11:05,2018,1,WESTERN EUROPE-EU,SPAIN(CANARY ISLANDS),1,STANSTED,LAS PALMAS,189866,170890,18976,159189,140727,18462,19.2708
03/03/2019 11:05,2018,1,WESTERN EUROPE-EU,SPAIN(CANARY ISLANDS),1,STANSTED,TENERIFE (SURREINA SOFIA),352782,323346,29436,312121,282693,29428,13.02732
03/03/2019 11:05,2018,1,WESTERN EUROPE-EU,SPAIN(CANARY ISLANDS),2,ABERDEEN,LAS PALMAS,8960,0,8960,7363,0,7363,21.68953
03/03/2019 11:05,2018,1,WESTERN EUROPE-EU,SPAIN(CANARY ISLANDS),2,ABERDEEN,TENERIFE (SURREINA SOFIA),29807,0,29807,25957,0,25957,14.83222
03/03/2019 11:05,2018,1,WESTERN EUROPE-EU,SPAIN(CANARY ISLANDS),2,BELFAST INTERNATIONAL,ARRECIFE,132403,90762,41641,123470,82171,41299,7.23496
03/03/2019 11:05,2018,1,WESTERN EUROPE-EU,SPAIN(CANARY ISLANDS),2,BELFAST INTERNATIONAL,FUERTEVENTURA,30013,30013,0,13269,13250,19,126.18886
03/03/2019 11:05,2018,1,WESTERN EUROPE-EU,SPAIN(CANARY ISLANDS),2,BELFAST INTERNATIONAL,LAS PALMAS,40059,28303,11756,45879,22167,23712,-12.68554
03/03/2019 11:05,2018,1,WESTERN EUROPE-EU,SPAIN(CANARY ISLANDS),2,BELFAST INTERNATIONAL,TENERIFE (SURREINA SOFIA),130667,72824,57843,126232,66063,60169,3.51337
03/03/2019 11:05,2018,1,WESTERN EUROPE-EU,SPAIN(CANARY ISLANDS),2,BIRMINGHAM,ARRECIFE,249657,190351,59306,262902,202325,60577,-5.038
03/03/2019 11:05,2018,1,WESTERN EUROPE-EU,SPAIN(CANARY ISLANDS),2,BIRMINGHAM,FUERTEVENTURA,149776,112437,37339,176062,135861,40201,-14.92997
03/03/2019 11:05,2018,1,WESTERN EUROPE-EU,SPAIN(CANARY ISLANDS),2,BIRMINGHAM,LAS PALMAS,176874,120271,56603,183355,140570,42785,-3.53467
03/03/2019 11:05,2018,1,WESTERN EUROPE-EU,SPAIN(CANARY ISLANDS),2,BIRMINGHAM,TENERIFE (NORTE LOS RODEOS),0,0,0,135,135,0,-100
03/03/2019 11:05,2018,1,WESTERN EUROPE-EU,SPAIN(CANARY ISLANDS),2,BIRMINGHAM,TENERIFE (SURREINA SOFIA),333730,253436,80294,434084,359444,74640,-23.11857
03/03/2019 11:05,2018,1,WESTERN EUROPE-EU,SPAIN(CANARY ISLANDS),2,BOURNEMOUTH,ARRECIFE,34930,0,34930,36879,163,36716,-5.28485
03/03/2019 11:05,2018,1,WESTERN EUROPE-EU,SPAIN(CANARY ISLANDS),2,BOURNEMOUTH,LAS PALMAS,28566,10865,17701,36024,18047,17977,-20.70286
03/03/2019 11:05,2018,1,WESTERN EUROPE-EU,SPAIN(CANARY ISLANDS),2,BOURNEMOUTH,TENERIFE (SURREINA SOFIA),45212,18096,27116,45403,16546,28857,-0.42068
03/03/2019 11:05,2018,1,WESTERN EUROPE-EU,SPAIN(CANARY ISLANDS),2,BRISTOL,ARRECIFE,165759,122093,43666,170474,130444,40030,-2.76582
03/03/2019 11:05,2018,1,WESTERN EUROPE-EU,SPAIN(CANARY ISLANDS),2,BRISTOL,FUERTEVENTURA,75557,48448,27109,74154,52513,21641,1.89201
03/03/2019 11:05,2018,1,WESTERN EUROPE-EU,SPAIN(CANARY ISLANDS),2,BRISTOL,LAS PALMAS,92078,59051,33027,101893,65986,35907,-9.63265
03/03/2019 11:05,2018,1,WESTERN EUROPE-EU,SPAIN(CANARY ISLANDS),2,BRISTOL,TENERIFE (SURREINA SOFIA),201858,152948,48910,189549,155246,34303,6.49384
03/03/2019 11:05,2018,1,WESTERN EUROPE-EU,SPAIN(CANARY ISLANDS),2,CARDIFF WALES,ARRECIFE,46465,0,46465,46031,0,46031,0.94284
03/03/2019 11:05,2018,1,WESTERN EUROPE-EU,SPAIN(CANARY ISLANDS),2,CARDIFF WALES,FUERTEVENTURA,130,130,0,731,174,557,-82.21614
03/03/2019 11:05,2018,1,WESTERN EUROPE-EU,SPAIN(CANARY ISLANDS),2,CARDIFF WALES,LAS PALMAS,18996,0,18996,19067,339,18728,-0.37237
03/03/2019 11:05,2018,1,WESTERN EUROPE-EU,SPAIN(CANARY ISLANDS),2,CARDIFF WALES,TENERIFE (SURREINA SOFIA),88771,23608,65163,88884,23393,65491,-0.12713
03/03/2019 11:05,2018,1,WESTERN EUROPE-EU,SPAIN(CANARY ISLANDS),2,DONCASTER SHEFFIELD,ARRECIFE,39395,0,39395,39101,0,39101,0.7519
03/03/2019 11:05,2018,1,WESTERN EUROPE-EU,SPAIN(CANARY ISLANDS),2,DONCASTER SHEFFIELD,LAS PALMAS,20042,0,20042,18355,0,18355,9.19096
03/03/2019 11:05,2018,1,WESTERN EUROPE-EU,SPAIN(CANARY ISLANDS),2,DONCASTER SHEFFIELD,TENERIFE (SURREINA SOFIA),51592,577,51015,50355,377,49978,2.45656
03/03/2019 11:05,2018,1,WESTERN EUROPE-EU,SPAIN(CANARY ISLANDS),2,EAST MIDLANDS INTERNATIONAL,ARRECIFE,197317,178805,18512,207280,183617,23663,-4.80654
03/03/2019 11:05,2018,1,WESTERN EUROPE-EU,SPAIN(CANARY ISLANDS),2,EAST MIDLANDS INTERNATIONAL,FUERTEVENTURA,117558,99429,18129,131001,96980,34021,-10.26175
03/03/2019 11:05,2018,1,WESTERN EUROPE-EU,SPAIN(CANARY ISLANDS),2,EAST MIDLANDS INTERNATIONAL,LAS PALMAS,98683,89404,9279,101196,86485,14711,-2.4833
03/03/2019 11:05,2018,1,WESTERN EUROPE-EU,SPAIN(CANARY ISLANDS),2,EAST MIDLANDS INTERNATIONAL,TENERIFE (NORTE LOS RODEOS),171,171,0,0,0,0,0
03/03/2019 11:05,2018,1,WESTERN EUROPE-EU,SPAIN(CANARY ISLANDS),2,EAST MIDLANDS INTERNATIONAL,TENERIFE (SURREINA SOFIA),326095,272092,54003,320326,264473,55853,1.80098
03/03/2019 11:05,2018,1,WESTERN EUROPE-EU,SPAIN(CANARY ISLANDS),2,EDINBURGH,ARRECIFE,97546,82204,15342,94926,76785,18141,2.76004
03/03/2019 11:05,2018,1,WESTERN EUROPE-EU,SPAIN(CANARY ISLANDS),2,EDINBURGH,FUERTEVENTURA,69591,69591,0,61603,61603,0,12.9669
03/03/2019 11:05,2018,1,WESTERN EUROPE-EU,SPAIN(CANARY ISLANDS),2,EDINBURGH,LAS PALMAS,82729,69749,12980,81385,65604,15781,1.65141
03/03/2019 11:05,2018,1,WESTERN EUROPE-EU,SPAIN(CANARY ISLANDS),2,EDINBURGH,TENERIFE (SURREINA SOFIA),256238,218611,37627,253726,217393,36333,0.99004
03/03/2019 11:05,2018,1,WESTERN EUROPE-EU,SPAIN(CANARY ISLANDS),2,EXETER,ARRECIFE,36955,0,36955,37069,0,37069,-0.30753
03/03/2019 11:05,2018,1,WESTERN EUROPE-EU,SPAIN(CANARY ISLANDS),2,EXETER,LAS PALMAS,18824,0,18824,18268,0,18268,3.04357
03/03/2019 11:05,2018,1,WESTERN EUROPE-EU,SPAIN(CANARY ISLANDS),2,EXETER,TENERIFE (SURREINA SOFIA),38877,0,38877,38881,0,38881,-0.01029
03/03/2019 11:05,2018,1,WESTERN EUROPE-EU,SPAIN(CANARY ISLANDS),2,GLASGOW,ARRECIFE,158155,135986,22169,181123,126435,54688,-12.68089
03/03/2019 11:05,2018,1,WESTERN EUROPE-EU,SPAIN(CANARY ISLANDS),2,GLASGOW,FUERTEVENTURA,71706,71706,0,86815,52454,34361,-17.40367
03/03/2019 11:05,2018,1,WESTERN EUROPE-EU,SPAIN(CANARY ISLANDS),2,GLASGOW,LAS PALMAS,96615,84608,12007,108596,75152,33444,-11.03263
03/03/2019 11:05,2018,1,WESTERN EUROPE-EU,SPAIN(CANARY ISLANDS),2,GLASGOW,TENERIFE (SURREINA SOFIA),226515,195499,31016,264087,146974,117113,-14.22713
03/03/2019 11:05,2018,1,WESTERN EUROPE-EU,SPAIN(CANARY ISLANDS),2,HUMBERSIDE,TENERIFE (SURREINA SOFIA),0,0,0,5428,0,5428,-100
03/03/2019 11:05,2018,1,WESTERN EUROPE-EU,SPAIN(CANARY ISLANDS),2,JERSEY,TENERIFE (SURREINA SOFIA),1681,612,1069,2628,0,2628,-36.03501
03/03/2019 11:05,2018,1,WESTERN EUROPE-EU,SPAIN(CANARY ISLANDS),2,LEEDS BRADFORD,ARRECIFE,141012,141012,0,136723,136723,0,3.137
03/03/2019 11:05,2018,1,WESTERN EUROPE-EU,SPAIN(CANARY ISLANDS),2,LEEDS BRADFORD,FUERTEVENTURA,73080,73080,0,69626,69626,0,4.96079
03/03/2019 11:05,2018,1,WESTERN EUROPE-EU,SPAIN(CANARY ISLANDS),2,LEEDS BRADFORD,LAS PALMAS,93472,93472,0,91941,91941,0,1.6652
03/03/2019 11:05,2018,1,WESTERN EUROPE-EU,SPAIN(CANARY ISLANDS),2,LEEDS BRADFORD,TENERIFE (SURREINA SOFIA),200690,187440,13250,212999,195693,17306,-5.7789
03/03/2019 11:05,2018,1,WESTERN EUROPE-EU,SPAIN(CANARY ISLANDS),2,LIVERPOOL (JOHN LENNON),ARRECIFE,74595,74595,0,75186,75186,0,-0.78605
03/03/2019 11:05,2018,1,WESTERN EUROPE-EU,SPAIN(CANARY ISLANDS),2,LIVERPOOL (JOHN LENNON),FUERTEVENTURA,52538,52538,0,55314,55314,0,-5.01862
03/03/2019 11:05,2018,1,WESTERN EUROPE-EU,SPAIN(CANARY ISLANDS),2,LIVERPOOL (JOHN LENNON),LAS PALMAS,21112,21112,0,24822,24822,0,-14.94642
03/03/2019 11:05,2018,1,WESTERN EUROPE-EU,SPAIN(CANARY ISLANDS),2,LIVERPOOL (JOHN LENNON),TENERIFE (SURREINA SOFIA),40861,40665,196,41251,41086,165,-0.94543
03/03/2019 11:05,2018,1,WESTERN EUROPE-EU,SPAIN(CANARY ISLANDS),2,MANCHESTER,ARRECIFE,455422,355888,99534,481544,381885,99659,-5.42463
03/03/2019 11:05,2018,1,WESTERN EUROPE-EU,SPAIN(CANARY ISLANDS),2,MANCHESTER,FUERTEVENTURA,259218,199938,59280,263959,201963,61996,-1.79611
03/03/2019 11:05,2018,1,WESTERN EUROPE-EU,SPAIN(CANARY ISLANDS),2,MANCHESTER,LAS PALMAS,302812,210479,92333,328176,217890,110286,-7.72878
03/03/2019 11:05,2018,1,WESTERN EUROPE-EU,SPAIN(CANARY ISLANDS),2,MANCHESTER,SANTA CRUZ DE LA PALMA,24039,0,24039,26132,0,26132,-8.00934
03/03/2019 11:05,2018,1,WESTERN EUROPE-EU,SPAIN(CANARY ISLANDS),2,MANCHESTER,TENERIFE (SURREINA SOFIA),798954,630357,168597,878674,704752,173922,-9.07276
03/03/2019 11:05,2018,1,WESTERN EUROPE-EU,SPAIN(CANARY ISLANDS),2,NEWCASTLE,ARRECIFE,151213,150984,229,157788,157788,0,-4.16698
03/03/2019 11:05,2018,1,WESTERN EUROPE-EU,SPAIN(CANARY ISLANDS),2,NEWCASTLE,FUERTEVENTURA,62430,62095,335,57459,57459,0,8.65139
03/03/2019 11:05,2018,1,WESTERN EUROPE-EU,SPAIN(CANARY ISLANDS),2,NEWCASTLE,LAS PALMAS,64863,64699,164,69424,69235,189,-6.56977
03/03/2019 11:05,2018,1,WESTERN EUROPE-EU,SPAIN(CANARY ISLANDS),2,NEWCASTLE,TENERIFE (SURREINA SOFIA),246944,246944,0,248007,248007,0,-0.42862
03/03/2019 11:05,2018,1,WESTERN EUROPE-EU,SPAIN(CANARY ISLANDS),2,NORWICH,LAS PALMAS,8252,0,8252,8565,0,8565,-3.65441
03/03/2019 11:05,2018,1,WESTERN EUROPE-EU,SPAIN(CANARY ISLANDS),2,NORWICH,TENERIFE (NORTE LOS RODEOS),12667,0,12667,18698,0,18698,-32.25479
03/03/2019 11:05,2018,1,WESTERN EUROPE-EU,SPAIN(CANARY ISLANDS),2,NORWICH,TENERIFE (SURREINA SOFIA),11723,173,11550,0,0,0,0
03/03/2019 11:05,2018,1,WESTERN EUROPE-EU,SPAIN(CANARY ISLANDS),2,PRESTWICK,ARRECIFE,34499,34499,0,33729,33729,0,2.2829
03/03/2019 11:05,2018,1,WESTERN EUROPE-EU,SPAIN(CANARY ISLANDS),2,PRESTWICK,FUERTEVENTURA,16988,16988,0,17405,17405,0,-2.39586
03/03/2019 11:05,2018,1,WESTERN EUROPE-EU,SPAIN(CANARY ISLANDS),2,PRESTWICK,LAS PALMAS,23749,23749,0,25810,25810,0,-7.98528
03/03/2019 11:05,2018,1,WESTERN EUROPE-EU,SPAIN(CANARY ISLANDS),2,PRESTWICK,TENERIFE (SURREINA SOFIA),95226,95226,0,93674,93460,214,1.65681
03/03/2019 11:05,2018,1,WESTERN EUROPE-EU,SWEDEN,1,GATWICK,GOTEBORG (LANDVETTER),183873,183873,0,194976,194976,0,-5.69455
03/03/2019 11:05,2018,1,WESTERN EUROPE-EU,SWEDEN,1,GATWICK,JONKOPING,0,0,0,220,0,220,-100
03/03/2019 11:05,2018,1,WESTERN EUROPE-EU,SWEDEN,1,GATWICK,KIRUNA,101,0,101,1230,0,1230,-91.78862
03/03/2019 11:05,2018,1,WESTERN EUROPE-EU,SWEDEN,1,GATWICK,OSTERSUND / FROSON,6582,6582,0,5390,5390,0,22.11503
03/03/2019 11:05,2018,1,WESTERN EUROPE-EU,SWEDEN,1,GATWICK,PAJALA YLLAS,0,0,0,378,0,378,-100
03/03/2019 11:05,2018,1,WESTERN EUROPE-EU,SWEDEN,1,GATWICK,STOCKHOLM (ARLANDA),498756,498646,110,497417,497403,14,0.26919
03/03/2019 11:05,2018,1,WESTERN EUROPE-EU,SWEDEN,1,GATWICK,STOCKHOLM (BROMMA),0,0,0,9,0,9,-100
03/03/2019 11:05,2018,1,WESTERN EUROPE-EU,SWEDEN,1,GATWICK,VISBY,0,0,0,171,0,171,-100
03/03/2019 11:05,2018,1,WESTERN EUROPE-EU,SWEDEN,1,HEATHROW,GOTEBORG (LANDVETTER),254676,254676,0,247135,247135,0,3.05137
03/03/2019 11:05,2018,1,WESTERN EUROPE-EU,SWEDEN,1,HEATHROW,KIRUNA,2238,0,2238,2538,0,2538,-11.82033
03/03/2019 11:05,2018,1,WESTERN EUROPE-EU,SWEDEN,1,HEATHROW,STOCKHOLM (ARLANDA),970622,970622,0,1013192,1013192,0,-4.20157
03/03/2019 11:05,2018,1,WESTERN EUROPE-EU,SWEDEN,1,LUTON,GOTEBORG (LANDVETTER),0,0,0,4,0,4,-100
03/03/2019 11:05,2018,1,WESTERN EUROPE-EU,SWEDEN,1,LUTON,NORRKOPING,0,0,0,25,0,25,-100
03/03/2019 11:05,2018,1,WESTERN EUROPE-EU,SWEDEN,1,LUTON,OSTERSUND / FROSON,808,0,808,0,0,0,0
03/03/2019 11:05,2018,1,WESTERN EUROPE-EU,SWEDEN,1,LUTON,STOCKHOLM (ARLANDA),49243,49243,0,58946,58853,93,-16.46083
03/03/2019 11:05,2018,1,WESTERN EUROPE-EU,SWEDEN,1,STANSTED,GOTEBORG (LANDVETTER),155673,155602,71,157867,157573,294,-1.38978
03/03/2019 11:05,2018,1,WESTERN EUROPE-EU,SWEDEN,1,STANSTED,HALMSTAD,312,0,312,0,0,0,0
03/03/2019 11:05,2018,1,WESTERN EUROPE-EU,SWEDEN,1,STANSTED,MALMO,179,179,0,92,0,92,94.56522
03/03/2019 11:05,2018,1,WESTERN EUROPE-EU,SWEDEN,1,STANSTED,NORRKOPING,174,174,0,0,0,0,0
03/03/2019 11:05,2018,1,WESTERN EUROPE-EU,SWEDEN,1,STANSTED,OSTERSUND / FROSON,87,0,87,0,0,0,0
03/03/2019 11:05,2018,1,WESTERN EUROPE-EU,SWEDEN,1,STANSTED,PAJALA YLLAS,378,0,378,0,0,0,0
03/03/2019 11:05,2018,1,WESTERN EUROPE-EU,SWEDEN,1,STANSTED,STOCKHOLM (ARLANDA),1169,477,692,649,0,649,80.12327
03/03/2019 11:05,2018,1,WESTERN EUROPE-EU,SWEDEN,1,STANSTED,STOCKHOLM (SKAVSTA),256482,256482,0,215172,214918,254,19.19859
03/03/2019 11:05,2018,1,WESTERN EUROPE-EU,SWEDEN,1,STANSTED,VASTERAS,69382,69382,0,71237,71237,0,-2.60398
03/03/2019 11:05,2018,1,WESTERN EUROPE-EU,SWEDEN,2,ABERDEEN,STOCKHOLM (ARLANDA),0,0,0,14,14,0,-100
03/03/2019 11:05,2018,1,WESTERN EUROPE-EU,SWEDEN,2,ABERDEEN,VISBY,0,0,0,262,0,262,-100
03/03/2019 11:05,2018,1,WESTERN EUROPE-EU,SWEDEN,2,BELFAST INTERNATIONAL,LULEA,0,0,0,1,0,1,-100
03/03/2019 11:05,2018,1,WESTERN EUROPE-EU,SWEDEN,2,BELFAST INTERNATIONAL,STOCKHOLM (SKAVSTA),0,0,0,190,0,190,-100
03/03/2019 11:05,2018,1,WESTERN EUROPE-EU,SWEDEN,2,BELFAST INTERNATIONAL,UMEA,0,0,0,1,0,1,-100
03/03/2019 11:05,2018,1,WESTERN EUROPE-EU,SWEDEN,2,BIRMINGHAM,GOTEBORG (LANDVETTER),3054,2896,158,11501,11501,0,-73.44579
03/03/2019 11:05,2018,1,WESTERN EUROPE-EU,SWEDEN,2,BIRMINGHAM,KIRUNA,105,0,105,194,0,194,-45.87629
03/03/2019 11:05,2018,1,WESTERN EUROPE-EU,SWEDEN,2,BIRMINGHAM,PAJALA YLLAS,378,0,378,374,0,374,1.06952
03/03/2019 11:05,2018,1,WESTERN EUROPE-EU,SWEDEN,2,BIRMINGHAM,STOCKHOLM (ARLANDA),2917,2896,21,20018,20018,0,-85.42811
03/03/2019 11:05,2018,1,WESTERN EUROPE-EU,SWEDEN,2,BIRMINGHAM,VAXJO,338,0,338,0,0,0,0
03/03/2019 11:05,2018,1,WESTERN EUROPE-EU,SWEDEN,2,BOURNEMOUTH,KIRUNA,0,0,0,179,0,179,-100
03/03/2019 11:05,2018,1,WESTERN EUROPE-EU,SWEDEN,2,BOURNEMOUTH,PAJALA YLLAS,0,0,0,378,0,378,-100
03/03/2019 11:05,2018,1,WESTERN EUROPE-EU,SWEDEN,2,BOURNEMOUTH,VISBY,0,0,0,320,0,320,-100
03/03/2019 11:05,2018,1,WESTERN EUROPE-EU,SWEDEN,2,BRISTOL,GOTEBORG (LANDVETTER),2211,2211,0,0,0,0,0
03/03/2019 11:05,2018,1,WESTERN EUROPE-EU,SWEDEN,2,BRISTOL,KIRUNA,0,0,0,198,0,198,-100
03/03/2019 11:05,2018,1,WESTERN EUROPE-EU,SWEDEN,2,BRISTOL,OSTERSUND / FROSON,522,522,0,0,0,0,0
03/03/2019 11:05,2018,1,WESTERN EUROPE-EU,SWEDEN,2,BRISTOL,STOCKHOLM (ARLANDA),28885,28885,0,4652,4652,0,520.91574
03/03/2019 11:05,2018,1,WESTERN EUROPE-EU,SWEDEN,2,BRISTOL,VAXJO,310,0,310,0,0,0,0
03/03/2019 11:05,2018,1,WESTERN EUROPE-EU,SWEDEN,2,CAMBRIDGE,GOTEBORG (LANDVETTER),10,10,0,0,0,0,0
03/03/2019 11:05,2018,1,WESTERN EUROPE-EU,SWEDEN,2,CARDIFF WALES,PAJALA YLLAS,374,0,374,379,0,379,-1.31926
03/03/2019 11:05,2018,1,WESTERN EUROPE-EU,SWEDEN,2,CARDIFF WALES,VAXJO,136,0,136,87,0,87,56.32184
03/03/2019 11:05,2018,1,WESTERN EUROPE-EU,SWEDEN,2,DONCASTER SHEFFIELD,KIRUNA,0,0,0,172,0,172,-100
03/03/2019 11:05,2018,1,WESTERN EUROPE-EU,SWEDEN,2,DURHAM TEES VALLEY,PAJALA YLLAS,374,0,374,384,0,384,-2.60417
03/03/2019 11:05,2018,1,WESTERN EUROPE-EU,SWEDEN,2,EAST MIDLANDS INTERNATIONAL,GOTEBORG (LANDVETTER),7,7,0,0,0,0,0
03/03/2019 11:05,2018,1,WESTERN EUROPE-EU,SWEDEN,2,EAST MIDLANDS INTERNATIONAL,KIRUNA,0,0,0,122,0,122,-100
03/03/2019 11:05,2018,1,WESTERN EUROPE-EU,SWEDEN,2,EAST MIDLANDS INTERNATIONAL,STOCKHOLM (ARLANDA),0,0,0,48,0,48,-100
03/03/2019 11:05,2018,1,WESTERN EUROPE-EU,SWEDEN,2,EDINBURGH,GOTEBORG (LANDVETTER),27191,27191,0,22019,22019,0,23.48881
03/03/2019 11:05,2018,1,WESTERN EUROPE-EU,SWEDEN,2,EDINBURGH,STOCKHOLM (ARLANDA),130330,130330,0,113895,113895,0,14.42996
03/03/2019 11:05,2018,1,WESTERN EUROPE-EU,SWEDEN,2,EDINBURGH,STOCKHOLM (SKAVSTA),6522,6522,0,0,0,0,0
03/03/2019 11:05,2018,1,WESTERN EUROPE-EU,SWEDEN,2,EXETER,PAJALA YLLAS,0,0,0,374,0,374,-100
03/03/2019 11:05,2018,1,WESTERN EUROPE-EU,SWEDEN,2,GLASGOW,LULEA,0,0,0,184,0,184,-100
03/03/2019 11:05,2018,1,WESTERN EUROPE-EU,SWEDEN,2,GLASGOW,PAJALA YLLAS,375,0,375,0,0,0,0
03/03/2019 11:05,2018,1,WESTERN EUROPE-EU,SWEDEN,2,GLASGOW,SATENAS,0,0,0,184,0,184,-100
03/03/2019 11:05,2018,1,WESTERN EUROPE-EU,SWEDEN,2,GUERNSEY,VISBY,0,0,0,182,0,182,-100
03/03/2019 11:05,2018,1,WESTERN EUROPE-EU,SWEDEN,2,HUMBERSIDE,KIRUNA,0,0,0,149,0,149,-100
03/03/2019 11:05,2018,1,WESTERN EUROPE-EU,SWEDEN,2,HUMBERSIDE,PAJALA YLLAS,376,0,376,378,0,378,-0.5291
03/03/2019 11:05,2018,1,WESTERN EUROPE-EU,SWEDEN,2,ISLE OF MAN,PAJALA YLLAS,308,0,308,342,0,342,-9.94152
03/03/2019 11:05,2018,1,WESTERN EUROPE-EU,SWEDEN,2,ISLE OF MAN,STOCKHOLM (ARLANDA),201,0,201,231,0,231,-12.98701
03/03/2019 11:05,2018,1,WESTERN EUROPE-EU,SWEDEN,2,ISLE OF MAN,VISBY,0,0,0,436,0,436,-100
03/03/2019 11:05,2018,1,WESTERN EUROPE-EU,SWEDEN,2,JERSEY,VISBY,0,0,0,528,44,484,-100
03/03/2019 11:05,2018,1,WESTERN EUROPE-EU,SWEDEN,2,LEEDS BRADFORD,KIRUNA,0,0,0,64,0,64,-100
03/03/2019 11:05,2018,1,WESTERN EUROPE-EU,SWEDEN,2,LEEDS BRADFORD,PAJALA YLLAS,374,0,374,376,0,376,-0.53191
03/03/2019 11:05,2018,1,WESTERN EUROPE-EU,SWEDEN,2,LEEDS BRADFORD,STOCKHOLM (ARLANDA),37,0,37,0,0,0,0
03/03/2019 11:05,2018,1,WESTERN EUROPE-EU,SWEDEN,2,LIVERPOOL (JOHN LENNON),PAJALA YLLAS,374,0,374,0,0,0,0
03/03/2019 11:05,2018,1,WESTERN EUROPE-EU,SWEDEN,2,LIVERPOOL (JOHN LENNON),STOCKHOLM (ARLANDA),168,168,0,0,0,0,0
03/03/2019 11:05,2018,1,WESTERN EUROPE-EU,SWEDEN,2,MANCHESTER,GOTEBORG (LANDVETTER),2862,2862,0,334,334,0,756.88623
03/03/2019 11:05,2018,1,WESTERN EUROPE-EU,SWEDEN,2,MANCHESTER,KIRUNA,0,0,0,341,0,341,-100
03/03/2019 11:05,2018,1,WESTERN EUROPE-EU,SWEDEN,2,MANCHESTER,STOCKHOLM (ARLANDA),165046,165046,0,187668,182279,5389,-12.05427
03/03/2019 11:05,2018,1,WESTERN EUROPE-EU,SWEDEN,2,MANCHESTER,STOCKHOLM (SKAVSTA),0,0,0,1520,0,1520,-100
03/03/2019 11:05,2018,1,WESTERN EUROPE-EU,SWEDEN,2,NEWCASTLE,KIRUNA,0,0,0,130,47,83,-100
03/03/2019 11:05,2018,1,WESTERN EUROPE-EU,SWEDEN,2,NEWCASTLE,STOCKHOLM (ARLANDA),0,0,0,53,0,53,-100
03/03/2019 11:05,2018,1,WESTERN EUROPE-EU,SWEDEN,2,NEWCASTLE,STOCKHOLM (BROMMA),0,0,0,30,0,30,-100
03/03/2019 11:05,2018,1,WESTERN EUROPE-EU,SWEDEN,2,NORWICH,PAJALA YLLAS,374,0,374,374,374,0,0
03/03/2019 11:05,2018,2,WESTERN EUROPE-OTHER,BOSNIA-HERZEGOVINA,1,LUTON,TUZLA,0,0,0,20159,20159,0,-100
03/03/2019 11:05,2018,2,WESTERN EUROPE-OTHER,BOSNIA-HERZEGOVINA,2,ABERDEEN,MOSTAR,0,0,0,96,0,96,-100
03/03/2019 11:05,2018,2,WESTERN EUROPE-OTHER,BOSNIA-HERZEGOVINA,2,BELFAST INTERNATIONAL,SARAJEVO,197,0,197,0,0,0,0
03/03/2019 11:05,2018,2,WESTERN EUROPE-OTHER,FAROE ISLANDS,2,ABERDEEN,VAGAR,289,0,289,286,0,286,1.04895
03/03/2019 11:05,2018,2,WESTERN EUROPE-OTHER,FAROE ISLANDS,2,CARDIFF WALES,VAGAR,285,0,285,0,0,0,0
03/03/2019 11:05,2018,2,WESTERN EUROPE-OTHER,FAROE ISLANDS,2,EDINBURGH,VAGAR,15236,14749,487,12413,12413,0,22.74229
03/03/2019 11:05,2018,2,WESTERN EUROPE-OTHER,ICELAND,1,GATWICK,EGILSSTADIR,0,0,0,202,0,202,-100
03/03/2019 11:05,2018,2,WESTERN EUROPE-OTHER,ICELAND,1,GATWICK,KEFLAVIK,467058,452688,14370,500157,484654,15503,-6.61772
03/03/2019 11:05,2018,2,WESTERN EUROPE-OTHER,ICELAND,1,HEATHROW,KEFLAVIK,378205,378205,0,351751,351751,0,7.52066
03/03/2019 11:05,2018,2,WESTERN EUROPE-OTHER,ICELAND,1,LONDON CITY,KEFLAVIK,5034,5034,0,2127,2127,0,136.67137
03/03/2019 11:05,2018,2,WESTERN EUROPE-OTHER,ICELAND,1,LUTON,KEFLAVIK,196481,196426,55,147225,147225,0,33.45627
03/03/2019 11:05,2018,2,WESTERN EUROPE-OTHER,ICELAND,1,STANSTED,AKUREYRI,160,0,160,0,0,0,0
03/03/2019 11:05,2018,2,WESTERN EUROPE-OTHER,ICELAND,1,STANSTED,KEFLAVIK,88414,88282,132,25104,25104,0,252.19089
03/03/2019 11:05,2018,2,WESTERN EUROPE-OTHER,ICELAND,2,ABERDEEN,AKUREYRI,0,0,0,142,142,0,-100
03/03/2019 11:05,2018,2,WESTERN EUROPE-OTHER,ICELAND,2,ABERDEEN,KEFLAVIK,3338,3338,0,12491,12491,0,-73.27676
03/03/2019 11:05,2018,2,WESTERN EUROPE-OTHER,ICELAND,2,ABERDEEN,REYKJAVIK,0,0,0,76,0,76,-100
03/03/2019 11:05,2018,2,WESTERN EUROPE-OTHER,ICELAND,2,BELFAST CITY (GEORGE BEST),KEFLAVIK,2447,2447,0,6392,6392,0,-61.71777
03/03/2019 11:05,2018,2,WESTERN EUROPE-OTHER,ICELAND,2,BELFAST INTERNATIONAL,KEFLAVIK,16206,16039,167,15515,15515,0,4.45375
03/03/2019 11:05,2018,2,WESTERN EUROPE-OTHER,ICELAND,2,BIRMINGHAM,KEFLAVIK,1590,1438,152,41731,41731,0,-96.18988
03/03/2019 11:05,2018,2,WESTERN EUROPE-OTHER,ICELAND,2,BOURNEMOUTH,AKUREYRI,648,0,648,0,0,0,0
03/03/2019 11:05,2018,2,WESTERN EUROPE-OTHER,ICELAND,2,BRISTOL,KEFLAVIK,19154,19154,0,41779,41779,0,-54.154
03/03/2019 11:05,2018,2,WESTERN EUROPE-OTHER,ICELAND,2,CARDIFF WALES,AKUREYRI,1061,0,1061,0,0,0,0
03/03/2019 11:05,2018,2,WESTERN EUROPE-OTHER,ICELAND,2,CARDIFF WALES,KEFLAVIK,4,0,4,0,0,0,0
03/03/2019 11:05,2018,2,WESTERN EUROPE-OTHER,ICELAND,2,EAST MIDLANDS INTERNATIONAL,AKUREYRI,96,0,96,0,0,0,0
03/03/2019 11:05,2018,2,WESTERN EUROPE-OTHER,ICELAND,2,EAST MIDLANDS INTERNATIONAL,KEFLAVIK,3799,0,3799,4277,0,4277,-11.17606
03/03/2019 11:05,2018,2,WESTERN EUROPE-OTHER,ICELAND,2,EDINBURGH,AKUREYRI,395,162,233,363,0,363,8.81543
03/03/2019 11:05,2018,2,WESTERN EUROPE-OTHER,ICELAND,2,EDINBURGH,KEFLAVIK,101889,101837,52,108636,108636,0,-6.21065
03/03/2019 11:05,2018,2,WESTERN EUROPE-OTHER,ICELAND,2,EXETER,AKUREYRI,615,0,615,0,0,0,0
03/03/2019 11:05,2018,2,WESTERN EUROPE-OTHER,ICELAND,2,GLASGOW,EGILSSTADIR,338,0,338,0,0,0,0
03/03/2019 11:05,2018,2,WESTERN EUROPE-OTHER,ICELAND,2,GLASGOW,KEFLAVIK,107299,107247,52,105901,105901,0,1.3201
03/03/2019 11:05,2018,2,WESTERN EUROPE-OTHER,ICELAND,2,HUMBERSIDE,AKUREYRI,669,0,669,0,0,0,0
03/03/2019 11:05,2018,2,WESTERN EUROPE-OTHER,ICELAND,2,HUMBERSIDE,KEFLAVIK,93,0,93,0,0,0,0
03/03/2019 11:05,2018,2,WESTERN EUROPE-OTHER,ICELAND,2,LEEDS BRADFORD,AKUREYRI,508,0,508,0,0,0,0
03/03/2019 11:05,2018,2,WESTERN EUROPE-OTHER,ICELAND,2,LIVERPOOL (JOHN LENNON),AKUREYRI,479,0,479,372,0,372,28.76344
03/03/2019 11:05,2018,2,WESTERN EUROPE-OTHER,ICELAND,2,LIVERPOOL (JOHN LENNON),KEFLAVIK,170,170,0,0,0,0,0
03/03/2019 11:05,2018,2,WESTERN EUROPE-OTHER,ICELAND,2,MANCHESTER,AKUREYRI,233,0,233,0,0,0,0
03/03/2019 11:05,2018,2,WESTERN EUROPE-OTHER,ICELAND,2,MANCHESTER,EGILSSTADIR,249,0,249,392,197,195,-36.47959
03/03/2019 11:05,2018,2,WESTERN EUROPE-OTHER,ICELAND,2,MANCHESTER,KEFLAVIK,203385,189290,14095,192909,177354,15555,5.43054
03/03/2019 11:05,2018,2,WESTERN EUROPE-OTHER,ICELAND,2,NEWCASTLE,AKUREYRI,364,364,0,0,0,0,0
03/03/2019 11:05,2018,2,WESTERN EUROPE-OTHER,ICELAND,2,NEWCASTLE,KEFLAVIK,0,0,0,142,0,142,-100
03/03/2019 11:05,2018,2,WESTERN EUROPE-OTHER,ICELAND,2,NEWCASTLE,REYKJAVIK,145,0,145,0,0,0,0
03/03/2019 11:05,2018,2,WESTERN EUROPE-OTHER,ICELAND,2,NORWICH,AKUREYRI,511,0,511,0,0,0,0
03/03/2019 11:05,2018,2,WESTERN EUROPE-OTHER,ICELAND,2,NORWICH,KEFLAVIK,224,0,224,0,0,0,0
03/03/2019 11:05,2018,2,WESTERN EUROPE-OTHER,KOSOVO,1,GATWICK,PRISTINA,430,430,0,20946,20946,0,-97.9471
03/03/2019 11:05,2018,2,WESTERN EUROPE-OTHER,KOSOVO,1,LUTON,PRISTINA,55944,55944,0,18208,18208,0,207.24956
03/03/2019 11:05,2018,2,WESTERN EUROPE-OTHER,MACEDONIA,1,GATWICK,SKOPJE,1,1,0,0,0,0,0
03/03/2019 11:05,2018,2,WESTERN EUROPE-OTHER,MACEDONIA,1,LUTON,OHRID,17087,17087,0,19709,19709,0,-13.30357
03/03/2019 11:05,2018,2,WESTERN EUROPE-OTHER,MACEDONIA,1,LUTON,SKOPJE,67868,67868,0,69252,69252,0,-1.9985
03/03/2019 11:05,2018,2,WESTERN EUROPE-OTHER,MACEDONIA,2,DONCASTER SHEFFIELD,SKOPJE,0,0,0,165,165,0,-100
03/03/2019 11:05,2018,2,WESTERN EUROPE-OTHER,MACEDONIA,2,GLASGOW,SKOPJE,188,0,188,0,0,0,0
03/03/2019 11:05,2018,2,WESTERN EUROPE-OTHER,MACEDONIA,2,LIVERPOOL (JOHN LENNON),SKOPJE,0,0,0,370,0,370,-100
03/03/2019 11:05,2018,2,WESTERN EUROPE-OTHER,MACEDONIA,2,MANCHESTER,SKOPJE,186,186,0,511,0,511,-63.60078
03/03/2019 11:05,2018,2,WESTERN EUROPE-OTHER,NORWAY,1,GATWICK,ANDENES,1,0,1,0,0,0,0
03/03/2019 11:05,2018,2,WESTERN EUROPE-OTHER,NORWAY,1,GATWICK,BERGEN,210922,209419,1503,199362,198047,1315,5.7985
03/03/2019 11:05,2018,2,WESTERN EUROPE-OTHER,NORWAY,1,GATWICK,EVENES,0,0,0,584,0,584,-100
03/03/2019 11:05,2018,2,WESTERN EUROPE-OTHER,NORWAY,1,GATWICK,FAGERNES/LEIRIN,1730,0,1730,3196,0,3196,-45.86984
03/03/2019 11:05,2018,2,WESTERN EUROPE-OTHER,NORWAY,1,GATWICK,HAUGESUND,0,0,0,2125,0,2125,-100
03/03/2019 11:05,2018,2,WESTERN EUROPE-OTHER,NORWAY,1,GATWICK,OSLO (GARDERMOEN),458875,458529,346,413419,413167,252,10.99514
03/03/2019 11:05,2018,2,WESTERN EUROPE-OTHER,NORWAY,1,GATWICK,STAVANGER,108200,107843,357,97138,97138,0,11.38792
03/03/2019 11:05,2018,2,WESTERN EUROPE-OTHER,NORWAY,1,GATWICK,TROMSOE,23477,22365,1112,20602,19238,1364,13.95496
03/03/2019 11:05,2018,2,WESTERN EUROPE-OTHER,NORWAY,1,GATWICK,TRONDHEIM (VAERNES),64382,64382,0,66893,66893,0,-3.75376
03/03/2019 11:05,2018,2,WESTERN EUROPE-OTHER,NORWAY,1,HEATHROW,BERGEN,0,0,0,71736,71736,0,-100
03/03/2019 11:05,2018,2,WESTERN EUROPE-OTHER,NORWAY,1,HEATHROW,OSLO (GARDERMOEN),668983,668983,0,679409,679409,0,-1.53457
03/03/2019 11:05,2018,2,WESTERN EUROPE-OTHER,NORWAY,1,HEATHROW,STAVANGER,98250,98250,0,148714,148714,0,-33.93359
03/03/2019 11:05,2018,2,WESTERN EUROPE-OTHER,NORWAY,1,LUTON,TROMSOE,1586,1586,0,0,0,0,0
03/03/2019 11:05,2018,2,WESTERN EUROPE-OTHER,NORWAY,1,STANSTED,BERGEN,0,0,0,110,0,110,-100
03/03/2019 11:05,2018,2,WESTERN EUROPE-OTHER,NORWAY,1,STANSTED,KRISTIANSAND (KJEVIK),7637,7637,0,0,0,0,0
03/03/2019 11:05,2018,2,WESTERN EUROPE-OTHER,NORWAY,1,STANSTED,OSLO (GARDERMOEN),307973,307973,0,293578,293578,0,4.9033
03/03/2019 11:05,2018,2,WESTERN EUROPE-OTHER,NORWAY,1,STANSTED,RYGGE,135,135,0,0,0,0,0
03/03/2019 11:05,2018,2,WESTERN EUROPE-OTHER,NORWAY,1,STANSTED,SANDEFJORD(TORP),56510,56510,0,48918,48918,0,15.51985
03/03/2019 11:05,2018,2,WESTERN EUROPE-OTHER,NORWAY,1,STANSTED,TROMSOE,80,0,80,0,0,0,0
03/03/2019 11:05,2018,2,WESTERN EUROPE-OTHER,NORWAY,2,ABERDEEN,ALESUND,21,21,0,0,0,0,0
03/03/2019 11:05,2018,2,WESTERN EUROPE-OTHER,NORWAY,2,ABERDEEN,BERGEN,43068,42914,154,39137,39084,53,10.0442
03/03/2019 11:05,2018,2,WESTERN EUROPE-OTHER,NORWAY,2,ABERDEEN,HAUGESUND,33,0,33,0,0,0,0
03/03/2019 11:05,2018,2,WESTERN EUROPE-OTHER,NORWAY,2,ABERDEEN,OSLO (GARDERMOEN),29122,29122,0,29956,29956,0,-2.78408
03/03/2019 11:05,2018,2,WESTERN EUROPE-OTHER,NORWAY,2,ABERDEEN,STAVANGER,96135,96135,0,93021,92950,71,3.34763
03/03/2019 11:05,2018,2,WESTERN EUROPE-OTHER,NORWAY,2,BELFAST INTERNATIONAL,HAUGESUND,0,0,0,274,0,274,-100
03/03/2019 11:05,2018,2,WESTERN EUROPE-OTHER,NORWAY,2,BELFAST INTERNATIONAL,OSLO (GARDERMOEN),0,0,0,209,0,209,-100
03/03/2019 11:05,2018,2,WESTERN EUROPE-OTHER,NORWAY,2,BELFAST INTERNATIONAL,SANDEFJORD(TORP),0,0,0,129,0,129,-100
03/03/2019 11:05,2018,2,WESTERN EUROPE-OTHER,NORWAY,2,BIRMINGHAM,ALESUND,54,0,54,30,0,30,80
03/03/2019 11:05,2018,2,WESTERN EUROPE-OTHER,NORWAY,2,BIRMINGHAM,BERGEN,561,0,561,290,0,290,93.44828
03/03/2019 11:05,2018,2,WESTERN EUROPE-OTHER,NORWAY,2,BIRMINGHAM,MOLDE,0,0,0,31,0,31,-100
03/03/2019 11:05,2018,2,WESTERN EUROPE-OTHER,NORWAY,2,BIRMINGHAM,TROMSOE,139,139,0,0,0,0,0
03/03/2019 11:05,2018,2,WESTERN EUROPE-OTHER,NORWAY,2,BOURNEMOUTH,BERGEN,147,0,147,438,0,438,-66.43836
03/03/2019 11:05,2018,2,WESTERN EUROPE-OTHER,NORWAY,2,BOURNEMOUTH,TROMSOE,232,0,232,442,0,442,-47.51131
03/03/2019 11:05,2018,2,WESTERN EUROPE-OTHER,NORWAY,2,BRISTOL,BERGEN,618,0,618,551,0,551,12.15971
03/03/2019 11:05,2018,2,WESTERN EUROPE-OTHER,NORWAY,2,BRISTOL,LONGYEARBYEN (SVALBARD),60,0,60,0,0,0,0
03/03/2019 11:05,2018,2,WESTERN EUROPE-OTHER,NORWAY,2,BRISTOL,TROMSOE,292,0,292,358,0,358,-18.43575
03/03/2019 11:05,2018,2,WESTERN EUROPE-OTHER,NORWAY,2,CARDIFF WALES,BERGEN,278,0,278,0,0,0,0
03/03/2019 11:05,2018,2,WESTERN EUROPE-OTHER,NORWAY,2,CARDIFF WALES,LONGYEARBYEN (SVALBARD),57,0,57,0,0,0,0
03/03/2019 11:05,2018,2,WESTERN EUROPE-OTHER,NORWAY,2,CARDIFF WALES,MOLDE,0,0,0,178,178,0,-100
03/03/2019 11:05,2018,2,WESTERN EUROPE-OTHER,NORWAY,2,CARDIFF WALES,OSLO (GARDERMOEN),4,0,4,0,0,0,0
03/03/2019 11:05,2018,2,WESTERN EUROPE-OTHER,NORWAY,2,CARDIFF WALES,TROMSOE,0,0,0,168,0,168,-100
03/03/2019 11:05,2018,2,WESTERN EUROPE-OTHER,NORWAY,2,EAST MIDLANDS INTERNATIONAL,TROMSOE,287,0,287,257,0,257,11.67315
03/03/2019 11:05,2018,2,WESTERN EUROPE-OTHER,NORWAY,2,EDINBURGH,BERGEN,1139,1139,0,2072,1678,394,-45.02896
03/03/2019 11:05,2018,2,WESTERN EUROPE-OTHER,NORWAY,2,EDINBURGH,BODO,0,0,0,374,0,374,-100
03/03/2019 11:05,2018,2,WESTERN EUROPE-OTHER,NORWAY,2,EDINBURGH,KRISTIANSAND (KJEVIK),194,0,194,0,0,0,0
03/03/2019 11:05,2018,2,WESTERN EUROPE-OTHER,NORWAY,2,EDINBURGH,MOLDE,506,0,506,0,0,0,0
03/03/2019 11:05,2018,2,WESTERN EUROPE-OTHER,NORWAY,2,EDINBURGH,OSLO (GARDERMOEN),119418,119257,161,105258,103997,1261,13.45266
03/03/2019 11:05,2018,2,WESTERN EUROPE-OTHER,NORWAY,2,EDINBURGH,TRONDHEIM (VAERNES),202,0,202,0,0,0,0
03/03/2019 11:05,2018,2,WESTERN EUROPE-OTHER,NORWAY,2,EXETER,BARDUFOSS,82,0,82,0,0,0,0
03/03/2019 11:05,2018,2,WESTERN EUROPE-OTHER,NORWAY,2,GLASGOW,BERGEN,2060,1622,438,1558,1358,200,32.2208
03/03/2019 11:05,2018,2,WESTERN EUROPE-OTHER,NORWAY,2,GLASGOW,OSLO (GARDERMOEN),20,20,0,0,0,0,0
03/03/2019 11:05,2018,2,WESTERN EUROPE-OTHER,NORWAY,2,GLASGOW,STAVANGER,0,0,0,73,73,0,-100
03/03/2019 11:05,2018,2,WESTERN EUROPE-OTHER,NORWAY,2,GLASGOW,TRONDHEIM (VAERNES),1041,0,1041,484,0,484,115.08264
03/03/2019 11:05,2018,2,WESTERN EUROPE-OTHER,NORWAY,2,HUMBERSIDE,BERGEN,0,0,0,36,0,36,-100
03/03/2019 11:05,2018,2,WESTERN EUROPE-OTHER,NORWAY,2,INVERNESS,BERGEN,3078,3078,0,0,0,0,0
03/03/2019 11:05,2018,2,WESTERN EUROPE-OTHER,NORWAY,2,KIRKWALL,BERGEN,410,410,0,505,505,0,-18.81188
03/03/2019 11:05,2018,2,WESTERN EUROPE-OTHER,NORWAY,2,LEEDS BRADFORD,BERGEN,276,0,276,0,0,0,0
03/03/2019 11:05,2018,2,WESTERN EUROPE-OTHER,NORWAY,2,LIVERPOOL (JOHN LENNON),ALESUND,0,0,0,140,0,140,-100
03/03/2019 11:05,2018,2,WESTERN EUROPE-OTHER,NORWAY,2,LIVERPOOL (JOHN LENNON),BERGEN,2878,2878,0,0,0,0,0
03/03/2019 11:05,2018,2,WESTERN EUROPE-OTHER,NORWAY,2,LIVERPOOL (JOHN LENNON),OSLO (GARDERMOEN),1955,0,1955,737,0,737,165.26459
03/03/2019 11:05,2018,2,WESTERN EUROPE-OTHER,NORWAY,2,LIVERPOOL (JOHN LENNON),STAVANGER,621,0,621,468,156,312,32.69231
03/03/2019 11:05,2018,2,WESTERN EUROPE-OTHER,NORWAY,2,MANCHESTER,BERGEN,19432,17685,1747,13351,11647,1704,45.54715
03/03/2019 11:05,2018,2,WESTERN EUROPE-OTHER,NORWAY,2,MANCHESTER,OSLO (GARDERMOEN),139770,139770,0,122364,121895,469,14.22477
03/03/2019 11:05,2018,2,WESTERN EUROPE-OTHER,NORWAY,2,MANCHESTER,SANDEFJORD(TORP),68488,68488,0,59160,59160,0,15.76741
03/03/2019 11:05,2018,2,WESTERN EUROPE-OTHER,NORWAY,2,MANCHESTER,STAVANGER,24720,24720,0,20394,20394,0,21.21212
03/03/2019 11:05,2018,2,WESTERN EUROPE-OTHER,NORWAY,2,MANCHESTER,TROMSOE,676,0,676,772,0,772,-12.43523
03/03/2019 11:05,2018,2,WESTERN EUROPE-OTHER,NORWAY,2,NEWCASTLE,BERGEN,266,0,266,514,0,514,-48.24903
03/03/2019 11:05,2018,2,WESTERN EUROPE-OTHER,NORWAY,2,NEWCASTLE,STAVANGER,11232,11232,0,10004,10004,0,12.27509
03/03/2019 11:05,2018,2,WESTERN EUROPE-OTHER,NORWAY,2,NEWCASTLE,TROMSOE,0,0,0,288,0,288,-100
03/03/2019 11:05,2018,2,WESTERN EUROPE-OTHER,NORWAY,2,NORWICH,TROMSOE,288,0,288,0,0,0,0
03/03/2019 11:05,2018,2,WESTERN EUROPE-OTHER,NORWAY,2,PRESTWICK,BARDUFOSS,66,0,66,0,0,0,0
03/03/2019 11:05,2018,2,WESTERN EUROPE-OTHER,NORWAY,2,PRESTWICK,EVENES,0,0,0,82,0,82,-100
03/03/2019 11:05,2018,2,WESTERN EUROPE-OTHER,NORWAY,2,PRESTWICK,OSLO (GARDERMOEN),70,0,70,0,0,0,0
03/03/2019 11:05,2018,2,WESTERN EUROPE-OTHER,NORWAY,2,SUMBURGH,BERGEN,1367,1367,0,1374,1374,0,-0.50946
03/03/2019 11:05,2018,2,WESTERN EUROPE-OTHER,REPUBLIC OF MONTENEGRO,1,GATWICK,PODGORICA,12408,0,12408,0,0,0,0
03/03/2019 11:05,2018,2,WESTERN EUROPE-OTHER,REPUBLIC OF MONTENEGRO,1,GATWICK,TIVAT,33153,33153,0,33051,33051,0,0.30861
03/03/2019 11:05,2018,2,WESTERN EUROPE-OTHER,REPUBLIC OF MONTENEGRO,1,LUTON,TIVAT,0,0,0,264,0,264,-100
03/03/2019 11:05,2018,2,WESTERN EUROPE-OTHER,REPUBLIC OF MONTENEGRO,1,STANSTED,PODGORICA,36291,36291,0,36738,36738,0,-1.21672
03/03/2019 11:05,2018,2,WESTERN EUROPE-OTHER,REPUBLIC OF MONTENEGRO,1,STANSTED,TIVAT,1625,1625,0,0,0,0,0
03/03/2019 11:05,2018,2,WESTERN EUROPE-OTHER,REPUBLIC OF MONTENEGRO,2,BIRMINGHAM,PODGORICA,5718,0,5718,0,0,0,0
03/03/2019 11:05,2018,2,WESTERN EUROPE-OTHER,REPUBLIC OF MONTENEGRO,2,MANCHESTER,PODGORICA,6460,0,6460,0,0,0,0
03/03/2019 11:05,2018,2,WESTERN EUROPE-OTHER,REPUBLIC OF MONTENEGRO,2,MANCHESTER,TIVAT,19206,19206,0,20021,20021,0,-4.07073
03/03/2019 11:05,2018,2,WESTERN EUROPE-OTHER,REPUBLIC OF SERBIA,1,HEATHROW,BELGRADE,93419,93419,0,92447,92447,0,1.05141
03/03/2019 11:05,2018,2,WESTERN EUROPE-OTHER,REPUBLIC OF SERBIA,1,LUTON,BELGRADE,51608,51346,262,47208,47103,105,9.32045
03/03/2019 11:05,2018,2,WESTERN EUROPE-OTHER,REPUBLIC OF SERBIA,1,STANSTED,BELGRADE,0,0,0,100,0,100,-100
03/03/2019 11:05,2018,2,WESTERN EUROPE-OTHER,REPUBLIC OF SERBIA,2,CARDIFF WALES,BELGRADE,0,0,0,143,0,143,-100
03/03/2019 11:05,2018,2,WESTERN EUROPE-OTHER,REPUBLIC OF SERBIA,2,LIVERPOOL (JOHN LENNON),BELGRADE,568,0,568,0,0,0,0
03/03/2019 11:05,2018,2,WESTERN EUROPE-OTHER,REPUBLIC OF SERBIA,2,MANCHESTER,BELGRADE,648,0,648,0,0,0,0
03/03/2019 11:05,2018,2,WESTERN EUROPE-OTHER,SWITZERLAND,1,GATWICK,ALTENRHEIN,43,0,43,0,0,0,0
03/03/2019 11:05,2018,2,WESTERN EUROPE-OTHER,SWITZERLAND,1,GATWICK,BALE MULHOUSE,286579,286579,0,278401,278400,1,2.93749
03/03/2019 11:05,2018,2,WESTERN EUROPE-OTHER,SWITZERLAND,1,GATWICK,GENEVA,828602,798350,30252,854140,826127,28013,-2.98991
03/03/2019 11:05,2018,2,WESTERN EUROPE-OTHER,SWITZERLAND,1,GATWICK,ZURICH,158771,158505,266,164837,164828,9,-3.68
03/03/2019 11:05,2018,2,WESTERN EUROPE-OTHER,SWITZERLAND,1,HEATHROW,BALE MULHOUSE,280223,280223,0,257324,257324,0,8.8989
03/03/2019 11:05,2018,2,WESTERN EUROPE-OTHER,SWITZERLAND,1,HEATHROW,GENEVA,1056453,1056453,0,1056478,1052445,4033,-0.00237
03/03/2019 11:05,2018,2,WESTERN EUROPE-OTHER,SWITZERLAND,1,HEATHROW,SION,1121,1121,0,475,475,0,136
03/03/2019 11:05,2018,2,WESTERN EUROPE-OTHER,SWITZERLAND,1,HEATHROW,ZURICH,1167980,1167388,592,1139638,1139271,367,2.48693
03/03/2019 11:05,2018,2,WESTERN EUROPE-OTHER,SWITZERLAND,1,LONDON CITY,BALE MULHOUSE,0,0,0,15977,15977,0,-100
03/03/2019 11:05,2018,2,WESTERN EUROPE-OTHER,SWITZERLAND,1,LONDON CITY,BERNE,7197,7197,0,10761,10761,0,-33.1196
03/03/2019 11:05,2018,2,WESTERN EUROPE-OTHER,SWITZERLAND,1,LONDON CITY,GENEVA,196756,196756,0,195443,195443,0,0.67181
03/03/2019 11:05,2018,2,WESTERN EUROPE-OTHER,SWITZERLAND,1,LONDON CITY,SION,97,97,0,0,0,0,0
03/03/2019 11:05,2018,2,WESTERN EUROPE-OTHER,SWITZERLAND,1,LONDON CITY,ZURICH,422734,422734,0,402817,402817,0,4.94443
03/03/2019 11:05,2018,2,WESTERN EUROPE-OTHER,SWITZERLAND,1,LUTON,BALE MULHOUSE,85937,85937,0,81815,81815,0,5.0382
03/03/2019 11:05,2018,2,WESTERN EUROPE-OTHER,SWITZERLAND,1,LUTON,GENEVA,317049,317049,0,293862,293860,2,7.89044
03/03/2019 11:05,2018,2,WESTERN EUROPE-OTHER,SWITZERLAND,1,LUTON,ZURICH,176957,176957,0,174574,174514,60,1.36504
03/03/2019 11:05,2018,2,WESTERN EUROPE-OTHER,SWITZERLAND,1,SOUTHEND,BALE MULHOUSE,0,0,0,41,41,0,-100
03/03/2019 11:05,2018,2,WESTERN EUROPE-OTHER,SWITZERLAND,1,SOUTHEND,GENEVA,31321,31321,0,32306,32306,0,-3.04897
03/03/2019 11:05,2018,2,WESTERN EUROPE-OTHER,SWITZERLAND,1,STANSTED,BALE MULHOUSE,88673,88673,0,103155,103019,136,-14.03907
03/03/2019 11:05,2018,2,WESTERN EUROPE-OTHER,SWITZERLAND,1,STANSTED,BERNE,0,0,0,156,0,156,-100
03/03/2019 11:05,2018,2,WESTERN EUROPE-OTHER,SWITZERLAND,1,STANSTED,GENEVA,88800,88800,0,69614,66465,3149,27.56055
03/03/2019 11:05,2018,2,WESTERN EUROPE-OTHER,SWITZERLAND,1,STANSTED,ZURICH,1062,61,1001,257,257,0,313.22957
03/03/2019 11:05,2018,2,WESTERN EUROPE-OTHER,SWITZERLAND,2,ABERDEEN,GENEVA,7877,7877,0,6384,6384,0,23.38659
03/03/2019 11:05,2018,2,WESTERN EUROPE-OTHER,SWITZERLAND,2,BELFAST INTERNATIONAL,BALE MULHOUSE,0,0,0,745,0,745,-100
03/03/2019 11:05,2018,2,WESTERN EUROPE-OTHER,SWITZERLAND,2,BELFAST INTERNATIONAL,GENEVA,21238,21238,0,20063,20063,0,5.85655
03/03/2019 11:05,2018,2,WESTERN EUROPE-OTHER,SWITZERLAND,2,BELFAST INTERNATIONAL,ZURICH,0,0,0,216,0,216,-100
03/03/2019 11:05,2018,2,WESTERN EUROPE-OTHER,SWITZERLAND,2,BIRMINGHAM,BALE MULHOUSE,143,143,0,66,66,0,116.66667
03/03/2019 11:05,2018,2,WESTERN EUROPE-OTHER,SWITZERLAND,2,BIRMINGHAM,GENEVA,114898,109853,5045,84027,80308,3719,36.73938
03/03/2019 11:05,2018,2,WESTERN EUROPE-OTHER,SWITZERLAND,2,BIRMINGHAM,ZURICH,103561,103332,229,97465,97465,0,6.25455
03/03/2019 11:05,2018,2,WESTERN EUROPE-OTHER,SWITZERLAND,2,BOURNEMOUTH,GENEVA,28656,28606,50,33605,33605,0,-14.72698
03/03/2019 11:05,2018,2,WESTERN EUROPE-OTHER,SWITZERLAND,2,BRISTOL,BALE MULHOUSE,50349,50131,218,50537,50537,0,-0.372
03/03/2019 11:05,2018,2,WESTERN EUROPE-OTHER,SWITZERLAND,2,BRISTOL,GENEVA,220956,212354,8602,232800,226534,6266,-5.08763
03/03/2019 11:05,2018,2,WESTERN EUROPE-OTHER,SWITZERLAND,2,BRISTOL,ZURICH,324,0,324,0,0,0,0
03/03/2019 11:05,2018,2,WESTERN EUROPE-OTHER,SWITZERLAND,2,CARDIFF WALES,ALTENRHEIN,0,0,0,45,0,45,-100
03/03/2019 11:05,2018,2,WESTERN EUROPE-OTHER,SWITZERLAND,2,CARDIFF WALES,BALE MULHOUSE,43,0,43,0,0,0,0
03/03/2019 11:05,2018,2,WESTERN EUROPE-OTHER,SWITZERLAND,2,CARDIFF WALES,GENEVA,3213,3213,0,3726,3683,43,-13.76812
03/03/2019 11:05,2018,2,WESTERN EUROPE-OTHER,SWITZERLAND,2,CARDIFF WALES,ZURICH,0,0,0,128,128,0,-100
03/03/2019 11:05,2018,2,WESTERN EUROPE-OTHER,SWITZERLAND,2,EAST MIDLANDS INTERNATIONAL,BALE MULHOUSE,0,0,0,41,0,41,-100
03/03/2019 11:05,2018,2,WESTERN EUROPE-OTHER,SWITZERLAND,2,EAST MIDLANDS INTERNATIONAL,BERNE,20,0,20,0,0,0,0
03/03/2019 11:05,2018,2,WESTERN EUROPE-OTHER,SWITZERLAND,2,EAST MIDLANDS INTERNATIONAL,GENEVA,10867,10775,92,17644,17462,182,-38.40966
03/03/2019 11:05,2018,2,WESTERN EUROPE-OTHER,SWITZERLAND,2,EAST MIDLANDS INTERNATIONAL,ZURICH,0,0,0,17,0,17,-100
03/03/2019 11:05,2018,2,WESTERN EUROPE-OTHER,SWITZERLAND,2,EDINBURGH,BALE MULHOUSE,104473,104473,0,107641,107641,0,-2.94312
03/03/2019 11:05,2018,2,WESTERN EUROPE-OTHER,SWITZERLAND,2,EDINBURGH,GENEVA,188379,183920,4459,193486,188757,4729,-2.63947
03/03/2019 11:05,2018,2,WESTERN EUROPE-OTHER,SWITZERLAND,2,EDINBURGH,ZURICH,38054,36187,1867,21845,20267,1578,74.20005
03/03/2019 11:05,2018,2,WESTERN EUROPE-OTHER,SWITZERLAND,2,EXETER,BALE MULHOUSE,0,0,0,68,68,0,-100
03/03/2019 11:05,2018,2,WESTERN EUROPE-OTHER,SWITZERLAND,2,EXETER,GENEVA,2323,2323,0,4205,4205,0,-44.75624
03/03/2019 11:05,2018,2,WESTERN EUROPE-OTHER,SWITZERLAND,2,GLASGOW,GENEVA,14960,14960,0,20694,20694,0,-27.70851
03/03/2019 11:05,2018,2,WESTERN EUROPE-OTHER,SWITZERLAND,2,GLASGOW,ZURICH,0,0,0,22,0,22,-100
03/03/2019 11:05,2018,2,WESTERN EUROPE-OTHER,SWITZERLAND,2,GUERNSEY,GENEVA,0,0,0,90,0,90,-100
03/03/2019 11:05,2018,2,WESTERN EUROPE-OTHER,SWITZERLAND,2,GUERNSEY,ZURICH,510,510,0,339,0,339,50.44248
03/03/2019 11:05,2018,2,WESTERN EUROPE-OTHER,SWITZERLAND,2,INVERNESS,GENEVA,0,0,0,2751,2751,0,-100
03/03/2019 11:05,2018,2,WESTERN EUROPE-OTHER,SWITZERLAND,2,ISLE OF MAN,GENEVA,2186,338,1848,1872,675,1197,16.7735
03/03/2019 11:05,2018,2,WESTERN EUROPE-OTHER,SWITZERLAND,2,ISLE OF MAN,ZURICH,24,0,24,0,0,0,0
03/03/2019 11:05,2018,2,WESTERN EUROPE-OTHER,SWITZERLAND,2,JERSEY,BALE MULHOUSE,107,0,107,853,853,0,-87.45604
03/03/2019 11:05,2018,2,WESTERN EUROPE-OTHER,SWITZERLAND,2,JERSEY,BERNE,1225,1225,0,884,884,0,38.57466
03/03/2019 11:05,2018,2,WESTERN EUROPE-OTHER,SWITZERLAND,2,JERSEY,GENEVA,2179,2179,0,2327,2327,0,-6.36012
03/03/2019 11:05,2018,2,WESTERN EUROPE-OTHER,SWITZERLAND,2,JERSEY,ZURICH,834,747,87,515,515,0,61.94175
03/03/2019 11:05,2018,2,WESTERN EUROPE-OTHER,SWITZERLAND,2,LEEDS BRADFORD,GENEVA,31912,31912,0,39034,39034,0,-18.24563
03/03/2019 11:05,2018,2,WESTERN EUROPE-OTHER,SWITZERLAND,2,LIVERPOOL (JOHN LENNON),BERNE,27,0,27,0,0,0,0
03/03/2019 11:05,2018,2,WESTERN EUROPE-OTHER,SWITZERLAND,2,LIVERPOOL (JOHN LENNON),GENEVA,124449,124390,59,121702,121702,0,2.25715
03/03/2019 11:05,2018,2,WESTERN EUROPE-OTHER,SWITZERLAND,2,LIVERPOOL (JOHN LENNON),SION,0,0,0,30,0,30,-100
03/03/2019 11:05,2018,2,WESTERN EUROPE-OTHER,SWITZERLAND,2,LIVERPOOL (JOHN LENNON),ZURICH,0,0,0,67,67,0,-100
03/03/2019 11:05,2018,2,WESTERN EUROPE-OTHER,SWITZERLAND,2,MANCHESTER,BALE MULHOUSE,97636,96208,1428,91213,90208,1005,7.04176
03/03/2019 11:05,2018,2,WESTERN EUROPE-OTHER,SWITZERLAND,2,MANCHESTER,BERNE,736,0,736,0,0,0,0
03/03/2019 11:05,2018,2,WESTERN EUROPE-OTHER,SWITZERLAND,2,MANCHESTER,GENEVA,280917,271694,9223,277533,270297,7236,1.21931
03/03/2019 11:05,2018,2,WESTERN EUROPE-OTHER,SWITZERLAND,2,MANCHESTER,ZURICH,140511,140078,433,132151,132151,0,6.3261
03/03/2019 11:05,2018,2,WESTERN EUROPE-OTHER,SWITZERLAND,2,NEWCASTLE,GENEVA,59330,58937,393,56850,56736,114,4.36236
03/03/2019 11:05,2018,2,WESTERN EUROPE-OTHER,SWITZERLAND,2,NORWICH,GENEVA,0,0,0,23,0,23,-100
03/03/2019 11:05,2018,2,WESTERN EUROPE-OTHER,SWITZERLAND,2,SOUTHAMPTON,GENEVA,19970,19920,50,8402,8356,46,137.6815
03/03/2019 11:05,2018,2,WESTERN EUROPE-OTHER,TURKEY,1,GATWICK,ANKARA (ESENBOGA),10,0,10,9,0,9,11.11111
03/03/2019 11:05,2018,2,WESTERN EUROPE-OTHER,TURKEY,1,GATWICK,ANTALYA,318113,239708,78405,225771,182272,43499,40.90074
03/03/2019 11:05,2018,2,WESTERN EUROPE-OTHER,TURKEY,1,GATWICK,BODRUM (MILAS),99937,83915,16022,97261,80827,16434,2.75136
03/03/2019 11:05,2018,2,WESTERN EUROPE-OTHER,TURKEY,1,GATWICK,DALAMAN,339519,281723,57796,293926,261725,32201,15.51173
03/03/2019 11:05,2018,2,WESTERN EUROPE-OTHER,TURKEY,1,GATWICK,ISTANBUL,228777,228777,0,213718,213718,0,7.0462
03/03/2019 11:05,2018,2,WESTERN EUROPE-OTHER,TURKEY,1,GATWICK,ISTANBUL (SABIHA GOKCEN),81237,81237,0,87640,87640,0,-7.30602
03/03/2019 11:05,2018,2,WESTERN EUROPE-OTHER,TURKEY,1,GATWICK,IZMIR (ADNAN MENDERES),57277,47102,10175,54436,45104,9332,5.21897
03/03/2019 11:05,2018,2,WESTERN EUROPE-OTHER,TURKEY,1,HEATHROW,ISTANBUL,1074397,1074397,0,1021532,1021532,0,5.17507
03/03/2019 11:05,2018,2,WESTERN EUROPE-OTHER,TURKEY,1,HEATHROW,ISTANBUL (SABIHA GOKCEN),151,151,0,0,0,0,0
03/03/2019 11:05,2018,2,WESTERN EUROPE-OTHER,TURKEY,1,LUTON,ANKARA (ESENBOGA),8755,8755,0,0,0,0,0
03/03/2019 11:05,2018,2,WESTERN EUROPE-OTHER,TURKEY,1,LUTON,ANTALYA,57367,52383,4984,24044,20476,3568,138.59175
03/03/2019 11:05,2018,2,WESTERN EUROPE-OTHER,TURKEY,1,LUTON,BODRUM (MILAS),31078,31078,0,18414,18414,0,68.77376
03/03/2019 11:05,2018,2,WESTERN EUROPE-OTHER,TURKEY,1,LUTON,DALAMAN,48439,41353,7086,23813,23059,754,103.4141
03/03/2019 11:05,2018,2,WESTERN EUROPE-OTHER,TURKEY,1,LUTON,GAZIANTEP,2964,2964,0,0,0,0,0
03/03/2019 11:05,2018,2,WESTERN EUROPE-OTHER,TURKEY,1,LUTON,IZMIR (ADNAN MENDERES),10010,10010,0,10640,10640,0,-5.92105
03/03/2019 11:05,2018,2,WESTERN EUROPE-OTHER,TURKEY,1,LUTON,TRABZON,0,0,0,46,0,46,-100
03/03/2019 11:05,2018,2,WESTERN EUROPE-OTHER,TURKEY,1,SOUTHEND,BODRUM (MILAS),0,0,0,352,352,0,-100
03/03/2019 11:05,2018,2,WESTERN EUROPE-OTHER,TURKEY,1,STANSTED,ANTALYA,129302,120131,9171,81591,65238,16353,58.47581
03/03/2019 11:05,2018,2,WESTERN EUROPE-OTHER,TURKEY,1,STANSTED,BODRUM (MILAS),46285,46285,0,21427,21427,0,116.01251
03/03/2019 11:05,2018,2,WESTERN EUROPE-OTHER,TURKEY,1,STANSTED,DALAMAN,154140,137127,17013,116750,100878,15872,32.0257
03/03/2019 11:05,2018,2,WESTERN EUROPE-OTHER,TURKEY,1,STANSTED,ISTANBUL,90543,90543,0,94958,94893,65,-4.64942
03/03/2019 11:05,2018,2,WESTERN EUROPE-OTHER,TURKEY,1,STANSTED,ISTANBUL (SABIHA GOKCEN),373221,373221,0,305510,305510,0,22.16327
03/03/2019 11:05,2018,2,WESTERN EUROPE-OTHER,TURKEY,1,STANSTED,IZMIR (ADNAN MENDERES),53043,53043,0,51065,49215,1850,3.87349
03/03/2019 11:05,2018,2,WESTERN EUROPE-OTHER,TURKEY,2,ABERDEEN,DALAMAN,7078,0,7078,5000,0,5000,41.56
03/03/2019 11:05,2018,2,WESTERN EUROPE-OTHER,TURKEY,2,BELFAST INTERNATIONAL,ANTALYA,19745,8781,10964,39,0,39,50528.20513
03/03/2019 11:05,2018,2,WESTERN EUROPE-OTHER,TURKEY,2,BELFAST INTERNATIONAL,DALAMAN,24112,4588,19524,8701,0,8701,177.11757
03/03/2019 11:05,2018,2,WESTERN EUROPE-OTHER,TURKEY,2,BELFAST INTERNATIONAL,ISTANBUL (SABIHA GOKCEN),0,0,0,131,0,131,-100
03/03/2019 11:05,2018,2,WESTERN EUROPE-OTHER,TURKEY,2,BIRMINGHAM,ANTALYA,136284,108534,27750,63514,45488,18026,114.57316
03/03/2019 11:05,2018,2,WESTERN EUROPE-OTHER,TURKEY,2,BIRMINGHAM,BODRUM (MILAS),22955,17868,5087,4723,0,4723,386.02583
03/03/2019 11:05,2018,2,WESTERN EUROPE-OTHER,TURKEY,2,BIRMINGHAM,DALAMAN,134457,99161,35296,128529,97032,31497,4.61219
03/03/2019 11:05,2018,2,WESTERN EUROPE-OTHER,TURKEY,2,BIRMINGHAM,ISTANBUL,145539,145514,25,133434,133434,0,9.0719
03/03/2019 11:05,2018,2,WESTERN EUROPE-OTHER,TURKEY,2,BIRMINGHAM,IZMIR (ADNAN MENDERES),5743,5743,0,6985,6985,0,-17.78096
03/03/2019 11:05,2018,2,WESTERN EUROPE-OTHER,TURKEY,2,BOURNEMOUTH,DALAMAN,6009,0,6009,6080,0,6080,-1.16776
03/03/2019 11:05,2018,2,WESTERN EUROPE-OTHER,TURKEY,2,BRISTOL,ANTALYA,50568,42517,8051,28472,22600,5872,77.60607
03/03/2019 11:05,2018,2,WESTERN EUROPE-OTHER,TURKEY,2,BRISTOL,BODRUM (MILAS),31949,27287,4662,26611,21682,4929,20.05937
03/03/2019 11:05,2018,2,WESTERN EUROPE-OTHER,TURKEY,2,BRISTOL,DALAMAN,92910,82038,10872,70522,59938,10584,31.74612
03/03/2019 11:05,2018,2,WESTERN EUROPE-OTHER,TURKEY,2,BRISTOL,IZMIR (ADNAN MENDERES),7,7,0,0,0,0,0
03/03/2019 11:05,2018,2,WESTERN EUROPE-OTHER,TURKEY,2,CARDIFF WALES,ANTALYA,16527,0,16527,0,0,0,0
03/03/2019 11:05,2018,2,WESTERN EUROPE-OTHER,TURKEY,2,CARDIFF WALES,DALAMAN,41162,0,41162,25219,0,25219,63.21821
03/03/2019 11:05,2018,2,WESTERN EUROPE-OTHER,TURKEY,2,DONCASTER SHEFFIELD,ANTALYA,6022,0,6022,0,0,0,0
03/03/2019 11:05,2018,2,WESTERN EUROPE-OTHER,TURKEY,2,DONCASTER SHEFFIELD,DALAMAN,15255,0,15255,7505,0,7505,103.26449
03/03/2019 11:05,2018,2,WESTERN EUROPE-OTHER,TURKEY,2,EAST MIDLANDS INTERNATIONAL,ANTALYA,41608,32937,8671,23080,23080,0,80.2773
03/03/2019 11:05,2018,2,WESTERN EUROPE-OTHER,TURKEY,2,EAST MIDLANDS INTERNATIONAL,BODRUM (MILAS),1752,1752,0,0,0,0,0
03/03/2019 11:05,2018,2,WESTERN EUROPE-OTHER,TURKEY,2,EAST MIDLANDS INTERNATIONAL,DALAMAN,53846,45032,8814,35636,26300,9336,51.10001
03/03/2019 11:05,2018,2,WESTERN EUROPE-OTHER,TURKEY,2,EDINBURGH,ANTALYA,24494,24494,0,0,0,0,0
03/03/2019 11:05,2018,2,WESTERN EUROPE-OTHER,TURKEY,2,EDINBURGH,BODRUM (MILAS),18780,18780,0,19982,19982,0,-6.01541
03/03/2019 11:05,2018,2,WESTERN EUROPE-OTHER,TURKEY,2,EDINBURGH,DALAMAN,41213,32184,9029,30020,21075,8945,37.28514
03/03/2019 11:05,2018,2,WESTERN EUROPE-OTHER,TURKEY,2,EDINBURGH,ISTANBUL,85653,85653,0,77494,77494,0,10.52856
03/03/2019 11:05,2018,2,WESTERN EUROPE-OTHER,TURKEY,2,EDINBURGH,ISTANBUL,129,129,0,0,0,0,0
03/03/2019 11:05,2018,2,WESTERN EUROPE-OTHER,TURKEY,2,EXETER,DALAMAN,11640,0,11640,5898,0,5898,97.35504
03/03/2019 11:05,2018,2,WESTERN EUROPE-OTHER,TURKEY,2,GLASGOW,ANTALYA,81873,81808,65,54322,32092,22230,50.71794
03/03/2019 11:05,2018,2,WESTERN EUROPE-OTHER,TURKEY,2,GLASGOW,BODRUM (MILAS),8762,8762,0,0,0,0,0
03/03/2019 11:05,2018,2,WESTERN EUROPE-OTHER,TURKEY,2,GLASGOW,DALAMAN,101390,83292,18098,70528,43523,27005,43.75851
03/03/2019 11:05,2018,2,WESTERN EUROPE-OTHER,TURKEY,2,LEEDS BRADFORD,ANTALYA,60196,60196,0,20647,20647,0,191.54841
03/03/2019 11:05,2018,2,WESTERN EUROPE-OTHER,TURKEY,2,LEEDS BRADFORD,BODRUM (MILAS),11236,11236,0,10556,10556,0,6.44183
03/03/2019 11:05,2018,2,WESTERN EUROPE-OTHER,TURKEY,2,LEEDS BRADFORD,DALAMAN,63847,55998,7849,41588,41009,579,53.52265
03/03/2019 11:05,2018,2,WESTERN EUROPE-OTHER,TURKEY,2,LIVERPOOL (JOHN LENNON),ANTALYA,0,0,0,212,0,212,-100
03/03/2019 11:05,2018,2,WESTERN EUROPE-OTHER,TURKEY,2,LIVERPOOL (JOHN LENNON),BODRUM (MILAS),15084,15084,0,9986,9986,0,51.05147
03/03/2019 11:05,2018,2,WESTERN EUROPE-OTHER,TURKEY,2,LIVERPOOL (JOHN LENNON),DALAMAN,8797,8797,0,0,0,0,0
03/03/2019 11:05,2018,2,WESTERN EUROPE-OTHER,TURKEY,2,MANCHESTER,ANTALYA,321923,264947,56976,214079,181535,32544,50.3758
03/03/2019 11:05,2018,2,WESTERN EUROPE-OTHER,TURKEY,2,MANCHESTER,BODRUM (MILAS),72176,56916,15260,57979,42514,15465,24.48645
03/03/2019 11:05,2018,2,WESTERN EUROPE-OTHER,TURKEY,2,MANCHESTER,DALAMAN,354102,302156,51946,272823,226034,46789,29.79184
03/03/2019 11:05,2018,2,WESTERN EUROPE-OTHER,TURKEY,2,MANCHESTER,ISTANBUL,208017,206316,1701,217528,216665,863,-4.37231
03/03/2019 11:05,2018,2,WESTERN EUROPE-OTHER,TURKEY,2,MANCHESTER,ISTANBUL,39572,39317,255,0,0,0,0
03/03/2019 11:05,2018,2,WESTERN EUROPE-OTHER,TURKEY,2,MANCHESTER,IZMIR (ADNAN MENDERES),49760,31349,18411,35360,24510,10850,40.72398
03/03/2019 11:05,2018,2,WESTERN EUROPE-OTHER,TURKEY,2,NEWCASTLE,ANTALYA,75325,75325,0,36629,36629,0,105.64307
03/03/2019 11:05,2018,2,WESTERN EUROPE-OTHER,TURKEY,2,NEWCASTLE,BODRUM (MILAS),19312,19312,0,0,0,0,0
03/03/2019 11:05,2018,2,WESTERN EUROPE-OTHER,TURKEY,2,NEWCASTLE,DALAMAN,110958,110958,0,76095,75862,233,45.8151
03/03/2019 11:05,2018,2,WESTERN EUROPE-OTHER,TURKEY,2,NORWICH,DALAMAN,11951,9,11942,0,0,0,0
03/03/2019 11:05,2018,3,EASTERN EUROPE-EU,BULGARIA,1,GATWICK,BURGAS,58192,17527,40665,61937,24684,37253,-6.04647
03/03/2019 11:05,2018,3,EASTERN EUROPE-EU,BULGARIA,1,GATWICK,SOFIA,130427,121139,9288,140255,131641,8614,-7.00724
03/03/2019 11:05,2018,3,EASTERN EUROPE-EU,BULGARIA,1,GATWICK,VARNA,19110,9770,9340,16765,14462,2303,13.98747
03/03/2019 11:05,2018,3,EASTERN EUROPE-EU,BULGARIA,1,HEATHROW,SOFIA,169529,169529,0,157087,157087,0,7.92045
03/03/2019 11:05,2018,3,EASTERN EUROPE-EU,BULGARIA,1,LUTON,BURGAS,100230,100011,219,87341,80153,7188,14.7571
03/03/2019 11:05,2018,3,EASTERN EUROPE-EU,BULGARIA,1,LUTON,SOFIA,314654,314654,0,288858,288858,0,8.93034
03/03/2019 11:05,2018,3,EASTERN EUROPE-EU,BULGARIA,1,LUTON,VARNA,106698,106552,146,115104,115104,0,-7.30296
03/03/2019 11:05,2018,3,EASTERN EUROPE-EU,BULGARIA,1,SOUTHEND,SOFIA,1391,1391,0,0,0,0,0
03/03/2019 11:05,2018,3,EASTERN EUROPE-EU,BULGARIA,1,STANSTED,BURGAS,8362,0,8362,1959,0,1959,326.85043
03/03/2019 11:05,2018,3,EASTERN EUROPE-EU,BULGARIA,1,STANSTED,PLOVDIV,55813,55813,0,53711,53711,0,3.91354
03/03/2019 11:05,2018,3,EASTERN EUROPE-EU,BULGARIA,1,STANSTED,SOFIA,260817,260817,0,253261,253261,0,2.98348
03/03/2019 11:05,2018,3,EASTERN EUROPE-EU,BULGARIA,2,ABERDEEN,BURGAS,6950,0,6950,7343,0,7343,-5.35204
03/03/2019 11:05,2018,3,EASTERN EUROPE-EU,BULGARIA,2,BELFAST CITY (GEORGE BEST),VARNA,99,0,99,0,0,0,0
03/03/2019 11:05,2018,3,EASTERN EUROPE-EU,BULGARIA,2,BELFAST INTERNATIONAL,BURGAS,21589,0,21589,18799,0,18799,14.84121
03/03/2019 11:05,2018,3,EASTERN EUROPE-EU,BULGARIA,2,BELFAST INTERNATIONAL,PLOVDIV,6491,0,6491,5128,0,5128,26.57956
03/03/2019 11:05,2018,3,EASTERN EUROPE-EU,BULGARIA,2,BELFAST INTERNATIONAL,VARNA,96,0,96,0,0,0,0
03/03/2019 11:05,2018,3,EASTERN EUROPE-EU,BULGARIA,2,BIRMINGHAM,BURGAS,43652,15137,28515,32642,12676,19966,33.72955
03/03/2019 11:05,2018,3,EASTERN EUROPE-EU,BULGARIA,2,BIRMINGHAM,SOFIA,60468,56599,3869,102084,98231,3853,-40.76643
03/03/2019 11:05,2018,3,EASTERN EUROPE-EU,BULGARIA,2,BIRMINGHAM,VARNA,5736,5736,0,0,0,0,0
03/03/2019 11:05,2018,3,EASTERN EUROPE-EU,BULGARIA,2,BRISTOL,BURGAS,22943,6100,16843,12355,0,12355,85.6981
03/03/2019 11:05,2018,3,EASTERN EUROPE-EU,BULGARIA,2,BRISTOL,SOFIA,9753,2813,6940,37851,33641,4210,-74.23318
03/03/2019 11:05,2018,3,EASTERN EUROPE-EU,BULGARIA,2,CARDIFF WALES,BURGAS,20293,0,20293,19101,0,19101,6.24051
03/03/2019 11:05,2018,3,EASTERN EUROPE-EU,BULGARIA,2,DONCASTER SHEFFIELD,BURGAS,20010,0,20010,12762,0,12762,56.79361
03/03/2019 11:05,2018,3,EASTERN EUROPE-EU,BULGARIA,2,DONCASTER SHEFFIELD,SOFIA,0,0,0,29028,29028,0,-100
03/03/2019 11:05,2018,3,EASTERN EUROPE-EU,BULGARIA,2,EAST MIDLANDS INTERNATIONAL,BURGAS,24004,7082,16922,23436,7182,16254,2.42362
03/03/2019 11:05,2018,3,EASTERN EUROPE-EU,BULGARIA,2,EAST MIDLANDS INTERNATIONAL,SOFIA,3276,0,3276,3061,0,3061,7.02385
03/03/2019 11:05,2018,3,EASTERN EUROPE-EU,BULGARIA,2,EDINBURGH,BURGAS,12372,0,12372,11398,0,11398,8.54536
03/03/2019 11:05,2018,3,EASTERN EUROPE-EU,BULGARIA,2,EDINBURGH,SOFIA,17690,17690,0,1453,1453,0,1117.48107
03/03/2019 11:05,2018,3,EASTERN EUROPE-EU,BULGARIA,2,GLASGOW,BURGAS,24252,7631,16621,17015,0,17015,42.53306
03/03/2019 11:05,2018,3,EASTERN EUROPE-EU,BULGARIA,2,GLASGOW,SOFIA,29812,29638,174,36383,36383,0,-18.06063
03/03/2019 11:05,2018,3,EASTERN EUROPE-EU,BULGARIA,2,HUMBERSIDE,BURGAS,6127,0,6127,6083,0,6083,0.72333
03/03/2019 11:05,2018,3,EASTERN EUROPE-EU,BULGARIA,2,LEEDS BRADFORD,BURGAS,12178,0,12178,5760,0,5760,111.42361
03/03/2019 11:05,2018,3,EASTERN EUROPE-EU,BULGARIA,2,LEEDS BRADFORD,SOFIA,0,0,0,167,167,0,-100
03/03/2019 11:05,2018,3,EASTERN EUROPE-EU,BULGARIA,2,LIVERPOOL (JOHN LENNON),BURGAS,306,0,306,0,0,0,0
03/03/2019 11:05,2018,3,EASTERN EUROPE-EU,BULGARIA,2,LIVERPOOL (JOHN LENNON),SOFIA,36360,36360,0,34357,34357,0,5.82996
03/03/2019 11:05,2018,3,EASTERN EUROPE-EU,BULGARIA,2,MANCHESTER,BURGAS,91945,31481,60464,91630,34840,56790,0.34377
03/03/2019 11:05,2018,3,EASTERN EUROPE-EU,BULGARIA,2,MANCHESTER,SOFIA,74817,65154,9663,79252,72454,6798,-5.59607
03/03/2019 11:05,2018,3,EASTERN EUROPE-EU,BULGARIA,2,MANCHESTER,VARNA,21855,7510,14345,5911,0,5911,269.73439
03/03/2019 11:05,2018,3,EASTERN EUROPE-EU,BULGARIA,2,NEWCASTLE,BURGAS,36544,36544,0,36628,36628,0,-0.22933
03/03/2019 11:05,2018,3,EASTERN EUROPE-EU,BULGARIA,2,NEWCASTLE,SOFIA,3181,3181,0,3125,2954,171,1.792
03/03/2019 11:05,2018,3,EASTERN EUROPE-EU,BULGARIA,2,NORWICH,BURGAS,5133,0,5133,5513,176,5337,-6.8928
03/03/2019 11:05,2018,3,EASTERN EUROPE-EU,CZECH REPUBLIC,1,GATWICK,PRAGUE,266986,266986,0,326578,326555,23,-18.2474
03/03/2019 11:05,2018,3,EASTERN EUROPE-EU,CZECH REPUBLIC,1,HEATHROW,PRAGUE,443743,443743,0,440166,440166,0,0.81265
03/03/2019 11:05,2018,3,EASTERN EUROPE-EU,CZECH REPUBLIC,1,LONDON CITY,PRAGUE,40730,40723,7,6532,6532,0,523.54562
03/03/2019 11:05,2018,3,EASTERN EUROPE-EU,CZECH REPUBLIC,1,LUTON,BRNO (TURANY),1083,1083,0,47835,47835,0,-97.73597
03/03/2019 11:05,2018,3,EASTERN EUROPE-EU,CZECH REPUBLIC,1,LUTON,PRAGUE,123629,123629,0,115157,115157,0,7.35691
03/03/2019 11:05,2018,3,EASTERN EUROPE-EU,CZECH REPUBLIC,1,SOUTHEND,PRAGUE,73341,73341,0,27622,27622,0,165.51662
03/03/2019 11:05,2018,3,EASTERN EUROPE-EU,CZECH REPUBLIC,1,STANSTED,BRNO (TURANY),112158,112158,0,108793,108793,0,3.09303
03/03/2019 11:05,2018,3,EASTERN EUROPE-EU,CZECH REPUBLIC,1,STANSTED,OSTRAVA,59430,59430,0,60350,60350,0,-1.52444
03/03/2019 11:05,2018,3,EASTERN EUROPE-EU,CZECH REPUBLIC,1,STANSTED,PARDUBICE,40857,40857,0,15458,15458,0,164.30974
03/03/2019 11:05,2018,3,EASTERN EUROPE-EU,CZECH REPUBLIC,1,STANSTED,PRAGUE,407545,407545,0,329285,329285,0,23.76665
03/03/2019 11:05,2018,3,EASTERN EUROPE-EU,CZECH REPUBLIC,2,BELFAST CITY (GEORGE BEST),PRAGUE,99,0,99,0,0,0,0
03/03/2019 11:05,2018,3,EASTERN EUROPE-EU,CZECH REPUBLIC,2,BELFAST INTERNATIONAL,PRAGUE,5275,5275,0,629,292,337,738.63275
03/03/2019 11:05,2018,3,EASTERN EUROPE-EU,CZECH REPUBLIC,2,BIRMINGHAM,BRNO (TURANY),173,173,0,0,0,0,0
03/03/2019 11:05,2018,3,EASTERN EUROPE-EU,CZECH REPUBLIC,2,BIRMINGHAM,PRAGUE,80354,80354,0,69569,69527,42,15.50259
03/03/2019 11:05,2018,3,EASTERN EUROPE-EU,CZECH REPUBLIC,2,BRISTOL,PRAGUE,92703,92703,0,71643,71643,0,29.39575
03/03/2019 11:05,2018,3,EASTERN EUROPE-EU,CZECH REPUBLIC,2,CARDIFF WALES,PRAGUE,279,0,279,42,0,42,564.28571
03/03/2019 11:05,2018,3,EASTERN EUROPE-EU,CZECH REPUBLIC,2,EAST MIDLANDS INTERNATIONAL,KARLOVY VARY,0,0,0,85,0,85,-100
03/03/2019 11:05,2018,3,EASTERN EUROPE-EU,CZECH REPUBLIC,2,EAST MIDLANDS INTERNATIONAL,PRAGUE,24368,24368,0,25552,25358,194,-4.63369
03/03/2019 11:05,2018,3,EASTERN EUROPE-EU,CZECH REPUBLIC,2,EDINBURGH,PRAGUE,149496,149496,0,92761,92761,0,61.16256
03/03/2019 11:05,2018,3,EASTERN EUROPE-EU,CZECH REPUBLIC,2,GLASGOW,PRAGUE,31709,31709,0,31852,31717,135,-0.44895
03/03/2019 11:05,2018,3,EASTERN EUROPE-EU,CZECH REPUBLIC,2,GUERNSEY,PRAGUE,104,0,104,0,0,0,0
03/03/2019 11:05,2018,3,EASTERN EUROPE-EU,CZECH REPUBLIC,2,LEEDS BRADFORD,PRAGUE,25620,25620,0,25971,25971,0,-1.35151
03/03/2019 11:05,2018,3,EASTERN EUROPE-EU,CZECH REPUBLIC,2,LIVERPOOL (JOHN LENNON),PRAGUE,74753,74753,0,55728,55728,0,34.13903
03/03/2019 11:05,2018,3,EASTERN EUROPE-EU,CZECH REPUBLIC,2,MANCHESTER,PRAGUE,189248,189248,0,173095,173095,0,9.33187
03/03/2019 11:05,2018,3,EASTERN EUROPE-EU,CZECH REPUBLIC,2,NEWCASTLE,PRAGUE,26515,26515,0,25451,25451,0,4.18058
03/03/2019 11:05,2018,3,EASTERN EUROPE-EU,CZECH REPUBLIC,2,PRESTWICK,PRAGUE,181,0,181,0,0,0,0
03/03/2019 11:05,2018,3,EASTERN EUROPE-EU,ESTONIA,1,GATWICK,TALLIN,52944,52933,11,34579,34579,0,53.11027
03/03/2019 11:05,2018,3,EASTERN EUROPE-EU,ESTONIA,1,HEATHROW,TALLIN,31350,31350,0,23662,23662,0,32.49091
03/03/2019 11:05,2018,3,EASTERN EUROPE-EU,ESTONIA,1,LUTON,TALLIN,14500,14500,0,0,0,0,0
03/03/2019 11:05,2018,3,EASTERN EUROPE-EU,ESTONIA,1,STANSTED,TALLIN,74199,74199,0,74634,74634,0,-0.58284
03/03/2019 11:05,2018,3,EASTERN EUROPE-EU,ESTONIA,2,EDINBURGH,TALLIN,6616,6528,88,0,0,0,0
03/03/2019 11:05,2018,3,EASTERN EUROPE-EU,ESTONIA,2,LIVERPOOL (JOHN LENNON),TALLIN,176,0,176,0,0,0,0
03/03/2019 11:05,2018,3,EASTERN EUROPE-EU,HUNGARY,1,GATWICK,BUDAPEST,174585,173860,725,213527,213527,0,-18.23751
03/03/2019 11:05,2018,3,EASTERN EUROPE-EU,HUNGARY,1,HEATHROW,BUDAPEST,363488,363488,0,333843,333843,0,8.87992
03/03/2019 11:05,2018,3,EASTERN EUROPE-EU,HUNGARY,1,LUTON,BUDAPEST,564102,564002,100,574051,573843,208,-1.73312
03/03/2019 11:05,2018,3,EASTERN EUROPE-EU,HUNGARY,1,LUTON,DEBRECEN,148516,148516,0,140778,140778,0,5.4966
03/03/2019 11:05,2018,3,EASTERN EUROPE-EU,HUNGARY,1,SOUTHEND,BUDAPEST,26779,26779,0,13299,13299,0,101.361
03/03/2019 11:05,2018,3,EASTERN EUROPE-EU,HUNGARY,1,STANSTED,BUDAPEST,427179,427131,48,390343,390343,0,9.43683
03/03/2019 11:05,2018,3,EASTERN EUROPE-EU,HUNGARY,2,BIRMINGHAM,BUDAPEST,46690,46690,0,48667,48345,322,-4.0623
03/03/2019 11:05,2018,3,EASTERN EUROPE-EU,HUNGARY,2,BIRMINGHAM,DEBRECEN,158,158,0,0,0,0,0
03/03/2019 11:05,2018,3,EASTERN EUROPE-EU,HUNGARY,2,BRISTOL,BUDAPEST,55948,55948,0,57859,57859,0,-3.30286
03/03/2019 11:05,2018,3,EASTERN EUROPE-EU,HUNGARY,2,DONCASTER SHEFFIELD,BUDAPEST,6081,6081,0,382,382,0,1491.88482
03/03/2019 11:05,2018,3,EASTERN EUROPE-EU,HUNGARY,2,DONCASTER SHEFFIELD,DEBRECEN,1469,1469,0,0,0,0,0
03/03/2019 11:05,2018,3,EASTERN EUROPE-EU,HUNGARY,2,EAST MIDLANDS INTERNATIONAL,BUDAPEST,74095,74095,0,64890,64890,0,14.18554
03/03/2019 11:05,2018,3,EASTERN EUROPE-EU,HUNGARY,2,EDINBURGH,BUDAPEST,97099,96925,174,50589,50589,0,91.93698
03/03/2019 11:05,2018,3,EASTERN EUROPE-EU,HUNGARY,2,GLASGOW,BUDAPEST,34361,34331,30,43550,43550,0,-21.09989
03/03/2019 11:05,2018,3,EASTERN EUROPE-EU,HUNGARY,2,HUMBERSIDE,BUDAPEST,92,0,92,88,0,88,4.54545
03/03/2019 11:05,2018,3,EASTERN EUROPE-EU,HUNGARY,2,LEEDS BRADFORD,BUDAPEST,30693,30693,0,27274,27274,0,12.53575
03/03/2019 11:05,2018,3,EASTERN EUROPE-EU,HUNGARY,2,LIVERPOOL (JOHN LENNON),BUDAPEST,48478,48478,0,44200,44200,0,9.67873
03/03/2019 11:05,2018,3,EASTERN EUROPE-EU,HUNGARY,2,MANCHESTER,BUDAPEST,156532,156315,217,151844,151713,131,3.08738
03/03/2019 11:05,2018,3,EASTERN EUROPE-EU,LATVIA,1,GATWICK,RIGA,140730,140730,0,122332,122332,0,15.0394
03/03/2019 11:05,2018,3,EASTERN EUROPE-EU,LATVIA,1,LUTON,RIGA,205365,205365,0,196894,196894,0,4.30231
03/03/2019 11:05,2018,3,EASTERN EUROPE-EU,LATVIA,1,STANSTED,RIGA,255325,255325,0,257854,257854,0,-0.98079
03/03/2019 11:05,2018,3,EASTERN EUROPE-EU,LATVIA,2,ABERDEEN,RIGA,7252,7252,0,10833,10739,94,-33.0564
03/03/2019 11:05,2018,3,EASTERN EUROPE-EU,LATVIA,2,BIRMINGHAM,RIGA,45,0,45,138,138,0,-67.3913
03/03/2019 11:05,2018,3,EASTERN EUROPE-EU,LATVIA,2,DONCASTER SHEFFIELD,RIGA,42419,42419,0,43160,43160,0,-1.71687
03/03/2019 11:05,2018,3,EASTERN EUROPE-EU,LATVIA,2,EAST MIDLANDS INTERNATIONAL,RIGA,55227,55227,0,55268,55268,0,-0.07418
03/03/2019 11:05,2018,3,EASTERN EUROPE-EU,LATVIA,2,EDINBURGH,RIGA,3269,3269,0,0,0,0,0
03/03/2019 11:05,2018,3,EASTERN EUROPE-EU,LATVIA,2,GLASGOW,RIGA,26819,26819,0,32645,32645,0,-17.84653
03/03/2019 11:05,2018,3,EASTERN EUROPE-EU,LATVIA,2,LEEDS BRADFORD,RIGA,36055,35779,276,36265,36265,0,-0.57907
03/03/2019 11:05,2018,3,EASTERN EUROPE-EU,LATVIA,2,LIVERPOOL (JOHN LENNON),RIGA,7178,7178,0,32437,32437,0,-77.87095
03/03/2019 11:05,2018,3,EASTERN EUROPE-EU,LATVIA,2,MANCHESTER,RIGA,48969,48969,0,53591,53591,0,-8.62458
03/03/2019 11:05,2018,3,EASTERN EUROPE-EU,LATVIA,2,NORWICH,RIGA,45,0,45,0,0,0,0
03/03/2019 11:05,2018,3,EASTERN EUROPE-EU,LITHUANIA,1,GATWICK,VILNIUS,0,0,0,1,0,1,-100
03/03/2019 11:05,2018,3,EASTERN EUROPE-EU,LITHUANIA,1,LUTON,KAUNAS,244636,244636,0,251071,251046,25,-2.56302
03/03/2019 11:05,2018,3,EASTERN EUROPE-EU,LITHUANIA,1,LUTON,PALANGA,61353,61353,0,56109,56109,0,9.34609
03/03/2019 11:05,2018,3,EASTERN EUROPE-EU,LITHUANIA,1,LUTON,VILNIUS,347688,347688,0,247669,247669,0,40.38414
03/03/2019 11:05,2018,3,EASTERN EUROPE-EU,LITHUANIA,1,STANSTED,KAUNAS,93219,93219,0,82435,82435,0,13.08182
03/03/2019 11:05,2018,3,EASTERN EUROPE-EU,LITHUANIA,1,STANSTED,PALANGA,37626,37626,0,38045,38045,0,-1.10133
03/03/2019 11:05,2018,3,EASTERN EUROPE-EU,LITHUANIA,1,STANSTED,VILNIUS,127393,127393,0,107636,107636,0,18.35538
03/03/2019 11:05,2018,3,EASTERN EUROPE-EU,LITHUANIA,2,BELFAST CITY (GEORGE BEST),PALANGA,0,0,0,226,0,226,-100
03/03/2019 11:05,2018,3,EASTERN EUROPE-EU,LITHUANIA,2,BELFAST INTERNATIONAL,KAUNAS,0,0,0,3491,3491,0,-100
03/03/2019 11:05,2018,3,EASTERN EUROPE-EU,LITHUANIA,2,BELFAST INTERNATIONAL,VILNIUS,36508,36508,0,31068,31068,0,17.50998
03/03/2019 11:05,2018,3,EASTERN EUROPE-EU,LITHUANIA,2,BIRMINGHAM,KAUNAS,0,0,0,521,521,0,-100
03/03/2019 11:05,2018,3,EASTERN EUROPE-EU,LITHUANIA,2,BIRMINGHAM,VILNIUS,35811,35811,0,29915,29915,0,19.70918
03/03/2019 11:05,2018,3,EASTERN EUROPE-EU,LITHUANIA,2,BRISTOL,KAUNAS,47439,47143,296,46861,46861,0,1.23344
03/03/2019 11:05,2018,3,EASTERN EUROPE-EU,LITHUANIA,2,DONCASTER SHEFFIELD,KAUNAS,0,0,0,5236,5236,0,-100
03/03/2019 11:05,2018,3,EASTERN EUROPE-EU,LITHUANIA,2,DONCASTER SHEFFIELD,PALANGA,0,0,0,7,7,0,-100
03/03/2019 11:05,2018,3,EASTERN EUROPE-EU,LITHUANIA,2,DONCASTER SHEFFIELD,VILNIUS,41032,41032,0,41027,41027,0,0.01219
03/03/2019 11:05,2018,3,EASTERN EUROPE-EU,LITHUANIA,2,EDINBURGH,KAUNAS,22288,22288,0,22075,22075,0,0.96489
03/03/2019 11:05,2018,3,EASTERN EUROPE-EU,LITHUANIA,2,EDINBURGH,VILNIUS,0,0,0,160,0,160,-100
03/03/2019 11:05,2018,3,EASTERN EUROPE-EU,LITHUANIA,2,GLASGOW,KAUNAS,122,0,122,0,0,0,0
03/03/2019 11:05,2018,3,EASTERN EUROPE-EU,LITHUANIA,2,GLASGOW,PALANGA,15025,15025,0,19980,19980,0,-24.7998
03/03/2019 11:05,2018,3,EASTERN EUROPE-EU,LITHUANIA,2,GLASGOW,VILNIUS,0,0,0,166,0,166,-100
03/03/2019 11:05,2018,3,EASTERN EUROPE-EU,LITHUANIA,2,LEEDS BRADFORD,VILNIUS,34789,34789,0,28390,28390,0,22.53963
03/03/2019 11:05,2018,3,EASTERN EUROPE-EU,LITHUANIA,2,LIVERPOOL (JOHN LENNON),VILNIUS,36813,36813,0,30610,30610,0,20.26462
03/03/2019 11:05,2018,3,EASTERN EUROPE-EU,LITHUANIA,2,NEWCASTLE,VILNIUS,0,0,0,179,0,179,-100
03/03/2019 11:05,2018,3,EASTERN EUROPE-EU,POLAND,1,GATWICK,GDANSK,0,0,0,1,0,1,-100
03/03/2019 11:05,2018,3,EASTERN EUROPE-EU,POLAND,1,GATWICK,KATOWICE,180,180,0,70,0,70,157.14286
03/03/2019 11:05,2018,3,EASTERN EUROPE-EU,POLAND,1,GATWICK,KRAKOW,147233,145543,1690,143924,143052,872,2.29913
03/03/2019 11:05,2018,3,EASTERN EUROPE-EU,POLAND,1,GATWICK,POZNAN,0,0,0,42,0,42,-100
03/03/2019 11:05,2018,3,EASTERN EUROPE-EU,POLAND,1,GATWICK,WARSAW (CHOPIN),10637,10637,0,15480,15479,1,-31.28553
03/03/2019 11:05,2018,3,EASTERN EUROPE-EU,POLAND,1,GATWICK,WROCLAW,109,0,109,0,0,0,0
03/03/2019 11:05,2018,3,EASTERN EUROPE-EU,POLAND,1,HEATHROW,KRAKOW,103347,103347,0,96581,96581,0,7.00552
03/03/2019 11:05,2018,3,EASTERN EUROPE-EU,POLAND,1,HEATHROW,WARSAW (CHOPIN),501117,501117,0,444088,444088,0,12.84182
03/03/2019 11:05,2018,3,EASTERN EUROPE-EU,POLAND,1,LUTON,BYDGOSZCZ,62601,62601,0,8764,8764,0,614.29712
03/03/2019 11:05,2018,3,EASTERN EUROPE-EU,POLAND,1,LUTON,GDANSK,334909,334909,0,304454,304454,0,10.00315
03/03/2019 11:05,2018,3,EASTERN EUROPE-EU,POLAND,1,LUTON,KATOWICE,374062,374062,0,318964,318964,0,17.27405
03/03/2019 11:05,2018,3,EASTERN EUROPE-EU,POLAND,1,LUTON,KRAKOW,11133,10725,408,459,0,459,2325.4902
03/03/2019 11:05,2018,3,EASTERN EUROPE-EU,POLAND,1,LUTON,LUBLIN (PORT LOTNICZY),122207,122207,0,113802,113802,0,7.38563
03/03/2019 11:05,2018,3,EASTERN EUROPE-EU,POLAND,1,LUTON,POZNAN,169036,169036,0,173603,173603,0,-2.63071
03/03/2019 11:05,2018,3,EASTERN EUROPE-EU,POLAND,1,LUTON,RZESZOW,56169,56169,0,57699,57699,0,-2.65169
03/03/2019 11:05,2018,3,EASTERN EUROPE-EU,POLAND,1,LUTON,SZCZECIN (GOLENOW),1556,1556,0,45526,45526,0,-96.58217
03/03/2019 11:05,2018,3,EASTERN EUROPE-EU,POLAND,1,LUTON,SZYMANY (MAZURY),41954,41954,0,41004,41004,0,2.31685
03/03/2019 11:05,2018,3,EASTERN EUROPE-EU,POLAND,1,LUTON,WARSAW (CHOPIN),486006,486006,0,447928,447900,28,8.50092
03/03/2019 11:05,2018,3,EASTERN EUROPE-EU,POLAND,1,LUTON,WROCLAW,150482,150482,0,118620,118620,0,26.86056
03/03/2019 11:05,2018,3,EASTERN EUROPE-EU,POLAND,1,SOUTHEND,RZESZOW,31,31,0,0,0,0,0
03/03/2019 11:05,2018,3,EASTERN EUROPE-EU,POLAND,1,STANSTED,BYDGOSZCZ,116763,116763,0,120524,120524,0,-3.12054
03/03/2019 11:05,2018,3,EASTERN EUROPE-EU,POLAND,1,STANSTED,GDANSK,201724,201724,0,208935,208935,0,-3.45131
03/03/2019 11:05,2018,3,EASTERN EUROPE-EU,POLAND,1,STANSTED,KATOWICE,126864,126864,0,129993,129993,0,-2.40705
03/03/2019 11:05,2018,3,EASTERN EUROPE-EU,POLAND,1,STANSTED,KRAKOW,345191,344079,1112,347441,346281,1160,-0.64759
03/03/2019 11:05,2018,3,EASTERN EUROPE-EU,POLAND,1,STANSTED,LODZ LUBLINEK,109485,109485,0,110052,110052,0,-0.51521
03/03/2019 11:05,2018,3,EASTERN EUROPE-EU,POLAND,1,STANSTED,LUBLIN (PORT LOTNICZY),73660,73660,0,70119,70119,0,5.04999
03/03/2019 11:05,2018,3,EASTERN EUROPE-EU,POLAND,1,STANSTED,POZNAN,157453,157453,0,136055,136055,0,15.72746
03/03/2019 11:05,2018,3,EASTERN EUROPE-EU,POLAND,1,STANSTED,RZESZOW,136922,136548,374,141221,140959,262,-3.04416
03/03/2019 11:05,2018,3,EASTERN EUROPE-EU,POLAND,1,STANSTED,SZCZECIN (GOLENOW),109531,109531,0,108181,108181,0,1.24791
03/03/2019 11:05,2018,3,EASTERN EUROPE-EU,POLAND,1,STANSTED,SZYMANY (MAZURY),49781,49781,0,51129,51129,0,-2.63647
03/03/2019 11:05,2018,3,EASTERN EUROPE-EU,POLAND,1,STANSTED,WARSAW (CHOPIN),485,0,485,0,0,0,0
03/03/2019 11:05,2018,3,EASTERN EUROPE-EU,POLAND,1,STANSTED,WARSAW (MODLIN MASOVIA),417121,417121,0,412432,412432,0,1.13691
03/03/2019 11:05,2018,3,EASTERN EUROPE-EU,POLAND,1,STANSTED,WROCLAW,210781,210781,0,223185,223185,0,-5.55772
03/03/2019 11:05,2018,3,EASTERN EUROPE-EU,POLAND,2,ABERDEEN,GDANSK,35754,35754,0,39586,39586,0,-9.68019
03/03/2019 11:05,2018,3,EASTERN EUROPE-EU,POLAND,2,ABERDEEN,WARSAW (CHOPIN),1852,1852,0,33282,33282,0,-94.43543
03/03/2019 11:05,2018,3,EASTERN EUROPE-EU,POLAND,2,BELFAST INTERNATIONAL,GDANSK,36076,36076,0,34163,34163,0,5.59963
03/03/2019 11:05,2018,3,EASTERN EUROPE-EU,POLAND,2,BELFAST INTERNATIONAL,KATOWICE,76,0,76,19259,19259,0,-99.60538
03/03/2019 11:05,2018,3,EASTERN EUROPE-EU,POLAND,2,BELFAST INTERNATIONAL,KRAKOW,101755,101755,0,99585,99145,440,2.17904
03/03/2019 11:05,2018,3,EASTERN EUROPE-EU,POLAND,2,BELFAST INTERNATIONAL,WARSAW (MODLIN MASOVIA),35146,35146,0,33732,33732,0,4.19187
03/03/2019 11:05,2018,3,EASTERN EUROPE-EU,POLAND,2,BELFAST INTERNATIONAL,WROCLAW,35109,35109,0,32386,32386,0,8.40795
03/03/2019 11:05,2018,3,EASTERN EUROPE-EU,POLAND,2,BIRMINGHAM,BYDGOSZCZ,55203,55203,0,54922,54922,0,0.51163
03/03/2019 11:05,2018,3,EASTERN EUROPE-EU,POLAND,2,BIRMINGHAM,GDANSK,38267,38267,0,37013,37013,0,3.388
03/03/2019 11:05,2018,3,EASTERN EUROPE-EU,POLAND,2,BIRMINGHAM,KATOWICE,36975,36975,0,36320,36320,0,1.80341
03/03/2019 11:05,2018,3,EASTERN EUROPE-EU,POLAND,2,BIRMINGHAM,KRAKOW,70687,69440,1247,45064,44162,902,56.85913
03/03/2019 11:05,2018,3,EASTERN EUROPE-EU,POLAND,2,BIRMINGHAM,POZNAN,32970,32970,0,32471,32471,0,1.53676
03/03/2019 11:05,2018,3,EASTERN EUROPE-EU,POLAND,2,BIRMINGHAM,RZESZOW,184,184,0,353,353,0,-47.87535
03/03/2019 11:05,2018,3,EASTERN EUROPE-EU,POLAND,2,BIRMINGHAM,WARSAW (CHOPIN),48553,48553,0,49221,49221,0,-1.35714
03/03/2019 11:05,2018,3,EASTERN EUROPE-EU,POLAND,2,BIRMINGHAM,WARSAW (MODLIN MASOVIA),53474,53474,0,52167,52167,0,2.50542
03/03/2019 11:05,2018,3,EASTERN EUROPE-EU,POLAND,2,BIRMINGHAM,WROCLAW,32075,32075,0,32257,32257,0,-0.56422
03/03/2019 11:05,2018,3,EASTERN EUROPE-EU,POLAND,2,BOURNEMOUTH,KRAKOW,35840,35840,0,33259,33259,0,7.76031
03/03/2019 11:05,2018,3,EASTERN EUROPE-EU,POLAND,2,BRISTOL,GDANSK,43515,43515,0,39456,39456,0,10.28741
03/03/2019 11:05,2018,3,EASTERN EUROPE-EU,POLAND,2,BRISTOL,KATOWICE,42941,42941,0,41759,41759,0,2.83053
03/03/2019 11:05,2018,3,EASTERN EUROPE-EU,POLAND,2,BRISTOL,KRAKOW,128506,128506,0,126866,126866,0,1.2927
03/03/2019 11:05,2018,3,EASTERN EUROPE-EU,POLAND,2,BRISTOL,POZNAN,40674,40629,45,37584,37584,0,8.22158
03/03/2019 11:05,2018,3,EASTERN EUROPE-EU,POLAND,2,BRISTOL,RZESZOW,35583,35583,0,37912,37912,0,-6.14317
03/03/2019 11:05,2018,3,EASTERN EUROPE-EU,POLAND,2,BRISTOL,WARSAW (CHOPIN),0,0,0,28607,28607,0,-100
03/03/2019 11:05,2018,3,EASTERN EUROPE-EU,POLAND,2,BRISTOL,WARSAW (MODLIN MASOVIA),71276,71276,0,73841,73841,0,-3.47368
03/03/2019 11:05,2018,3,EASTERN EUROPE-EU,POLAND,2,BRISTOL,WROCLAW,38378,38378,0,39225,39225,0,-2.15934
03/03/2019 11:05,2018,3,EASTERN EUROPE-EU,POLAND,2,CARDIFF WALES,KRAKOW,376,0,376,712,335,377,-47.19101
03/03/2019 11:05,2018,3,EASTERN EUROPE-EU,POLAND,2,CARDIFF WALES,POZNAN,182,182,0,0,0,0,0
03/03/2019 11:05,2018,3,EASTERN EUROPE-EU,POLAND,2,CARDIFF WALES,WARSAW (MODLIN MASOVIA),0,0,0,305,305,0,-100
03/03/2019 11:05,2018,3,EASTERN EUROPE-EU,POLAND,2,CARDIFF WALES,WROCLAW,54,0,54,0,0,0,0
03/03/2019 11:05,2018,3,EASTERN EUROPE-EU,POLAND,2,DONCASTER SHEFFIELD,GDANSK,73443,73443,0,83251,83251,0,-11.78124
03/03/2019 11:05,2018,3,EASTERN EUROPE-EU,POLAND,2,DONCASTER SHEFFIELD,KATOWICE,81381,81381,0,79937,79937,0,1.80642
03/03/2019 11:05,2018,3,EASTERN EUROPE-EU,POLAND,2,DONCASTER SHEFFIELD,KRAKOW,0,0,0,6,6,0,-100
03/03/2019 11:05,2018,3,EASTERN EUROPE-EU,POLAND,2,DONCASTER SHEFFIELD,LUBLIN (PORT LOTNICZY),17428,17428,0,41032,41032,0,-57.52583
03/03/2019 11:05,2018,3,EASTERN EUROPE-EU,POLAND,2,DONCASTER SHEFFIELD,POZNAN,50519,50519,0,71448,71448,0,-29.29263
03/03/2019 11:05,2018,3,EASTERN EUROPE-EU,POLAND,2,DONCASTER SHEFFIELD,WARSAW (CHOPIN),68754,68754,0,62523,62523,0,9.96593
03/03/2019 11:05,2018,3,EASTERN EUROPE-EU,POLAND,2,DONCASTER SHEFFIELD,WROCLAW,35692,35692,0,45745,45745,0,-21.97617
03/03/2019 11:05,2018,3,EASTERN EUROPE-EU,POLAND,2,EAST MIDLANDS INTERNATIONAL,GDANSK,0,0,0,185,185,0,-100
03/03/2019 11:05,2018,3,EASTERN EUROPE-EU,POLAND,2,EAST MIDLANDS INTERNATIONAL,KATOWICE,172,172,0,0,0,0,0
03/03/2019 11:05,2018,3,EASTERN EUROPE-EU,POLAND,2,EAST MIDLANDS INTERNATIONAL,KRAKOW,56924,56498,426,57089,56657,432,-0.28902
03/03/2019 11:05,2018,3,EASTERN EUROPE-EU,POLAND,2,EAST MIDLANDS INTERNATIONAL,LODZ LUBLINEK,37114,37114,0,37053,37053,0,0.16463
03/03/2019 11:05,2018,3,EASTERN EUROPE-EU,POLAND,2,EAST MIDLANDS INTERNATIONAL,RZESZOW,55310,55310,0,56476,56476,0,-2.06459
03/03/2019 11:05,2018,3,EASTERN EUROPE-EU,POLAND,2,EAST MIDLANDS INTERNATIONAL,WARSAW (MODLIN MASOVIA),54340,54340,0,50962,50962,0,6.62847
03/03/2019 11:05,2018,3,EASTERN EUROPE-EU,POLAND,2,EAST MIDLANDS INTERNATIONAL,WROCLAW,85587,85587,0,84643,84643,0,1.11527
03/03/2019 11:05,2018,3,EASTERN EUROPE-EU,POLAND,2,EDINBURGH,GDANSK,56317,56317,0,56604,56604,0,-0.50703
03/03/2019 11:05,2018,3,EASTERN EUROPE-EU,POLAND,2,EDINBURGH,KATOWICE,36308,36308,0,6077,6077,0,497.46585
03/03/2019 11:05,2018,3,EASTERN EUROPE-EU,POLAND,2,EDINBURGH,KRAKOW,132049,131581,468,139227,138764,463,-5.15561
03/03/2019 11:05,2018,3,EASTERN EUROPE-EU,POLAND,2,EDINBURGH,POZNAN,37569,37402,167,37863,37863,0,-0.77648
03/03/2019 11:05,2018,3,EASTERN EUROPE-EU,POLAND,2,EDINBURGH,SZCZECIN (GOLENOW),19761,19761,0,0,0,0,0
03/03/2019 11:05,2018,3,EASTERN EUROPE-EU,POLAND,2,EDINBURGH,WARSAW (MODLIN MASOVIA),54934,54934,0,55875,55875,0,-1.68412
03/03/2019 11:05,2018,3,EASTERN EUROPE-EU,POLAND,2,EDINBURGH,WROCLAW,36513,36513,0,6552,6552,0,457.28022
03/03/2019 11:05,2018,3,EASTERN EUROPE-EU,POLAND,2,EXETER,KRAKOW,422,0,422,435,0,435,-2.98851
03/03/2019 11:05,2018,3,EASTERN EUROPE-EU,POLAND,2,GLASGOW,BYDGOSZCZ,16641,16641,0,22291,22291,0,-25.34655
03/03/2019 11:05,2018,3,EASTERN EUROPE-EU,POLAND,2,GLASGOW,GDANSK,1490,1426,64,36276,36276,0,-95.8926
03/03/2019 11:05,2018,3,EASTERN EUROPE-EU,POLAND,2,GLASGOW,KATOWICE,34283,34221,62,41165,41165,0,-16.71809
03/03/2019 11:05,2018,3,EASTERN EUROPE-EU,POLAND,2,GLASGOW,KRAKOW,36564,35937,627,6767,6302,465,440.32806
03/03/2019 11:05,2018,3,EASTERN EUROPE-EU,POLAND,2,GLASGOW,LUBLIN (PORT LOTNICZY),0,0,0,12496,12496,0,-100
03/03/2019 11:05,2018,3,EASTERN EUROPE-EU,POLAND,2,GLASGOW,POZNAN,0,0,0,3490,3490,0,-100
03/03/2019 11:05,2018,3,EASTERN EUROPE-EU,POLAND,2,GLASGOW,WARSAW (CHOPIN),0,0,0,29660,29660,0,-100
03/03/2019 11:05,2018,3,EASTERN EUROPE-EU,POLAND,2,GLASGOW,WARSAW (MODLIN MASOVIA),40116,40116,0,54171,54011,160,-25.94562
03/03/2019 11:05,2018,3,EASTERN EUROPE-EU,POLAND,2,GLASGOW,WROCLAW,37015,37015,0,37541,37541,0,-1.40113
03/03/2019 11:05,2018,3,EASTERN EUROPE-EU,POLAND,2,LEEDS BRADFORD,GDANSK,65182,65182,0,66456,66456,0,-1.91706
03/03/2019 11:05,2018,3,EASTERN EUROPE-EU,POLAND,2,LEEDS BRADFORD,KRAKOW,78726,78267,459,74355,74355,0,5.87856
03/03/2019 11:05,2018,3,EASTERN EUROPE-EU,POLAND,2,LEEDS BRADFORD,WARSAW (CHOPIN),0,0,0,123,123,0,-100
03/03/2019 11:05,2018,3,EASTERN EUROPE-EU,POLAND,2,LEEDS BRADFORD,WARSAW (MODLIN MASOVIA),35811,35811,0,35870,35870,0,-0.16448
03/03/2019 11:05,2018,3,EASTERN EUROPE-EU,POLAND,2,LEEDS BRADFORD,WROCLAW,34519,34519,0,5601,5601,0,516.30066
03/03/2019 11:05,2018,3,EASTERN EUROPE-EU,POLAND,2,LIVERPOOL (JOHN LENNON),GDANSK,56055,56055,0,59324,59324,0,-5.51042
03/03/2019 11:05,2018,3,EASTERN EUROPE-EU,POLAND,2,LIVERPOOL (JOHN LENNON),KATOWICE,38867,38867,0,39524,39524,0,-1.66228
03/03/2019 11:05,2018,3,EASTERN EUROPE-EU,POLAND,2,LIVERPOOL (JOHN LENNON),KRAKOW,102975,102975,0,101917,101917,0,1.0381
03/03/2019 11:05,2018,3,EASTERN EUROPE-EU,POLAND,2,LIVERPOOL (JOHN LENNON),LUBLIN (PORT LOTNICZY),14718,14718,0,18928,18928,0,-22.24218
03/03/2019 11:05,2018,3,EASTERN EUROPE-EU,POLAND,2,LIVERPOOL (JOHN LENNON),POZNAN,36137,36137,0,40265,40265,0,-10.25208
03/03/2019 11:05,2018,3,EASTERN EUROPE-EU,POLAND,2,LIVERPOOL (JOHN LENNON),SZCZECIN (GOLENOW),35675,35675,0,35713,35713,0,-0.1064
03/03/2019 11:05,2018,3,EASTERN EUROPE-EU,POLAND,2,LIVERPOOL (JOHN LENNON),WARSAW (CHOPIN),45505,45505,0,42723,42723,0,6.51172
03/03/2019 11:05,2018,3,EASTERN EUROPE-EU,POLAND,2,LIVERPOOL (JOHN LENNON),WARSAW (MODLIN MASOVIA),70915,70915,0,71456,71456,0,-0.75711
03/03/2019 11:05,2018,3,EASTERN EUROPE-EU,POLAND,2,LIVERPOOL (JOHN LENNON),WROCLAW,48258,48258,0,51850,51850,0,-6.92768
03/03/2019 11:05,2018,3,EASTERN EUROPE-EU,POLAND,2,MANCHESTER,GDANSK,48337,48337,0,47818,47818,0,1.08537
03/03/2019 11:05,2018,3,EASTERN EUROPE-EU,POLAND,2,MANCHESTER,KRAKOW,166889,166457,432,159808,159048,760,4.43094
03/03/2019 11:05,2018,3,EASTERN EUROPE-EU,POLAND,2,MANCHESTER,RZESZOW,37789,37789,0,38747,38747,0,-2.47245
03/03/2019 11:05,2018,3,EASTERN EUROPE-EU,POLAND,2,MANCHESTER,WARSAW (CHOPIN),0,0,0,178,178,0,-100
03/03/2019 11:05,2018,3,EASTERN EUROPE-EU,POLAND,2,MANCHESTER,WARSAW (MODLIN MASOVIA),53955,53955,0,54394,54394,0,-0.80707
03/03/2019 11:05,2018,3,EASTERN EUROPE-EU,POLAND,2,MANCHESTER,WROCLAW,47078,47078,0,49992,49992,0,-5.82893
03/03/2019 11:05,2018,3,EASTERN EUROPE-EU,POLAND,2,NEWCASTLE,GDANSK,20521,20521,0,27182,27182,0,-24.50519
03/03/2019 11:05,2018,3,EASTERN EUROPE-EU,POLAND,2,NEWCASTLE,KRAKOW,28454,28454,0,27171,27171,0,4.72195
03/03/2019 11:05,2018,3,EASTERN EUROPE-EU,POLAND,2,NEWCASTLE,WARSAW (MODLIN MASOVIA),33304,33304,0,32105,31931,174,3.73462
03/03/2019 11:05,2018,3,EASTERN EUROPE-EU,POLAND,2,NEWCASTLE,WROCLAW,33151,33151,0,32931,32931,0,0.66806
03/03/2019 11:05,2018,3,EASTERN EUROPE-EU,POLAND,2,PRESTWICK,GDANSK,181,0,181,0,0,0,0
03/03/2019 11:05,2018,3,EASTERN EUROPE-EU,POLAND,2,PRESTWICK,POZNAN,122,0,122,0,0,0,0
03/03/2019 11:05,2018,3,EASTERN EUROPE-EU,POLAND,2,PRESTWICK,RZESZOW,34175,34175,0,5985,5985,0,471.01086
03/03/2019 11:05,2018,3,EASTERN EUROPE-EU,POLAND,2,PRESTWICK,WARSAW (MODLIN MASOVIA),0,0,0,161,0,161,-100
03/03/2019 11:05,2018,3,EASTERN EUROPE-EU,POLAND,2,PRESTWICK,WROCLAW,184,0,184,166,166,0,10.84337
03/03/2019 11:05,2018,3,EASTERN EUROPE-EU,POLAND,2,SOUTHAMPTON,KRAKOW,0,0,0,149,149,0,-100
03/03/2019 11:05,2018,3,EASTERN EUROPE-EU,ROMANIA,1,GATWICK,BUCHAREST (OTOPENI),141129,141129,0,122456,122456,0,15.24874
03/03/2019 11:05,2018,3,EASTERN EUROPE-EU,ROMANIA,1,HEATHROW,BUCHAREST (OTOPENI),257371,257371,0,260726,260726,0,-1.28679
03/03/2019 11:05,2018,3,EASTERN EUROPE-EU,ROMANIA,1,LUTON,BACAU,97302,97302,0,87117,87117,0,11.69117
03/03/2019 11:05,2018,3,EASTERN EUROPE-EU,ROMANIA,1,LUTON,BUCHAREST (OTOPENI),635685,635685,0,565616,565616,0,12.38809
03/03/2019 11:05,2018,3,EASTERN EUROPE-EU,ROMANIA,1,LUTON,CLUJ NAPOCA,315630,315630,0,327118,327091,27,-3.51188
03/03/2019 11:05,2018,3,EASTERN EUROPE-EU,ROMANIA,1,LUTON,CONSTANTA,60421,60421,0,44127,44127,0,36.92524
03/03/2019 11:05,2018,3,EASTERN EUROPE-EU,ROMANIA,1,LUTON,CRAIOVA,121250,121250,0,109332,109332,0,10.90074
03/03/2019 11:05,2018,3,EASTERN EUROPE-EU,ROMANIA,1,LUTON,IASI,211843,211843,0,187463,187463,0,13.00523
03/03/2019 11:05,2018,3,EASTERN EUROPE-EU,ROMANIA,1,LUTON,SATU MARE,38649,38649,0,33967,33967,0,13.78397
03/03/2019 11:05,2018,3,EASTERN EUROPE-EU,ROMANIA,1,LUTON,SIBIU,97885,97885,0,76306,76306,0,28.27956
03/03/2019 11:05,2018,3,EASTERN EUROPE-EU,ROMANIA,1,LUTON,SUCEAVA,124144,124144,0,77703,77703,0,59.76732
03/03/2019 11:05,2018,3,EASTERN EUROPE-EU,ROMANIA,1,LUTON,TIMISOARA,121180,121180,0,114113,114113,0,6.19298
03/03/2019 11:05,2018,3,EASTERN EUROPE-EU,ROMANIA,1,LUTON,TIRGU MURES,17626,17626,0,0,0,0,0
03/03/2019 11:05,2018,3,EASTERN EUROPE-EU,ROMANIA,1,STANSTED,BACAU,152,152,0,0,0,0,0
03/03/2019 11:05,2018,3,EASTERN EUROPE-EU,ROMANIA,1,STANSTED,BUCHAREST (OTOPENI),231838,231838,0,240103,240103,0,-3.44227
03/03/2019 11:05,2018,3,EASTERN EUROPE-EU,ROMANIA,1,STANSTED,ORADEA,21496,21496,0,16029,16029,0,34.10693
03/03/2019 11:05,2018,3,EASTERN EUROPE-EU,ROMANIA,1,STANSTED,TIMISOARA,27198,27198,0,123389,123389,0,-77.95752
03/03/2019 11:05,2018,3,EASTERN EUROPE-EU,ROMANIA,2,BIRMINGHAM,BUCHAREST (OTOPENI),103222,103222,0,55389,55389,0,86.3583
03/03/2019 11:05,2018,3,EASTERN EUROPE-EU,ROMANIA,2,BIRMINGHAM,CLUJ NAPOCA,14275,14275,0,4869,4869,0,193.18135
03/03/2019 11:05,2018,3,EASTERN EUROPE-EU,ROMANIA,2,BIRMINGHAM,CONSTANTA,0,0,0,167,167,0,-100
03/03/2019 11:05,2018,3,EASTERN EUROPE-EU,ROMANIA,2,BIRMINGHAM,TIMISOARA,246,0,246,0,0,0,0
03/03/2019 11:05,2018,3,EASTERN EUROPE-EU,ROMANIA,2,BRISTOL,BUCHAREST (OTOPENI),37622,37622,0,33890,33890,0,11.0121
03/03/2019 11:05,2018,3,EASTERN EUROPE-EU,ROMANIA,2,DONCASTER SHEFFIELD,BUCHAREST (OTOPENI),63575,63575,0,55155,55155,0,15.26607
03/03/2019 11:05,2018,3,EASTERN EUROPE-EU,ROMANIA,2,DONCASTER SHEFFIELD,CLUJ NAPOCA,36032,36032,0,33735,33735,0,6.80895
03/03/2019 11:05,2018,3,EASTERN EUROPE-EU,ROMANIA,2,DONCASTER SHEFFIELD,CRAIOVA,0,0,0,175,175,0,-100
03/03/2019 11:05,2018,3,EASTERN EUROPE-EU,ROMANIA,2,EDINBURGH,BUCHAREST (OTOPENI),0,0,0,134,134,0,-100
03/03/2019 11:05,2018,3,EASTERN EUROPE-EU,ROMANIA,2,GLASGOW,BUCHAREST (OTOPENI),44484,44484,0,65754,65754,0,-32.34784
03/03/2019 11:05,2018,3,EASTERN EUROPE-EU,ROMANIA,2,GLASGOW,IASI,0,0,0,4937,4937,0,-100
03/03/2019 11:05,2018,3,EASTERN EUROPE-EU,ROMANIA,2,LIVERPOOL (JOHN LENNON),BACAU,27869,27869,0,26180,26180,0,6.45149
03/03/2019 11:05,2018,3,EASTERN EUROPE-EU,ROMANIA,2,LIVERPOOL (JOHN LENNON),BUCHAREST (OTOPENI),68304,68304,0,63320,63320,0,7.87113
03/03/2019 11:05,2018,3,EASTERN EUROPE-EU,ROMANIA,2,LIVERPOOL (JOHN LENNON),CLUJ NAPOCA,26791,26791,0,23442,23442,0,14.28632
03/03/2019 11:05,2018,3,EASTERN EUROPE-EU,ROMANIA,2,LIVERPOOL (JOHN LENNON),CRAIOVA,0,0,0,23489,23489,0,-100
03/03/2019 11:05,2018,3,EASTERN EUROPE-EU,ROMANIA,2,LIVERPOOL (JOHN LENNON),IASI,5173,5173,0,0,0,0,0
03/03/2019 11:05,2018,3,EASTERN EUROPE-EU,ROMANIA,2,LIVERPOOL (JOHN LENNON),TIMISOARA,0,0,0,97,97,0,-100
03/03/2019 11:05,2018,3,EASTERN EUROPE-EU,ROMANIA,2,MANCHESTER,BUCHAREST (OTOPENI),512,186,326,340,0,340,50.58824
03/03/2019 11:05,2018,3,EASTERN EUROPE-EU,SLOVAK REPUBLIC,1,GATWICK,BRATISLAVA,7,0,7,6,0,6,16.66667
03/03/2019 11:05,2018,3,EASTERN EUROPE-EU,SLOVAK REPUBLIC,1,LUTON,BRATISLAVA,91211,91211,0,256,0,256,35529.29688
03/03/2019 11:05,2018,3,EASTERN EUROPE-EU,SLOVAK REPUBLIC,1,LUTON,KOSICE,140134,140134,0,126078,126078,0,11.14865
03/03/2019 11:05,2018,3,EASTERN EUROPE-EU,SLOVAK REPUBLIC,1,LUTON,TATRY-POPRAD,60820,60820,0,53970,53970,0,12.69224
03/03/2019 11:05,2018,3,EASTERN EUROPE-EU,SLOVAK REPUBLIC,1,STANSTED,BRATISLAVA,216383,216383,0,195107,194703,404,10.90479
03/03/2019 11:05,2018,3,EASTERN EUROPE-EU,SLOVAK REPUBLIC,2,BIRMINGHAM,BRATISLAVA,54994,54994,0,56782,55605,1177,-3.14889
03/03/2019 11:05,2018,3,EASTERN EUROPE-EU,SLOVAK REPUBLIC,2,BRISTOL,KOSICE,0,0,0,12074,12074,0,-100
03/03/2019 11:05,2018,3,EASTERN EUROPE-EU,SLOVAK REPUBLIC,2,DONCASTER SHEFFIELD,KOSICE,16584,16584,0,45491,45491,0,-63.54444
03/03/2019 11:05,2018,3,EASTERN EUROPE-EU,SLOVAK REPUBLIC,2,EAST MIDLANDS INTERNATIONAL,BRATISLAVA,294,0,294,0,0,0,0
03/03/2019 11:05,2018,3,EASTERN EUROPE-EU,SLOVAK REPUBLIC,2,EDINBURGH,BRATISLAVA,36267,35903,364,38610,38610,0,-6.06838
03/03/2019 11:05,2018,3,EASTERN EUROPE-EU,SLOVAK REPUBLIC,2,GLASGOW,BRATISLAVA,1751,0,1751,724,0,724,141.85083
03/03/2019 11:05,2018,3,EASTERN EUROPE-EU,SLOVAK REPUBLIC,2,LEEDS BRADFORD,BRATISLAVA,35226,35226,0,34501,34501,0,2.10139
03/03/2019 11:05,2018,3,EASTERN EUROPE-EU,SLOVAK REPUBLIC,2,LIVERPOOL (JOHN LENNON),TATRY-POPRAD,0,0,0,131,0,131,-100
03/03/2019 11:05,2018,3,EASTERN EUROPE-EU,SLOVAK REPUBLIC,2,MANCHESTER,BRATISLAVA,54966,54966,0,56268,56268,0,-2.31393
03/03/2019 11:05,2018,4,EASTERN EUROPE -OTHER,ALBANIA,1,GATWICK,TIRANA,104290,97969,6321,96156,84677,11479,8.45917
03/03/2019 11:05,2018,4,EASTERN EUROPE -OTHER,ALBANIA,1,LUTON,TIRANA,43205,43205,0,0,0,0,0
03/03/2019 11:05,2018,4,EASTERN EUROPE -OTHER,ALBANIA,1,STANSTED,TIRANA,853,0,853,2031,0,2031,-58.00098
03/03/2019 11:05,2018,4,EASTERN EUROPE -OTHER,ALBANIA,2,CARDIFF WALES,TIRANA,176,0,176,0,0,0,0
03/03/2019 11:05,2018,4,EASTERN EUROPE -OTHER,ALBANIA,2,DURHAM TEES VALLEY,TIRANA,0,0,0,1,0,1,-100
03/03/2019 11:05,2018,4,EASTERN EUROPE -OTHER,ALBANIA,2,EDINBURGH,TIRANA,77,0,77,0,0,0,0
03/03/2019 11:05,2018,4,EASTERN EUROPE -OTHER,ALBANIA,2,GLASGOW,TIRANA,141,0,141,0,0,0,0
03/03/2019 11:05,2018,4,EASTERN EUROPE -OTHER,ALBANIA,2,MANCHESTER,TIRANA,124,124,0,0,0,0,0
03/03/2019 11:05,2018,4,EASTERN EUROPE -OTHER,ARMENIA,2,GLASGOW,YEREVAN,100,0,100,0,0,0,0
03/03/2019 11:05,2018,4,EASTERN EUROPE -OTHER,AZERBAIJAN,1,GATWICK,BAKU (HEYDER ALIYEV INT'L),234,0,234,689,0,689,-66.03774
03/03/2019 11:05,2018,4,EASTERN EUROPE -OTHER,AZERBAIJAN,1,HEATHROW,BAKU (HEYDER ALIYEV INT'L),38815,38815,0,47985,47985,0,-19.11014
03/03/2019 11:05,2018,4,EASTERN EUROPE -OTHER,AZERBAIJAN,1,LUTON,BAKU (HEYDER ALIYEV INT'L),1219,0,1219,1011,0,1011,20.57369
03/03/2019 11:05,2018,4,EASTERN EUROPE -OTHER,AZERBAIJAN,2,BELFAST INTERNATIONAL,BAKU (HEYDER ALIYEV INT'L),0,0,0,39,0,39,-100
03/03/2019 11:05,2018,4,EASTERN EUROPE -OTHER,BELARUS,1,GATWICK,MINSK INT'L ,31898,31568,330,28954,28835,119,10.16785
03/03/2019 11:05,2018,4,EASTERN EUROPE -OTHER,BELARUS,1,LUTON,MINSK INT'L ,0,0,0,141,0,141,-100
03/03/2019 11:05,2018,4,EASTERN EUROPE -OTHER,BELARUS,2,MANCHESTER,MINSK INT'L ,3113,3039,74,2936,2936,0,6.02861
03/03/2019 11:05,2018,4,EASTERN EUROPE -OTHER,GEORGIA,1,GATWICK,TBILISI,13767,13767,0,7144,7144,0,92.70717
03/03/2019 11:05,2018,4,EASTERN EUROPE -OTHER,GEORGIA,1,LUTON,KUTAISI,27427,27427,0,13992,13992,0,96.01915
03/03/2019 11:05,2018,4,EASTERN EUROPE -OTHER,GEORGIA,2,CARDIFF WALES,TBILISI,0,0,0,197,0,197,-100
03/03/2019 11:05,2018,4,EASTERN EUROPE -OTHER,GEORGIA,2,EDINBURGH,TBILISI,95,0,95,0,0,0,0
03/03/2019 11:05,2018,4,EASTERN EUROPE -OTHER,KAZAKHSTAN,1,HEATHROW,ASTANA,45379,45379,0,41678,41678,0,8.87998
03/03/2019 11:05,2018,4,EASTERN EUROPE -OTHER,KAZAKHSTAN,1,LUTON,ALMATY,0,0,0,2,0,2,-100
03/03/2019 11:05,2018,4,EASTERN EUROPE -OTHER,KAZAKHSTAN,2,GLASGOW,ASTANA,0,0,0,237,0,237,-100
03/03/2019 11:05,2018,4,EASTERN EUROPE -OTHER,REPUBLIC OF MOLDOVA,1,LUTON,CHISINAU (KISHINEV),117156,117156,0,83154,83154,0,40.8904
03/03/2019 11:05,2018,4,EASTERN EUROPE -OTHER,REPUBLIC OF MOLDOVA,1,STANSTED,CHISINAU (KISHINEV),67873,67873,0,60058,60058,0,13.01242
03/03/2019 11:05,2018,4,EASTERN EUROPE -OTHER,REPUBLIC OF MOLDOVA,2,CARDIFF WALES,CHISINAU (KISHINEV),0,0,0,120,0,120,-100
03/03/2019 11:05,2018,4,EASTERN EUROPE -OTHER,RUSSIA,1,GATWICK,MOSCOW (SHEREMETYEVO),16577,16577,0,81042,81042,0,-79.54517
03/03/2019 11:05,2018,4,EASTERN EUROPE -OTHER,RUSSIA,1,GATWICK,ST PETERSBURG,47097,47097,0,0,0,0,0
03/03/2019 11:05,2018,4,EASTERN EUROPE -OTHER,RUSSIA,1,HEATHROW,ADLER / SOCHI,0,0,0,119,0,119,-100
03/03/2019 11:05,2018,4,EASTERN EUROPE -OTHER,RUSSIA,1,HEATHROW,MOSCOW (DOMODEDOVO),248977,248977,0,261437,261311,126,-4.76597
03/03/2019 11:05,2018,4,EASTERN EUROPE -OTHER,RUSSIA,1,HEATHROW,MOSCOW (SHEREMETYEVO),475473,475473,0,422025,422025,0,12.66465
03/03/2019 11:05,2018,4,EASTERN EUROPE -OTHER,RUSSIA,1,HEATHROW,ST PETERSBURG,81017,81017,0,93026,93026,0,-12.90929
03/03/2019 11:05,2018,4,EASTERN EUROPE -OTHER,RUSSIA,1,LUTON,ADLER / SOCHI,400,0,400,918,0,918,-56.42702
03/03/2019 11:05,2018,4,EASTERN EUROPE -OTHER,RUSSIA,1,LUTON,MOSCOW (SHEREMETYEVO),113,0,113,0,0,0,0
03/03/2019 11:05,2018,4,EASTERN EUROPE -OTHER,RUSSIA,1,LUTON,MOSCOW (VNUKOVO),0,0,0,167,0,167,-100
03/03/2019 11:05,2018,4,EASTERN EUROPE -OTHER,RUSSIA,1,LUTON,ST PETERSBURG,164,164,0,0,0,0,0
03/03/2019 11:05,2018,4,EASTERN EUROPE -OTHER,RUSSIA,1,STANSTED,MOSCOW (SHEREMETYEVO),256,0,256,0,0,0,0
03/03/2019 11:05,2018,4,EASTERN EUROPE -OTHER,RUSSIA,2,BIRMINGHAM,ST PETERSBURG,62,0,62,0,0,0,0
03/03/2019 11:05,2018,4,EASTERN EUROPE -OTHER,RUSSIA,2,EAST MIDLANDS INTERNATIONAL,SAMARA/KUYBYSHEV,220,0,220,0,0,0,0
03/03/2019 11:05,2018,4,EASTERN EUROPE -OTHER,RUSSIA,2,GLASGOW,MOSCOW (SHEREMETYEVO),336,0,336,0,0,0,0
03/03/2019 11:05,2018,4,EASTERN EUROPE -OTHER,RUSSIA,2,GLASGOW,MOSCOW (VNUKOVO),39,0,39,0,0,0,0
03/03/2019 11:05,2018,4,EASTERN EUROPE -OTHER,RUSSIA,2,GLASGOW,ST PETERSBURG,492,0,492,0,0,0,0
03/03/2019 11:05,2018,4,EASTERN EUROPE -OTHER,RUSSIA,2,GLASGOW,UFA,122,0,122,0,0,0,0
03/03/2019 11:05,2018,4,EASTERN EUROPE -OTHER,RUSSIA,2,LIVERPOOL (JOHN LENNON),MOSCOW (SHEREMETYEVO),0,0,0,433,0,433,-100
03/03/2019 11:05,2018,4,EASTERN EUROPE -OTHER,RUSSIA,2,MANCHESTER,MOSCOW (SHEREMETYEVO),0,0,0,398,0,398,-100
03/03/2019 11:05,2018,4,EASTERN EUROPE -OTHER,RUSSIA,2,MANCHESTER,ROSTOV,0,0,0,133,0,133,-100
03/03/2019 11:05,2018,4,EASTERN EUROPE -OTHER,TURKMENISTAN,1,HEATHROW,ASHKHABAD,9467,9467,0,9987,9987,0,-5.20677
03/03/2019 11:05,2018,4,EASTERN EUROPE -OTHER,TURKMENISTAN,2,BIRMINGHAM,ASHKHABAD,56344,56344,0,42756,42756,0,31.78033
03/03/2019 11:05,2018,4,EASTERN EUROPE -OTHER,TURKMENISTAN,2,BIRMINGHAM,KRASNOVODSK,163,163,0,0,0,0,0
03/03/2019 11:05,2018,4,EASTERN EUROPE -OTHER,UKRAINE,1,GATWICK,KIEV (BORISPOL),192351,192351,0,170437,170437,0,12.85754
03/03/2019 11:05,2018,4,EASTERN EUROPE -OTHER,UKRAINE,1,HEATHROW,KIEV (BORISPOL),82243,81750,493,80344,80344,0,2.36359
03/03/2019 11:05,2018,4,EASTERN EUROPE -OTHER,UKRAINE,1,LUTON,KHARKOV OSNOVA INTL,3144,3144,0,0,0,0,0
03/03/2019 11:05,2018,4,EASTERN EUROPE -OTHER,UKRAINE,1,LUTON,KIEV (BORISPOL),0,0,0,926,926,0,-100
03/03/2019 11:05,2018,4,EASTERN EUROPE -OTHER,UKRAINE,1,LUTON,KIEV (ZHULYANY),55289,55289,0,41528,41528,0,33.13668
03/03/2019 11:05,2018,4,EASTERN EUROPE -OTHER,UKRAINE,1,LUTON,LVOV,32435,32435,0,0,0,0,0
03/03/2019 11:05,2018,4,EASTERN EUROPE -OTHER,UKRAINE,1,STANSTED,KIEV (BORISPOL),13444,13444,0,0,0,0,0
03/03/2019 11:05,2018,4,EASTERN EUROPE -OTHER,UKRAINE,1,STANSTED,LVOV,7959,7959,0,0,0,0,0
03/03/2019 11:05,2018,4,EASTERN EUROPE -OTHER,UKRAINE,2,BIRMINGHAM,KIEV (BORISPOL),95,95,0,0,0,0,0
03/03/2019 11:05,2018,4,EASTERN EUROPE -OTHER,UKRAINE,2,BIRMINGHAM,KIEV (ZHULYANY),0,0,0,110,0,110,-100
03/03/2019 11:05,2018,4,EASTERN EUROPE -OTHER,UKRAINE,2,EAST MIDLANDS INTERNATIONAL,KIEV (BORISPOL),375,0,375,0,0,0,0
03/03/2019 11:05,2018,4,EASTERN EUROPE -OTHER,UKRAINE,2,LEEDS BRADFORD,KIEV (BORISPOL),0,0,0,80,80,0,-100
03/03/2019 11:05,2018,4,EASTERN EUROPE -OTHER,UKRAINE,2,LIVERPOOL (JOHN LENNON),KIEV (BORISPOL),9361,0,9361,0,0,0,0
03/03/2019 11:05,2018,4,EASTERN EUROPE -OTHER,UKRAINE,2,LIVERPOOL (JOHN LENNON),KIEV (ZHULYANY),908,0,908,0,0,0,0
03/03/2019 11:05,2018,4,EASTERN EUROPE -OTHER,UKRAINE,2,MANCHESTER,KHARKOV OSNOVA INTL,646,0,646,565,0,565,14.33628
03/03/2019 11:05,2018,4,EASTERN EUROPE -OTHER,UKRAINE,2,MANCHESTER,KIEV (BORISPOL),1465,0,1465,210,0,210,597.61905
03/03/2019 11:05,2018,4,EASTERN EUROPE -OTHER,UZBEKISTAN,1,HEATHROW,TASHKENT,28710,28710,0,26138,26138,0,9.84008
03/03/2019 11:05,2018,25,NEAR EAST,ISRAEL,1,GATWICK,TEL AVIV,33787,33787,0,34115,33744,371,-0.96145
03/03/2019 11:05,2018,25,NEAR EAST,ISRAEL,1,HEATHROW,TEL AVIV,648088,648088,0,607277,607277,0,6.72033
03/03/2019 11:05,2018,25,NEAR EAST,ISRAEL,1,LUTON,OVDA,5192,4806,386,3644,3255,389,42.48079
03/03/2019 11:05,2018,25,NEAR EAST,ISRAEL,1,LUTON,TEL AVIV,472220,470812,1408,417773,414376,3397,13.03268
03/03/2019 11:05,2018,25,NEAR EAST,ISRAEL,1,STANSTED,TEL AVIV,30367,30195,172,19751,19657,94,53.74918
03/03/2019 11:05,2018,25,NEAR EAST,ISRAEL,2,BELFAST INTERNATIONAL,TEL AVIV,44,0,44,0,0,0,0
03/03/2019 11:05,2018,25,NEAR EAST,ISRAEL,2,BIRMINGHAM,TEL AVIV,0,0,0,148,148,0,-100
03/03/2019 11:05,2018,25,NEAR EAST,ISRAEL,2,EDINBURGH,TEL AVIV,3432,0,3432,0,0,0,0
03/03/2019 11:05,2018,25,NEAR EAST,ISRAEL,2,GLASGOW,TEL AVIV,260,0,260,0,0,0,0
03/03/2019 11:05,2018,25,NEAR EAST,ISRAEL,2,MANCHESTER,TEL AVIV,37292,37292,0,68634,68479,155,-45.66541
03/03/2019 11:05,2018,25,NEAR EAST,JORDAN,1,GATWICK,AQABA,3087,2197,890,568,0,568,443.48592
03/03/2019 11:05,2018,25,NEAR EAST,JORDAN,1,HEATHROW,AMMAN,230033,230033,0,219105,219105,0,4.98756
03/03/2019 11:05,2018,25,NEAR EAST,JORDAN,1,STANSTED,AQABA,554,336,218,0,0,0,0
03/03/2019 11:05,2018,25,NEAR EAST,JORDAN,2,BELFAST INTERNATIONAL,AMMAN,75,0,75,130,0,130,-42.30769
03/03/2019 11:05,2018,25,NEAR EAST,JORDAN,2,BIRMINGHAM,AMMAN (KING HUSSEIN),113,0,113,0,0,0,0
03/03/2019 11:05,2018,25,NEAR EAST,JORDAN,2,BIRMINGHAM,AQABA,596,0,596,570,0,570,4.5614
03/03/2019 11:05,2018,25,NEAR EAST,JORDAN,2,GLASGOW,AMMAN,23,0,23,0,0,0,0
03/03/2019 11:05,2018,25,NEAR EAST,JORDAN,2,GLASGOW,AQABA,0,0,0,578,0,578,-100
03/03/2019 11:05,2018,25,NEAR EAST,JORDAN,2,LEEDS BRADFORD,AMMAN,0,0,0,189,0,189,-100
03/03/2019 11:05,2018,25,NEAR EAST,JORDAN,2,LIVERPOOL (JOHN LENNON),AMMAN,134,0,134,0,0,0,0
03/03/2019 11:05,2018,25,NEAR EAST,JORDAN,2,MANCHESTER,AQABA,1036,0,1036,564,0,564,83.68794
03/03/2019 11:05,2018,25,NEAR EAST,LEBANON,1,HEATHROW,BEIRUT,300706,300706,0,292894,292894,0,2.66718
03/03/2019 11:05,2018,25,NEAR EAST,LEBANON,2,BELFAST INTERNATIONAL,BEIRUT,206,0,206,91,0,91,126.37363
03/03/2019 11:05,2018,25,NEAR EAST,LEBANON,2,BIRMINGHAM,BEIRUT,130,0,130,239,0,239,-45.60669
03/03/2019 11:05,2018,25,NEAR EAST,LEBANON,2,LEEDS BRADFORD,BEIRUT,0,0,0,189,0,189,-100
03/03/2019 11:05,2018,30,NORTH AFRICA,ALGERIA,1,GATWICK,ALGIERS,57169,57169,0,52299,52299,0,9.31184
03/03/2019 11:05,2018,30,NORTH AFRICA,ALGERIA,1,HEATHROW,ALGIERS,74355,74355,0,76544,76544,0,-2.85979
03/03/2019 11:05,2018,30,NORTH AFRICA,ALGERIA,2,BOURNEMOUTH,ALGIERS,0,0,0,1,1,0,-100
03/03/2019 11:05,2018,30,NORTH AFRICA,EGYPT,1,GATWICK,HURGHADA,212439,212439,0,182655,139494,43161,16.30615
03/03/2019 11:05,2018,30,NORTH AFRICA,EGYPT,1,GATWICK,MARSA ALAM,28048,28048,0,21076,21076,0,33.08028
03/03/2019 11:05,2018,30,NORTH AFRICA,EGYPT,1,HEATHROW,CAIRO,402530,402316,214,378097,378097,0,6.4621
03/03/2019 11:05,2018,30,NORTH AFRICA,EGYPT,1,HEATHROW,LUXOR,8629,8629,0,7167,7167,0,20.39905
03/03/2019 11:05,2018,30,NORTH AFRICA,EGYPT,1,LUTON,MARSA ALAM,49,49,0,0,0,0,0
03/03/2019 11:05,2018,30,NORTH AFRICA,EGYPT,1,STANSTED,HURGHADA,5616,5616,0,135,0,135,4060
03/03/2019 11:05,2018,30,NORTH AFRICA,EGYPT,2,BELFAST INTERNATIONAL,CAIRO,72,0,72,0,0,0,0
03/03/2019 11:05,2018,30,NORTH AFRICA,EGYPT,2,BIRMINGHAM,HURGHADA,99842,99654,188,35136,16495,18641,184.1587
03/03/2019 11:05,2018,30,NORTH AFRICA,EGYPT,2,BIRMINGHAM,MARSA ALAM,21439,21439,0,3200,3200,0,569.96875
03/03/2019 11:05,2018,30,NORTH AFRICA,EGYPT,2,BRISTOL,HURGHADA,31066,21891,9175,0,0,0,0
03/03/2019 11:05,2018,30,NORTH AFRICA,EGYPT,2,EAST MIDLANDS INTERNATIONAL,HURGHADA,7475,7475,0,0,0,0,0
03/03/2019 11:05,2018,30,NORTH AFRICA,EGYPT,2,GLASGOW,CAIRO,89,0,89,0,0,0,0
03/03/2019 11:05,2018,30,NORTH AFRICA,EGYPT,2,GLASGOW,HURGHADA,8031,8031,0,3605,3605,0,122.77393
03/03/2019 11:05,2018,30,NORTH AFRICA,EGYPT,2,MANCHESTER,HURGHADA,160244,160244,0,124993,81517,43476,28.20238
03/03/2019 11:05,2018,30,NORTH AFRICA,EGYPT,2,NEWCASTLE,HURGHADA,20234,20234,0,11796,11796,0,71.53272
03/03/2019 11:05,2018,30,NORTH AFRICA,MOROCCO,1,GATWICK,AGADIR (AL MASSIRA),91010,91010,0,92309,92229,80,-1.40723
03/03/2019 11:05,2018,30,NORTH AFRICA,MOROCCO,1,GATWICK,CASABLANCA MOHAMED V,65220,65220,0,55889,55889,0,16.69559
03/03/2019 11:05,2018,30,NORTH AFRICA,MOROCCO,1,GATWICK,FEZ,16251,16251,0,5298,5298,0,206.73839
03/03/2019 11:05,2018,30,NORTH AFRICA,MOROCCO,1,GATWICK,MARRAKESH,355350,355350,0,327835,327833,2,8.39294
03/03/2019 11:05,2018,30,NORTH AFRICA,MOROCCO,1,GATWICK,OUARZAZATE,722,0,722,819,0,819,-11.84371
03/03/2019 11:05,2018,30,NORTH AFRICA,MOROCCO,1,GATWICK,RABAT,228,0,228,6940,6647,293,-96.7147
03/03/2019 11:05,2018,30,NORTH AFRICA,MOROCCO,1,GATWICK,TANGIERS (IBN BATUTA),26187,26187,0,25428,25428,0,2.9849
03/03/2019 11:05,2018,30,NORTH AFRICA,MOROCCO,1,HEATHROW,CASABLANCA MOHAMED V,86215,86215,0,86369,86369,0,-0.1783
03/03/2019 11:05,2018,30,NORTH AFRICA,MOROCCO,1,HEATHROW,MARRAKESH,8684,8684,0,0,0,0,0
03/03/2019 11:05,2018,30,NORTH AFRICA,MOROCCO,1,HEATHROW,RABAT,14147,14147,0,10292,10292,0,37.45628
03/03/2019 11:05,2018,30,NORTH AFRICA,MOROCCO,1,LUTON,AGADIR (AL MASSIRA),632,445,187,0,0,0,0
03/03/2019 11:05,2018,30,NORTH AFRICA,MOROCCO,1,LUTON,CASABLANCA MOHAMED V,38,0,38,0,0,0,0
03/03/2019 11:05,2018,30,NORTH AFRICA,MOROCCO,1,LUTON,ESSAOUIRA,20038,20038,0,31249,31249,0,-35.87635
03/03/2019 11:05,2018,30,NORTH AFRICA,MOROCCO,1,LUTON,MARRAKESH,59507,59507,0,59749,59749,0,-0.40503
03/03/2019 11:05,2018,30,NORTH AFRICA,MOROCCO,1,LUTON,RABAT,0,0,0,44,0,44,-100
03/03/2019 11:05,2018,30,NORTH AFRICA,MOROCCO,1,STANSTED,AGADIR (AL MASSIRA),37660,37660,0,37553,37553,0,0.28493
03/03/2019 11:05,2018,30,NORTH AFRICA,MOROCCO,1,STANSTED,FEZ,35384,35384,0,36425,36425,0,-2.85793
03/03/2019 11:05,2018,30,NORTH AFRICA,MOROCCO,1,STANSTED,MARRAKESH,130668,128289,2379,132231,128455,3776,-1.18202
03/03/2019 11:05,2018,30,NORTH AFRICA,MOROCCO,1,STANSTED,RABAT,52556,52556,0,53775,53775,0,-2.26685
03/03/2019 11:05,2018,30,NORTH AFRICA,MOROCCO,2,BIRMINGHAM,AGADIR (AL MASSIRA),1616,1616,0,0,0,0,0
03/03/2019 11:05,2018,30,NORTH AFRICA,MOROCCO,2,BIRMINGHAM,MARRAKESH,18263,18263,0,19381,19173,208,-5.76854
03/03/2019 11:05,2018,30,NORTH AFRICA,MOROCCO,2,BRISTOL,AGADIR (AL MASSIRA),0,0,0,4,4,0,-100
03/03/2019 11:05,2018,30,NORTH AFRICA,MOROCCO,2,BRISTOL,MARRAKESH,0,0,0,18989,18989,0,-100
03/03/2019 11:05,2018,30,NORTH AFRICA,MOROCCO,2,CARDIFF WALES,MARRAKESH,3,3,0,0,0,0,0
03/03/2019 11:05,2018,30,NORTH AFRICA,MOROCCO,2,EAST MIDLANDS INTERNATIONAL,MARRAKESH,180,180,0,0,0,0,0
03/03/2019 11:05,2018,30,NORTH AFRICA,MOROCCO,2,LEEDS BRADFORD,AGADIR (AL MASSIRA),0,0,0,18,0,18,-100
03/03/2019 11:05,2018,30,NORTH AFRICA,MOROCCO,2,LEEDS BRADFORD,TANGIERS (IBN BATUTA),0,0,0,17,0,17,-100
03/03/2019 11:05,2018,30,NORTH AFRICA,MOROCCO,2,LIVERPOOL (JOHN LENNON),AGADIR (AL MASSIRA),170,170,0,0,0,0,0
03/03/2019 11:05,2018,30,NORTH AFRICA,MOROCCO,2,LIVERPOOL (JOHN LENNON),MARRAKESH,36083,36083,0,35787,35787,0,0.82712
03/03/2019 11:05,2018,30,NORTH AFRICA,MOROCCO,2,MANCHESTER,AGADIR (AL MASSIRA),93019,93019,0,47662,47662,0,95.16386
03/03/2019 11:05,2018,30,NORTH AFRICA,MOROCCO,2,MANCHESTER,CASABLANCA MOHAMED V,25684,25684,0,21519,21519,0,19.35499
03/03/2019 11:05,2018,30,NORTH AFRICA,MOROCCO,2,MANCHESTER,MARRAKESH,89984,88765,1219,83727,81333,2394,7.4731
03/03/2019 11:05,2018,30,NORTH AFRICA,TUNISIA,1,GATWICK,ENFIDHA - HAMMAMET INTL,67630,55691,11939,0,0,0,0
03/03/2019 11:05,2018,30,NORTH AFRICA,TUNISIA,1,GATWICK,MONASTIR,635,635,0,0,0,0,0
03/03/2019 11:05,2018,30,NORTH AFRICA,TUNISIA,1,GATWICK,TUNIS,31450,31077,373,28758,28758,0,9.36087
03/03/2019 11:05,2018,30,NORTH AFRICA,TUNISIA,1,HEATHROW,TUNIS,46090,46090,0,45179,45179,0,2.01642
03/03/2019 11:05,2018,30,NORTH AFRICA,TUNISIA,1,STANSTED,ENFIDHA - HAMMAMET INTL,8937,8937,0,0,0,0,0
03/03/2019 11:05,2018,30,NORTH AFRICA,TUNISIA,1,STANSTED,TUNIS,0,0,0,29,0,29,-100
03/03/2019 11:05,2018,30,NORTH AFRICA,TUNISIA,2,BIRMINGHAM,ENFIDHA - HAMMAMET INTL,29108,16930,12178,0,0,0,0
03/03/2019 11:05,2018,30,NORTH AFRICA,TUNISIA,2,BIRMINGHAM,MONASTIR,430,430,0,0,0,0,0
03/03/2019 11:05,2018,30,NORTH AFRICA,TUNISIA,2,BIRMINGHAM,TUNIS,371,0,371,0,0,0,0
03/03/2019 11:05,2018,30,NORTH AFRICA,TUNISIA,2,BRISTOL,ENFIDHA - HAMMAMET INTL,8715,0,8715,0,0,0,0
03/03/2019 11:05,2018,30,NORTH AFRICA,TUNISIA,2,GLASGOW,ENFIDHA - HAMMAMET INTL,13978,13978,0,0,0,0,0
03/03/2019 11:05,2018,30,NORTH AFRICA,TUNISIA,2,GLASGOW,MONASTIR,449,449,0,0,0,0,0
03/03/2019 11:05,2018,30,NORTH AFRICA,TUNISIA,2,MANCHESTER,ENFIDHA - HAMMAMET INTL,53699,41660,12039,0,0,0,0
03/03/2019 11:05,2018,30,NORTH AFRICA,TUNISIA,2,MANCHESTER,MONASTIR,797,426,371,0,0,0,0
03/03/2019 11:05,2018,30,NORTH AFRICA,TUNISIA,2,NEWCASTLE,ENFIDHA - HAMMAMET INTL,10738,10738,0,0,0,0,0
03/03/2019 11:05,2018,35,EAST AFRICA,ETHIOPIA,1,HEATHROW,ADDIS ABABA,237158,237158,0,190483,190483,0,24.5035
03/03/2019 11:05,2018,35,EAST AFRICA,ETHIOPIA,2,MANCHESTER,ADDIS ABABA,1820,1820,0,0,0,0,0
03/03/2019 11:05,2018,35,EAST AFRICA,KENYA,1,HEATHROW,NAIROBI,360461,360461,0,337920,337920,0,6.67051
03/03/2019 11:05,2018,35,EAST AFRICA,RWANDA,1,GATWICK,KIGALI,17684,17684,0,14132,14132,0,25.13445
03/03/2019 11:05,2018,35,EAST AFRICA,TANZANIA,2,LIVERPOOL (JOHN LENNON),DAR-ES-SALAAM,0,0,0,140,0,140,-100
03/03/2019 11:05,2018,40,WEST AFRICA,GAMBIA,1,GATWICK,BANJUL,55848,34059,21789,42775,21980,20795,30.56224
03/03/2019 11:05,2018,40,WEST AFRICA,GAMBIA,2,BIRMINGHAM,BANJUL,15801,15801,0,11480,11474,6,37.63937
03/03/2019 11:05,2018,40,WEST AFRICA,GAMBIA,2,EAST MIDLANDS INTERNATIONAL,BANJUL,205,0,205,0,0,0,0
03/03/2019 11:05,2018,40,WEST AFRICA,GAMBIA,2,MANCHESTER,BANJUL,30270,30270,0,18822,18605,217,60.82244
03/03/2019 11:05,2018,40,WEST AFRICA,GHANA,1,GATWICK,ACCRA,794,0,794,460,0,460,72.6087
03/03/2019 11:05,2018,40,WEST AFRICA,GHANA,1,HEATHROW,ACCRA,208978,208978,0,208615,208615,0,0.174
03/03/2019 11:05,2018,40,WEST AFRICA,NIGERIA,1,GATWICK,LAGOS,7273,7273,0,63944,63596,348,-88.62599
03/03/2019 11:05,2018,40,WEST AFRICA,NIGERIA,1,HEATHROW,ABUJA,121274,121274,0,98457,98457,0,23.17458
03/03/2019 11:05,2018,40,WEST AFRICA,NIGERIA,1,HEATHROW,LAGOS,374601,374601,0,340449,340449,0,10.03146
03/03/2019 11:05,2018,40,WEST AFRICA,NIGERIA,1,LUTON,ABUJA,0,0,0,3,0,3,-100
03/03/2019 11:05,2018,40,WEST AFRICA,NIGERIA,1,SOUTHEND,IBADAN,0,0,0,144,144,0,-100
03/03/2019 11:05,2018,40,WEST AFRICA,NIGERIA,2,DONCASTER SHEFFIELD,LAGOS,137,0,137,0,0,0,0
03/03/2019 11:05,2018,40,WEST AFRICA,SENEGAL,2,MANCHESTER,DAKAR,0,0,0,221,221,0,-100
03/03/2019 11:05,2018,45,CENTRAL AFRICA,ANGOLA,1,HEATHROW,LUANDA,3035,3035,0,11122,11122,0,-72.71174
03/03/2019 11:05,2018,50,SOUTHERN AFRICA,REPUBLIC OF SOUTH AFRICA,1,GATWICK,CAPE TOWN,50708,49260,1448,45188,45188,0,12.21563
03/03/2019 11:05,2018,50,SOUTHERN AFRICA,REPUBLIC OF SOUTH AFRICA,1,HEATHROW,CAPE TOWN,331787,331787,0,330897,330897,0,0.26897
03/03/2019 11:05,2018,50,SOUTHERN AFRICA,REPUBLIC OF SOUTH AFRICA,1,HEATHROW,DURBAN,9650,9650,0,0,0,0,0
03/03/2019 11:05,2018,50,SOUTHERN AFRICA,REPUBLIC OF SOUTH AFRICA,1,HEATHROW,JOHANNESBURG,933357,933357,0,954716,954716,0,-2.23721
03/03/2019 11:05,2018,50,SOUTHERN AFRICA,REPUBLIC OF SOUTH AFRICA,2,MANCHESTER,CAPE TOWN,1086,0,1086,0,0,0,0
03/03/2019 11:05,2018,55,MIDDLE EAST,BAHRAIN,1,HEATHROW,BAHRAIN,382507,382507,0,328920,328920,0,16.2918
03/03/2019 11:05,2018,55,MIDDLE EAST,IRAN,1,HEATHROW,TEHRAN IMAM KHOMEINI,122937,122937,0,153207,153207,0,-19.75758
03/03/2019 11:05,2018,55,MIDDLE EAST,IRAQ,1,GATWICK,BAGHDAD (GECA),9686,9686,0,7814,7784,30,23.957
03/03/2019 11:05,2018,55,MIDDLE EAST,IRAQ,1,GATWICK,ERBIL INTERNATIONAL,176,176,0,0,0,0,0
03/03/2019 11:05,2018,55,MIDDLE EAST,IRAQ,1,GATWICK,SULAYMANIYAH INT,6929,6929,0,7164,7164,0,-3.28029
03/03/2019 11:05,2018,55,MIDDLE EAST,IRAQ,2,MANCHESTER,BAGHDAD (GECA),8839,8839,0,9645,9645,0,-8.35666
03/03/2019 11:05,2018,55,MIDDLE EAST,KUWAIT,1,HEATHROW,KUWAIT,379240,379240,0,384392,384392,0,-1.3403
03/03/2019 11:05,2018,55,MIDDLE EAST,OMAN,1,GATWICK,MUSCAT,573,0,573,0,0,0,0
03/03/2019 11:05,2018,55,MIDDLE EAST,OMAN,1,HEATHROW,MUSCAT,384466,384466,0,331675,331675,0,15.91648
03/03/2019 11:05,2018,55,MIDDLE EAST,OMAN,2,BIRMINGHAM,MUSCAT,581,0,581,0,0,0,0
03/03/2019 11:05,2018,55,MIDDLE EAST,OMAN,2,MANCHESTER,MUSCAT,133065,132476,589,69078,69078,0,92.63007
03/03/2019 11:05,2018,55,MIDDLE EAST,QATAR,1,GATWICK,DOHA HAMAD,170314,170296,18,0,0,0,0
03/03/2019 11:05,2018,55,MIDDLE EAST,QATAR,1,HEATHROW,DOHA HAMAD,1181541,1181541,0,1287225,1287197,28,-8.21022
03/03/2019 11:05,2018,55,MIDDLE EAST,QATAR,1,STANSTED,DOHA HAMAD,0,0,0,185,185,0,-100
03/03/2019 11:05,2018,55,MIDDLE EAST,QATAR,2,BIRMINGHAM,DOHA HAMAD,121002,121002,0,126331,126331,0,-4.21828
03/03/2019 11:05,2018,55,MIDDLE EAST,QATAR,2,CARDIFF WALES,DOHA HAMAD,55568,55568,0,0,0,0,0
03/03/2019 11:05,2018,55,MIDDLE EAST,QATAR,2,EDINBURGH,DOHA HAMAD,140727,140727,0,132788,132788,0,5.9787
03/03/2019 11:05,2018,55,MIDDLE EAST,QATAR,2,GLASGOW,DOHA HAMAD,0,0,0,496,496,0,-100
03/03/2019 11:05,2018,55,MIDDLE EAST,QATAR,2,MANCHESTER,DOHA HAMAD,327951,327951,0,327247,327247,0,0.21513
03/03/2019 11:05,2018,55,MIDDLE EAST,SAUDI ARABIA,1,HEATHROW,JEDDAH,249869,249869,0,230160,230160,0,8.56317
03/03/2019 11:05,2018,55,MIDDLE EAST,SAUDI ARABIA,1,HEATHROW,MEDINA,3300,3300,0,2302,2302,0,43.35361
03/03/2019 11:05,2018,55,MIDDLE EAST,SAUDI ARABIA,1,HEATHROW,RIYADH,276302,276302,0,250805,250805,0,10.16607
03/03/2019 11:05,2018,55,MIDDLE EAST,SAUDI ARABIA,2,MANCHESTER,JEDDAH,97621,97621,0,91908,91908,0,6.216
03/03/2019 11:05,2018,55,MIDDLE EAST,SAUDI ARABIA,2,MANCHESTER,MEDINA,0,0,0,187,187,0,-100
03/03/2019 11:05,2018,55,MIDDLE EAST,SAUDI ARABIA,2,MANCHESTER,RIYADH,0,0,0,9462,9462,0,-100
03/03/2019 11:05,2018,55,MIDDLE EAST,UNITED ARAB EMIRATES,1,GATWICK,ABU DHABI INTERNATIONAL,195,0,195,0,0,0,0
03/03/2019 11:05,2018,55,MIDDLE EAST,UNITED ARAB EMIRATES,1,GATWICK,DUBAI,1029841,1029841,0,966466,966466,0,6.5574
03/03/2019 11:05,2018,55,MIDDLE EAST,UNITED ARAB EMIRATES,1,GATWICK,DUBAI (WORLD CENTRAL),567,0,567,7209,0,7209,-92.13483
03/03/2019 11:05,2018,55,MIDDLE EAST,UNITED ARAB EMIRATES,1,HEATHROW,ABU DHABI INTERNATIONAL,1010388,1010160,228,1004473,1004473,0,0.58887
03/03/2019 11:05,2018,55,MIDDLE EAST,UNITED ARAB EMIRATES,1,HEATHROW,DUBAI,2610784,2610784,0,2873011,2873011,0,-9.12725
03/03/2019 11:05,2018,55,MIDDLE EAST,UNITED ARAB EMIRATES,1,STANSTED,ABU DHABI INTERNATIONAL,234,0,234,0,0,0,0
03/03/2019 11:05,2018,55,MIDDLE EAST,UNITED ARAB EMIRATES,1,STANSTED,DUBAI,122643,122643,0,0,0,0,0
03/03/2019 11:05,2018,55,MIDDLE EAST,UNITED ARAB EMIRATES,2,BIRMINGHAM,DUBAI,710517,710517,0,744477,744477,0,-4.56159
03/03/2019 11:05,2018,55,MIDDLE EAST,UNITED ARAB EMIRATES,2,BIRMINGHAM,DUBAI (WORLD CENTRAL),581,0,581,6111,0,6111,-90.49255
03/03/2019 11:05,2018,55,MIDDLE EAST,UNITED ARAB EMIRATES,2,CARDIFF WALES,DUBAI (WORLD CENTRAL),0,0,0,1136,0,1136,-100
03/03/2019 11:05,2018,55,MIDDLE EAST,UNITED ARAB EMIRATES,2,EAST MIDLANDS INTERNATIONAL,DUBAI (WORLD CENTRAL),0,0,0,106,0,106,-100
03/03/2019 11:05,2018,55,MIDDLE EAST,UNITED ARAB EMIRATES,2,EDINBURGH,ABU DHABI INTERNATIONAL,84346,84346,0,117646,117646,0,-28.30525
03/03/2019 11:05,2018,55,MIDDLE EAST,UNITED ARAB EMIRATES,2,EDINBURGH,DUBAI,40565,40565,0,0,0,0,0
03/03/2019 11:05,2018,55,MIDDLE EAST,UNITED ARAB EMIRATES,2,GLASGOW,DUBAI,455037,455037,0,466953,466953,0,-2.55186
03/03/2019 11:05,2018,55,MIDDLE EAST,UNITED ARAB EMIRATES,2,GLASGOW,DUBAI (WORLD CENTRAL),0,0,0,1146,0,1146,-100
03/03/2019 11:05,2018,55,MIDDLE EAST,UNITED ARAB EMIRATES,2,LIVERPOOL (JOHN LENNON),DUBAI (WORLD CENTRAL),160,0,160,99,0,99,61.61616
03/03/2019 11:05,2018,55,MIDDLE EAST,UNITED ARAB EMIRATES,2,MANCHESTER,ABU DHABI INTERNATIONAL,426468,425877,591,429034,428835,199,-0.59809
03/03/2019 11:05,2018,55,MIDDLE EAST,UNITED ARAB EMIRATES,2,MANCHESTER,DUBAI,1000214,1000214,0,990269,990269,0,1.00427
03/03/2019 11:05,2018,55,MIDDLE EAST,UNITED ARAB EMIRATES,2,MANCHESTER,DUBAI (WORLD CENTRAL),685,0,685,7995,0,7995,-91.43215
03/03/2019 11:05,2018,55,MIDDLE EAST,UNITED ARAB EMIRATES,2,NEWCASTLE,DUBAI,242302,241964,338,237856,237856,0,1.8692
03/03/2019 11:05,2018,55,MIDDLE EAST,UNITED ARAB EMIRATES,2,NEWCASTLE,DUBAI (WORLD CENTRAL),0,0,0,865,574,291,-100
03/03/2019 11:05,2018,55,MIDDLE EAST,UNITED ARAB EMIRATES,2,PRESTWICK,DUBAI,630,0,630,0,0,0,0
03/03/2019 11:05,2018,60,INDIAN SUB-CONTINENT,BANGLADESH,1,HEATHROW,DHAKHA,80436,80436,0,73116,73116,0,10.01149
03/03/2019 11:05,2018,60,INDIAN SUB-CONTINENT,BANGLADESH,1,HEATHROW,SYLHET,52345,52345,0,48927,48927,0,6.98592
03/03/2019 11:05,2018,60,INDIAN SUB-CONTINENT,INDIA,1,GATWICK,COCHIN,577,0,577,0,0,0,0
03/03/2019 11:05,2018,60,INDIAN SUB-CONTINENT,INDIA,1,GATWICK,GOA,43279,29584,13695,42331,25480,16851,2.23949
03/03/2019 11:05,2018,60,INDIAN SUB-CONTINENT,INDIA,1,HEATHROW,AHMEDABAD,65910,65910,0,66719,66719,0,-1.21255
03/03/2019 11:05,2018,60,INDIAN SUB-CONTINENT,INDIA,1,HEATHROW,AMRITSAR,4689,4689,0,5003,5003,0,-6.27623
03/03/2019 11:05,2018,60,INDIAN SUB-CONTINENT,INDIA,1,HEATHROW,BANGALORE (BENGALURU),179321,179321,0,171746,171746,0,4.41058
03/03/2019 11:05,2018,60,INDIAN SUB-CONTINENT,INDIA,1,HEATHROW,CHENNAI,136869,136869,0,132218,132218,0,3.51768
03/03/2019 11:05,2018,60,INDIAN SUB-CONTINENT,INDIA,1,HEATHROW,DELHI,1021351,1021351,0,1023509,1023509,0,-0.21084
03/03/2019 11:05,2018,60,INDIAN SUB-CONTINENT,INDIA,1,HEATHROW,HYDERABAD ( RAJIV GHANDI ),140459,140459,0,136468,136468,0,2.9245
03/03/2019 11:05,2018,60,INDIAN SUB-CONTINENT,INDIA,1,HEATHROW,MUMBAI,1121997,1121997,0,963977,963977,0,16.39251
03/03/2019 11:05,2018,60,INDIAN SUB-CONTINENT,INDIA,2,BIRMINGHAM,AMRITSAR,76088,76088,0,76931,76931,0,-1.09579
03/03/2019 11:05,2018,60,INDIAN SUB-CONTINENT,INDIA,2,BIRMINGHAM,COCHIN,575,0,575,0,0,0,0
03/03/2019 11:05,2018,60,INDIAN SUB-CONTINENT,INDIA,2,BIRMINGHAM,DELHI,70715,70715,0,78706,78706,0,-10.15297
03/03/2019 11:05,2018,60,INDIAN SUB-CONTINENT,INDIA,2,BIRMINGHAM,GOA,7788,0,7788,1662,0,1662,368.59206
03/03/2019 11:05,2018,60,INDIAN SUB-CONTINENT,INDIA,2,MANCHESTER,COCHIN,586,0,586,0,0,0,0
03/03/2019 11:05,2018,60,INDIAN SUB-CONTINENT,INDIA,2,MANCHESTER,GOA,64307,46846,17461,46755,33761,12994,37.54037
03/03/2019 11:05,2018,60,INDIAN SUB-CONTINENT,INDIA,2,MANCHESTER,MUMBAI,15299,15299,0,0,0,0,0
03/03/2019 11:05,2018,60,INDIAN SUB-CONTINENT,PAKISTAN,1,GATWICK,BENAZIR BHUTTO INTERNATIONAL AIRPORT,724,0,724,1067,0,1067,-32.1462
03/03/2019 11:05,2018,60,INDIAN SUB-CONTINENT,PAKISTAN,1,HEATHROW,BENAZIR BHUTTO INTERNATIONAL AIRPORT,123633,123633,0,124286,124286,0,-0.5254
03/03/2019 11:05,2018,60,INDIAN SUB-CONTINENT,PAKISTAN,1,HEATHROW,ISLAMABAD INTERNATIONAL AIRPORT,25933,25933,0,0,0,0,0
03/03/2019 11:05,2018,60,INDIAN SUB-CONTINENT,PAKISTAN,1,HEATHROW,KARACHI,49278,49278,0,44720,44720,0,10.19231
03/03/2019 11:05,2018,60,INDIAN SUB-CONTINENT,PAKISTAN,1,HEATHROW,LAHORE,92561,92561,0,86623,86623,0,6.85499
03/03/2019 11:05,2018,60,INDIAN SUB-CONTINENT,PAKISTAN,2,BIRMINGHAM,BENAZIR BHUTTO INTERNATIONAL AIRPORT,81726,81726,0,81275,81275,0,0.55491
03/03/2019 11:05,2018,60,INDIAN SUB-CONTINENT,PAKISTAN,2,DONCASTER SHEFFIELD,BENAZIR BHUTTO INTERNATIONAL AIRPORT,139,0,139,0,0,0,0
03/03/2019 11:05,2018,60,INDIAN SUB-CONTINENT,PAKISTAN,2,MANCHESTER,BENAZIR BHUTTO INTERNATIONAL AIRPORT,153159,153159,0,186185,186185,0,-17.73827
03/03/2019 11:05,2018,60,INDIAN SUB-CONTINENT,PAKISTAN,2,MANCHESTER,ISLAMABAD INTERNATIONAL AIRPORT,33116,33116,0,0,0,0,0
03/03/2019 11:05,2018,60,INDIAN SUB-CONTINENT,PAKISTAN,2,MANCHESTER,KARACHI,23,23,0,1951,1951,0,-98.82112
03/03/2019 11:05,2018,60,INDIAN SUB-CONTINENT,PAKISTAN,2,MANCHESTER,LAHORE,51716,51716,0,50251,50251,0,2.91536
03/03/2019 11:05,2018,60,INDIAN SUB-CONTINENT,SRI LANKA,1,GATWICK,COLOMBO,8482,0,8482,10620,0,10620,-20.13183
03/03/2019 11:05,2018,60,INDIAN SUB-CONTINENT,SRI LANKA,1,HEATHROW,COLOMBO,225211,225211,0,218075,218075,0,3.27227
03/03/2019 11:05,2018,60,INDIAN SUB-CONTINENT,SRI LANKA,1,HEATHROW,MATTALA RAJAPAKSA,0,0,0,3,3,0,-100
03/03/2019 11:05,2018,60,INDIAN SUB-CONTINENT,SRI LANKA,2,MANCHESTER,COLOMBO,362,0,362,0,0,0,0
03/03/2019 11:05,2018,65,FAR EAST,BRUNEI,1,HEATHROW,BANDAR SERI BEGAWAN,79062,79062,0,78340,78340,0,0.92162
03/03/2019 11:05,2018,65,FAR EAST,CHINA,1,GATWICK,BEIJING,224,224,0,0,0,0,0
03/03/2019 11:05,2018,65,FAR EAST,CHINA,1,GATWICK,CHENGDU,27214,27214,0,0,0,0,0
03/03/2019 11:05,2018,65,FAR EAST,CHINA,1,GATWICK,CHONGQING JIANGBEI INTERNATIONAL,11034,11034,0,20795,20795,0,-46.93917
03/03/2019 11:05,2018,65,FAR EAST,CHINA,1,GATWICK,SHANGHAI (PU DONG),4526,4526,0,198,198,0,2185.85859
03/03/2019 11:05,2018,65,FAR EAST,CHINA,1,GATWICK,TIANJIN,13821,13821,0,19441,19441,0,-28.90798
03/03/2019 11:05,2018,65,FAR EAST,CHINA,1,GATWICK,XIAMEN,0,0,0,12,0,12,-100
03/03/2019 11:05,2018,65,FAR EAST,CHINA,1,HEATHROW,BEIJING,530314,530314,0,485503,485061,442,9.22981
03/03/2019 11:05,2018,65,FAR EAST,CHINA,1,HEATHROW,CHANGSHA HUANGHUA INTERNATIONAL AIRPORT,34452,34452,0,0,0,0,0
03/03/2019 11:05,2018,65,FAR EAST,CHINA,1,HEATHROW,CHENGDU,0,0,0,1562,1562,0,-100
03/03/2019 11:05,2018,65,FAR EAST,CHINA,1,HEATHROW,CHONGQING JIANGBEI INTERNATIONAL,12886,12886,0,0,0,0,0
03/03/2019 11:05,2018,65,FAR EAST,CHINA,1,HEATHROW,GUANGZHOU BAIYUN INTERNATIONAL,157231,157231,0,208653,208653,0,-24.64475
03/03/2019 11:05,2018,65,FAR EAST,CHINA,1,HEATHROW,QINGDAO,28699,26695,2004,2125,0,2125,1250.54118
03/03/2019 11:05,2018,65,FAR EAST,CHINA,1,HEATHROW,SANYA PHOENIX INTERNATIONAL,9383,9383,0,0,0,0,0
03/03/2019 11:05,2018,65,FAR EAST,CHINA,1,HEATHROW,SHANGHAI (PU DONG),511003,511003,0,486159,486159,0,5.11026
03/03/2019 11:05,2018,65,FAR EAST,CHINA,1,HEATHROW,TIANJIN,4851,4851,0,0,0,0,0
03/03/2019 11:05,2018,65,FAR EAST,CHINA,1,HEATHROW,WUHAN TIANHE INTERNATIONAL,30425,30425,0,0,0,0,0
03/03/2019 11:05,2018,65,FAR EAST,CHINA,1,HEATHROW,XIAN XIANYANG,25331,25331,0,0,0,0,0
03/03/2019 11:05,2018,65,FAR EAST,CHINA,1,STANSTED,BEIJING,0,0,0,258,0,258,-100
03/03/2019 11:05,2018,65,FAR EAST,CHINA,2,BIRMINGHAM,BEIJING,0,0,0,209,209,0,-100
03/03/2019 11:05,2018,65,FAR EAST,CHINA,2,EDINBURGH,BEIJING,19329,19329,0,0,0,0,0
03/03/2019 11:05,2018,65,FAR EAST,CHINA,2,MANCHESTER,BEIJING,75536,75536,0,90191,90191,0,-16.24885
03/03/2019 11:05,2018,65,FAR EAST,HONG KONG,1,GATWICK,HONG KONG (CHEK LAP KOK),166758,166758,0,145058,145058,0,14.95953
03/03/2019 11:05,2018,65,FAR EAST,HONG KONG,1,HEATHROW,HONG KONG (CHEK LAP KOK),1572021,1572021,0,1588805,1588805,0,-1.05639
03/03/2019 11:05,2018,65,FAR EAST,HONG KONG,2,MANCHESTER,HONG KONG (CHEK LAP KOK),183553,183553,0,131841,131639,202,39.223
03/03/2019 11:05,2018,65,FAR EAST,INDONESIA,1,HEATHROW,JAKARTA (SOEKARNO-HATTA INTNL),55264,55264,0,34893,34893,0,58.38134
03/03/2019 11:05,2018,65,FAR EAST,JAPAN,1,HEATHROW,TOKYO (HANEDA),587932,587932,0,487627,487627,0,20.57003
03/03/2019 11:05,2018,65,FAR EAST,JAPAN,1,HEATHROW,TOKYO (NARITA),130054,130054,0,137817,137817,0,-5.63283
03/03/2019 11:05,2018,65,FAR EAST,MALAYSIA,1,GATWICK,LANGKAWI,585,0,585,0,0,0,0
03/03/2019 11:05,2018,65,FAR EAST,MALAYSIA,1,HEATHROW,KUALA LUMPUR (SEPANG),521674,521674,0,692039,692039,0,-24.61783
03/03/2019 11:05,2018,65,FAR EAST,MALAYSIA,2,BIRMINGHAM,LANGKAWI,582,0,582,0,0,0,0
03/03/2019 11:05,2018,65,FAR EAST,MALAYSIA,2,MANCHESTER,LANGKAWI,582,0,582,0,0,0,0
03/03/2019 11:05,2018,65,FAR EAST,MONGOLIA,1,GATWICK,ULAN BATOR,80,0,80,0,0,0,0
03/03/2019 11:05,2018,65,FAR EAST,PHILIPPINES,1,HEATHROW,MANILA,161339,161339,0,130309,130309,0,23.81263
03/03/2019 11:05,2018,65,FAR EAST,REPUBLIC OF KOREA,1,GATWICK,SEOUL (INCHEON),186,0,186,0,0,0,0
03/03/2019 11:05,2018,65,FAR EAST,REPUBLIC OF KOREA,1,HEATHROW,SEOUL (INCHEON),526584,526584,0,506857,506857,0,3.89202
03/03/2019 11:05,2018,65,FAR EAST,REPUBLIC OF KOREA,2,GLASGOW,SEOUL (INCHEON),320,0,320,985,0,985,-67.51269
03/03/2019 11:05,2018,65,FAR EAST,SINGAPORE,1,GATWICK,SINGAPORE,119140,119140,0,25548,25548,0,366.33787
03/03/2019 11:05,2018,65,FAR EAST,SINGAPORE,1,HEATHROW,SINGAPORE,1421105,1421105,0,1234806,1234806,0,15.08731
03/03/2019 11:05,2018,65,FAR EAST,SINGAPORE,2,MANCHESTER,SINGAPORE,83766,83766,0,85443,85443,0,-1.96271
03/03/2019 11:05,2018,65,FAR EAST,TAIWAN,1,GATWICK,TAIPEI,114895,114895,0,9447,9447,0,1116.2062
03/03/2019 11:05,2018,65,FAR EAST,TAIWAN,1,HEATHROW,TAIPEI,31225,31225,0,35682,35682,0,-12.49089
03/03/2019 11:05,2018,65,FAR EAST,THAILAND,1,GATWICK,KRABI,4915,0,4915,1207,0,1207,307.20795
03/03/2019 11:05,2018,65,FAR EAST,THAILAND,1,GATWICK,PHUKET,13970,0,13970,16469,0,16469,-15.17396
03/03/2019 11:05,2018,65,FAR EAST,THAILAND,1,GATWICK,U-TAPAO,585,0,585,0,0,0,0
03/03/2019 11:05,2018,65,FAR EAST,THAILAND,1,HEATHROW,BANGKOK SUVARNABHUMI ,828432,828432,0,850446,850446,0,-2.58852
03/03/2019 11:05,2018,65,FAR EAST,THAILAND,2,BIRMINGHAM,PHUKET,4988,0,4988,1259,0,1259,296.18745
03/03/2019 11:05,2018,65,FAR EAST,THAILAND,2,BIRMINGHAM,U-TAPAO,588,0,588,0,0,0,0
03/03/2019 11:05,2018,65,FAR EAST,THAILAND,2,LIVERPOOL (JOHN LENNON),BANGKOK SUVARNABHUMI ,0,0,0,50,0,50,-100
03/03/2019 11:05,2018,65,FAR EAST,THAILAND,2,MANCHESTER,PHUKET,7900,0,7900,6524,0,6524,21.09135
03/03/2019 11:05,2018,65,FAR EAST,VIETNAM,1,GATWICK,PHU QUOC INTERNATIONAL,10074,0,10074,3892,0,3892,158.83864
03/03/2019 11:05,2018,65,FAR EAST,VIETNAM,1,HEATHROW,HANOI,86576,86576,0,84975,84975,0,1.88408
03/03/2019 11:05,2018,65,FAR EAST,VIETNAM,1,HEATHROW,HO CHI MINH CITY,65749,65749,0,65357,65357,0,0.59978
03/03/2019 11:05,2018,70,AUSTRALASIA,AUSTRALIA,1,HEATHROW,BRISBANE,0,0,0,335,0,335,-100
03/03/2019 11:05,2018,70,AUSTRALASIA,AUSTRALIA,1,HEATHROW,MELBOURNE,51499,51499,0,142615,142615,0,-63.88949
03/03/2019 11:05,2018,70,AUSTRALASIA,AUSTRALIA,1,HEATHROW,PERTH (AUSTRALIA),108737,108737,0,0,0,0,0
03/03/2019 11:05,2018,70,AUSTRALASIA,AUSTRALIA,1,HEATHROW,SYDNEY,192603,192603,0,261176,260844,332,-26.25548
03/03/2019 11:05,2018,70,AUSTRALASIA,AUSTRALIA,2,LIVERPOOL (JOHN LENNON),SYDNEY,0,0,0,60,0,60,-100
03/03/2019 11:05,2018,70,AUSTRALASIA,NEW ZEALAND,1,HEATHROW,AUCKLAND INTERNATIONAL,17419,17419,0,17566,17566,0,-0.83684
03/03/2019 11:05,2018,75,CANADA,CANADA,1,GATWICK,CALGARY,134547,134547,0,131049,131049,0,2.66923
03/03/2019 11:05,2018,75,CANADA,CANADA,1,GATWICK,EDMONTON,11070,11070,0,10008,10008,0,10.61151
03/03/2019 11:05,2018,75,CANADA,CANADA,1,GATWICK,GANDER,342,342,0,0,0,0,0
03/03/2019 11:05,2018,75,CANADA,CANADA,1,GATWICK,HALIFAX INT,49572,49572,0,0,0,0,0
03/03/2019 11:05,2018,75,CANADA,CANADA,1,GATWICK,MONTREAL (DORVAL),25226,25226,0,25624,25624,0,-1.55323
03/03/2019 11:05,2018,75,CANADA,CANADA,1,GATWICK,OTTAWA INTERNATIONAL,774,774,0,38032,38032,0,-97.96487
03/03/2019 11:05,2018,75,CANADA,CANADA,1,GATWICK,ST JOHNS,500,500,0,0,0,0,0
03/03/2019 11:05,2018,75,CANADA,CANADA,1,GATWICK,TORONTO,431505,431505,0,429508,429508,0,0.46495
03/03/2019 11:05,2018,75,CANADA,CANADA,1,GATWICK,VANCOUVER,163669,163669,0,197016,197016,0,-16.92604
03/03/2019 11:05,2018,75,CANADA,CANADA,1,GATWICK,WINNIPEG,5553,5553,0,4907,4907,0,13.16487
03/03/2019 11:05,2018,75,CANADA,CANADA,1,HEATHROW,CALGARY,291248,291248,0,305003,305003,0,-4.50979
03/03/2019 11:05,2018,75,CANADA,CANADA,1,HEATHROW,HALIFAX INT,71799,71799,0,78785,78785,0,-8.86717
03/03/2019 11:05,2018,75,CANADA,CANADA,1,HEATHROW,MONTREAL (DORVAL),321085,321085,0,320668,320668,0,0.13004
03/03/2019 11:05,2018,75,CANADA,CANADA,1,HEATHROW,OTTAWA INTERNATIONAL,114365,114365,0,113286,113286,0,0.95246
03/03/2019 11:05,2018,75,CANADA,CANADA,1,HEATHROW,ST JOHNS,39606,39606,0,33467,33467,0,18.34344
03/03/2019 11:05,2018,75,CANADA,CANADA,1,HEATHROW,TORONTO,1091315,1091315,0,1047947,1047947,0,4.13838
03/03/2019 11:05,2018,75,CANADA,CANADA,1,HEATHROW,VANCOUVER,546666,546666,0,504218,504218,0,8.41858
03/03/2019 11:05,2018,75,CANADA,CANADA,1,STANSTED,TORONTO,20211,20211,0,0,0,0,0
03/03/2019 11:05,2018,75,CANADA,CANADA,2,BIRMINGHAM,MONTREAL (DORVAL),48,0,48,0,0,0,0
03/03/2019 11:05,2018,75,CANADA,CANADA,2,BIRMINGHAM,TORONTO,467,467,0,13734,13734,0,-96.59968
03/03/2019 11:05,2018,75,CANADA,CANADA,2,EDINBURGH,TORONTO,30316,30316,0,27714,27714,0,9.38876
03/03/2019 11:05,2018,75,CANADA,CANADA,2,GLASGOW,CALGARY,248,248,0,0,0,0,0
03/03/2019 11:05,2018,75,CANADA,CANADA,2,GLASGOW,HALIFAX INT,614,614,0,130,130,0,372.30769
03/03/2019 11:05,2018,75,CANADA,CANADA,2,GLASGOW,ST JOHNS,0,0,0,134,134,0,-100
03/03/2019 11:05,2018,75,CANADA,CANADA,2,GLASGOW,TORONTO,137736,137736,0,126888,126888,0,8.54927
03/03/2019 11:05,2018,75,CANADA,CANADA,2,GLASGOW,VANCOUVER,13126,13126,0,13137,13137,0,-0.08373
03/03/2019 11:05,2018,75,CANADA,CANADA,2,LEEDS BRADFORD,TORONTO,57,11,46,37,0,37,54.05405
03/03/2019 11:05,2018,75,CANADA,CANADA,2,MANCHESTER,EDMONTON,0,0,0,3,3,0,-100
03/03/2019 11:05,2018,75,CANADA,CANADA,2,MANCHESTER,IQALUIT,1,1,0,0,0,0,0
03/03/2019 11:05,2018,75,CANADA,CANADA,2,MANCHESTER,ST JOHNS,0,0,0,158,158,0,-100
03/03/2019 11:05,2018,75,CANADA,CANADA,2,MANCHESTER,TORONTO,134653,134653,0,112321,112192,129,19.8823
03/03/2019 11:05,2018,75,CANADA,CANADA,2,MANCHESTER,VANCOUVER,34925,34925,0,30706,30706,0,13.73999
03/03/2019 11:05,2018,80,UNITED STATES OF AMERICA,USA,1,GATWICK,AUSTIN (BERGSTROM),54214,54214,0,0,0,0,0
03/03/2019 11:05,2018,80,UNITED STATES OF AMERICA,USA,1,GATWICK,BOSTON,209106,209106,0,136407,136407,0,53.29565
03/03/2019 11:05,2018,80,UNITED STATES OF AMERICA,USA,1,GATWICK,CHARLOTTE,0,0,0,145,0,145,-100
03/03/2019 11:05,2018,80,UNITED STATES OF AMERICA,USA,1,GATWICK,CHICAGO (O'HARE),145697,145697,0,1,0,1,14569600
03/03/2019 11:05,2018,80,UNITED STATES OF AMERICA,USA,1,GATWICK,DALLAS/FORT WORTH,0,0,0,13,0,13,-100
03/03/2019 11:05,2018,80,UNITED STATES OF AMERICA,USA,1,GATWICK,DENVER INTERNATIONAL,84217,84217,0,18848,18848,0,346.82194
03/03/2019 11:05,2018,80,UNITED STATES OF AMERICA,USA,1,GATWICK,FORT LAUDERDALE,179438,179438,0,112394,112394,0,59.65087
03/03/2019 11:05,2018,80,UNITED STATES OF AMERICA,USA,1,GATWICK,LAS VEGAS,306923,306923,0,257297,257297,0,19.28744
03/03/2019 11:05,2018,80,UNITED STATES OF AMERICA,USA,1,GATWICK,LOS ANGELES INTERNATIONAL,283710,283710,0,213673,213673,0,32.77766
03/03/2019 11:05,2018,80,UNITED STATES OF AMERICA,USA,1,GATWICK,NEW YORK (JF KENNEDY),593620,593300,320,450820,450820,0,31.67561
03/03/2019 11:05,2018,80,UNITED STATES OF AMERICA,USA,1,GATWICK,NEWBURGH/USA,344,344,0,0,0,0,0
03/03/2019 11:05,2018,80,UNITED STATES OF AMERICA,USA,1,GATWICK,OAKLAND,193615,193448,167,190032,190032,0,1.88547
03/03/2019 11:05,2018,80,UNITED STATES OF AMERICA,USA,1,GATWICK,ORLANDO,876408,876102,306,826319,825642,677,6.0617
03/03/2019 11:05,2018,80,UNITED STATES OF AMERICA,USA,1,GATWICK,PHOENIX,0,0,0,168,0,168,-100
03/03/2019 11:05,2018,80,UNITED STATES OF AMERICA,USA,1,GATWICK,SAN BERNARDINO (NORTON AFB),0,0,0,1,0,1,-100
03/03/2019 11:05,2018,80,UNITED STATES OF AMERICA,USA,1,GATWICK,SANFORD,40391,0,40391,39862,0,39862,1.32708
03/03/2019 11:05,2018,80,UNITED STATES OF AMERICA,USA,1,GATWICK,SEATTLE (TACOMA),95714,95549,165,27745,27745,0,244.97747
03/03/2019 11:05,2018,80,UNITED STATES OF AMERICA,USA,1,GATWICK,TAMPA,156527,156527,0,141000,141000,0,11.01206
03/03/2019 11:05,2018,80,UNITED STATES OF AMERICA,USA,1,HEATHROW,ATLANTA,617007,617007,0,644081,644081,0,-4.20351
03/03/2019 11:05,2018,80,UNITED STATES OF AMERICA,USA,1,HEATHROW,AUSTIN (BERGSTROM),171798,171798,0,128887,128887,0,33.29351
03/03/2019 11:05,2018,80,UNITED STATES OF AMERICA,USA,1,HEATHROW,BALTIMORE,128387,128387,0,124756,124423,333,2.91048
03/03/2019 11:05,2018,80,UNITED STATES OF AMERICA,USA,1,HEATHROW,BOSTON,849443,849443,0,814124,813880,244,4.33828
03/03/2019 11:05,2018,80,UNITED STATES OF AMERICA,USA,1,HEATHROW,CHARLOTTE,302048,302048,0,303240,303240,0,-0.39309
03/03/2019 11:05,2018,80,UNITED STATES OF AMERICA,USA,1,HEATHROW,CHICAGO (O'HARE),1158537,1158537,0,1062328,1062328,0,9.05643
03/03/2019 11:05,2018,80,UNITED STATES OF AMERICA,USA,1,HEATHROW,CLEVELAND,147,0,147,787,0,787,-81.32147
03/03/2019 11:05,2018,80,UNITED STATES OF AMERICA,USA,1,HEATHROW,DALLAS/FORT WORTH,710461,710461,0,677113,677113,0,4.92503
03/03/2019 11:05,2018,80,UNITED STATES OF AMERICA,USA,1,HEATHROW,DENVER INTERNATIONAL,282201,282201,0,195398,195206,192,44.42369
03/03/2019 11:05,2018,80,UNITED STATES OF AMERICA,USA,1,HEATHROW,DETROIT,190484,190484,0,188797,188797,0,0.89355
03/03/2019 11:05,2018,80,UNITED STATES OF AMERICA,USA,1,HEATHROW,FORT LAUDERDALE,0,0,0,176,0,176,-100
03/03/2019 11:05,2018,80,UNITED STATES OF AMERICA,USA,1,HEATHROW,HOUSTON,500856,500856,0,474976,474976,0,5.4487
03/03/2019 11:05,2018,80,UNITED STATES OF AMERICA,USA,1,HEATHROW,INDIANAPOLIS,0,0,0,243,243,0,-100
03/03/2019 11:05,2018,80,UNITED STATES OF AMERICA,USA,1,HEATHROW,JACKSONVILLE,415,0,415,553,0,553,-24.95479
03/03/2019 11:05,2018,80,UNITED STATES OF AMERICA,USA,1,HEATHROW,LAS VEGAS,297490,297490,0,320674,320674,0,-7.22977
03/03/2019 11:05,2018,80,UNITED STATES OF AMERICA,USA,1,HEATHROW,LOS ANGELES INTERNATIONAL,1657737,1657580,157,1600587,1600415,172,3.57057
03/03/2019 11:05,2018,80,UNITED STATES OF AMERICA,USA,1,HEATHROW,MIAMI INTERNATIONAL,1029366,1029176,190,985148,984961,187,4.48846
03/03/2019 11:05,2018,80,UNITED STATES OF AMERICA,USA,1,HEATHROW,MINNEAPOLIS-ST PAUL,131244,131244,0,129130,128430,700,1.63711
03/03/2019 11:05,2018,80,UNITED STATES OF AMERICA,USA,1,HEATHROW,NASHVILLE METROPOLITAN,58512,58183,329,0,0,0,0
03/03/2019 11:05,2018,80,UNITED STATES OF AMERICA,USA,1,HEATHROW,NEW ORLEANS,85932,85932,0,56519,55994,525,52.04091
03/03/2019 11:05,2018,80,UNITED STATES OF AMERICA,USA,1,HEATHROW,NEW YORK (JF KENNEDY),3034155,3034155,0,2945744,2945744,0,3.00131
03/03/2019 11:05,2018,80,UNITED STATES OF AMERICA,USA,1,HEATHROW,NEW YORK (NEWARK),1084275,1084275,0,1020678,1020678,0,6.23086
03/03/2019 11:05,2018,80,UNITED STATES OF AMERICA,USA,1,HEATHROW,OAKLAND,164,0,164,0,0,0,0
03/03/2019 11:05,2018,80,UNITED STATES OF AMERICA,USA,1,HEATHROW,ORLANDO,2268,1611,657,661,0,661,243.11649
03/03/2019 11:05,2018,80,UNITED STATES OF AMERICA,USA,1,HEATHROW,PHILADELPHIA INTERNATIONAL,466399,465749,650,485316,485316,0,-3.89787
03/03/2019 11:05,2018,80,UNITED STATES OF AMERICA,USA,1,HEATHROW,PHOENIX,248620,248620,0,220180,220027,153,12.9167
03/03/2019 11:05,2018,80,UNITED STATES OF AMERICA,USA,1,HEATHROW,PORTLAND (OREGON),32248,32248,0,24421,24421,0,32.05028
03/03/2019 11:05,2018,80,UNITED STATES OF AMERICA,USA,1,HEATHROW,RALEIGH,132254,132254,0,125410,125410,0,5.4573
03/03/2019 11:05,2018,80,UNITED STATES OF AMERICA,USA,1,HEATHROW,SALT LAKE CITY,71790,71790,0,83169,83169,0,-13.68178
03/03/2019 11:05,2018,80,UNITED STATES OF AMERICA,USA,1,HEATHROW,SAN DIEGO,173771,173771,0,174586,174586,0,-0.46682
03/03/2019 11:05,2018,80,UNITED STATES OF AMERICA,USA,1,HEATHROW,SAN FRANCISCO,1055976,1055976,0,1009584,1009584,0,4.59516
03/03/2019 11:05,2018,80,UNITED STATES OF AMERICA,USA,1,HEATHROW,SAN JOSE,110016,110016,0,113463,113463,0,-3.03799
03/03/2019 11:05,2018,80,UNITED STATES OF AMERICA,USA,1,HEATHROW,SEATTLE (TACOMA),397356,397356,0,384596,384596,0,3.31777
03/03/2019 11:05,2018,80,UNITED STATES OF AMERICA,USA,1,HEATHROW,TAMPA,0,0,0,2,2,0,-100
03/03/2019 11:05,2018,80,UNITED STATES OF AMERICA,USA,1,HEATHROW,WASHINGTON (DULLES),838389,838389,0,845634,845634,0,-0.85675
03/03/2019 11:05,2018,80,UNITED STATES OF AMERICA,USA,1,LONDON CITY,NEW YORK (JF KENNEDY),10514,10514,0,11966,11966,0,-12.13438
03/03/2019 11:05,2018,80,UNITED STATES OF AMERICA,USA,1,LUTON,MIAMI INTERNATIONAL,0,0,0,11,0,11,-100
03/03/2019 11:05,2018,80,UNITED STATES OF AMERICA,USA,1,STANSTED,BOSTON,22494,22494,0,0,0,0,0
03/03/2019 11:05,2018,80,UNITED STATES OF AMERICA,USA,1,STANSTED,LAS VEGAS,3347,3347,0,6507,6507,0,-48.56309
03/03/2019 11:05,2018,80,UNITED STATES OF AMERICA,USA,1,STANSTED,LOS ANGELES INTERNATIONAL,0,0,0,347,347,0,-100
03/03/2019 11:05,2018,80,UNITED STATES OF AMERICA,USA,1,STANSTED,NEW YORK (NEWARK),48216,48216,0,1742,1742,0,2667.85304
03/03/2019 11:05,2018,80,UNITED STATES OF AMERICA,USA,1,STANSTED,ORLANDO,12242,12242,0,28314,28314,0,-56.76344
03/03/2019 11:05,2018,80,UNITED STATES OF AMERICA,USA,1,STANSTED,SANFORD,0,0,0,3462,0,3462,-100
03/03/2019 11:05,2018,80,UNITED STATES OF AMERICA,USA,1,STANSTED,WASHINGTON (DULLES),6033,6033,0,0,0,0,0
03/03/2019 11:05,2018,80,UNITED STATES OF AMERICA,USA,2,BELFAST INTERNATIONAL,LAS VEGAS,597,0,597,631,0,631,-5.38827
03/03/2019 11:05,2018,80,UNITED STATES OF AMERICA,USA,2,BELFAST INTERNATIONAL,NEW YORK (NEWARK),322,322,0,2924,2924,0,-88.98769
03/03/2019 11:05,2018,80,UNITED STATES OF AMERICA,USA,2,BELFAST INTERNATIONAL,NEWBURGH/USA,24261,24261,0,16676,16676,0,45.48453
03/03/2019 11:05,2018,80,UNITED STATES OF AMERICA,USA,2,BELFAST INTERNATIONAL,ORLANDO,18565,17288,1277,9176,6117,3059,102.32127
03/03/2019 11:05,2018,80,UNITED STATES OF AMERICA,USA,2,BELFAST INTERNATIONAL,PROVIDENCE,13378,13378,0,6518,6518,0,105.24701
03/03/2019 11:05,2018,80,UNITED STATES OF AMERICA,USA,2,BIRMINGHAM,NEW YORK (JF KENNEDY),0,0,0,1656,1656,0,-100
03/03/2019 11:05,2018,80,UNITED STATES OF AMERICA,USA,2,BIRMINGHAM,NEW YORK (NEWARK),7059,7059,0,65510,65510,0,-89.22455
03/03/2019 11:05,2018,80,UNITED STATES OF AMERICA,USA,2,BIRMINGHAM,ORLANDO,0,0,0,624,624,0,-100
03/03/2019 11:05,2018,80,UNITED STATES OF AMERICA,USA,2,BIRMINGHAM,SANFORD,18066,0,18066,16021,0,16021,12.7645
03/03/2019 11:05,2018,80,UNITED STATES OF AMERICA,USA,2,BRISTOL,SANFORD,10504,0,10504,11458,0,11458,-8.32606
03/03/2019 11:05,2018,80,UNITED STATES OF AMERICA,USA,2,CARDIFF WALES,ORLANDO,325,325,0,1260,0,1260,-74.20635
03/03/2019 11:05,2018,80,UNITED STATES OF AMERICA,USA,2,CARDIFF WALES,TAMPA,276,276,0,0,0,0,0
03/03/2019 11:05,2018,80,UNITED STATES OF AMERICA,USA,2,DONCASTER SHEFFIELD,NEW YORK (JF KENNEDY),332,332,0,0,0,0,0
03/03/2019 11:05,2018,80,UNITED STATES OF AMERICA,USA,2,EAST MIDLANDS INTERNATIONAL,NEW YORK (NEWARK),410,410,0,874,874,0,-53.08924
03/03/2019 11:05,2018,80,UNITED STATES OF AMERICA,USA,2,EAST MIDLANDS INTERNATIONAL,SANFORD,10839,0,10839,10908,0,10908,-0.63256
03/03/2019 11:05,2018,80,UNITED STATES OF AMERICA,USA,2,EDINBURGH,ATLANTA,0,0,0,73,0,73,-100
03/03/2019 11:05,2018,80,UNITED STATES OF AMERICA,USA,2,EDINBURGH,CHICAGO (O'HARE),52383,52383,0,36668,36668,0,42.85753
03/03/2019 11:05,2018,80,UNITED STATES OF AMERICA,USA,2,EDINBURGH,HOUSTON,266,266,0,0,0,0,0
03/03/2019 11:05,2018,80,UNITED STATES OF AMERICA,USA,2,EDINBURGH,LOS ANGELES INTERNATIONAL,0,0,0,185,185,0,-100
03/03/2019 11:05,2018,80,UNITED STATES OF AMERICA,USA,2,EDINBURGH,NEW YORK (JF KENNEDY),135142,135142,0,127570,127570,0,5.93556
03/03/2019 11:05,2018,80,UNITED STATES OF AMERICA,USA,2,EDINBURGH,NEW YORK (NEWARK),108537,108537,0,139111,139042,69,-21.97813
03/03/2019 11:05,2018,80,UNITED STATES OF AMERICA,USA,2,EDINBURGH,NEWBURGH/USA,64687,64687,0,44445,44385,60,45.54393
03/03/2019 11:05,2018,80,UNITED STATES OF AMERICA,USA,2,EDINBURGH,OAKLAND,0,0,0,2,2,0,-100
03/03/2019 11:05,2018,80,UNITED STATES OF AMERICA,USA,2,EDINBURGH,PROVIDENCE,31898,31898,0,20749,20749,0,53.73271
03/03/2019 11:05,2018,80,UNITED STATES OF AMERICA,USA,2,EDINBURGH,SANFORD,2157,0,2157,2305,0,2305,-6.42082
03/03/2019 11:05,2018,80,UNITED STATES OF AMERICA,USA,2,EDINBURGH,WASHINGTON (DULLES),37150,37150,0,0,0,0,0
03/03/2019 11:05,2018,80,UNITED STATES OF AMERICA,USA,2,EDINBURGH,WINDSOR LOCKS BRADLEY INTL,3656,3656,0,18644,18644,0,-80.39047
03/03/2019 11:05,2018,80,UNITED STATES OF AMERICA,USA,2,GLASGOW,LAS VEGAS,11725,11725,0,25078,16035,9043,-53.24587
03/03/2019 11:05,2018,80,UNITED STATES OF AMERICA,USA,2,GLASGOW,NEW YORK (JF KENNEDY),34154,34154,0,31702,31702,0,7.73453
03/03/2019 11:05,2018,80,UNITED STATES OF AMERICA,USA,2,GLASGOW,NEW YORK (NEWARK),46448,46005,443,69881,69881,0,-33.53272
03/03/2019 11:05,2018,80,UNITED STATES OF AMERICA,USA,2,GLASGOW,ORLANDO,88106,88106,0,98136,81286,16850,-10.22051
03/03/2019 11:05,2018,80,UNITED STATES OF AMERICA,USA,2,GLASGOW,PHILADELPHIA INTERNATIONAL,42167,42167,0,39691,39691,0,6.23819
03/03/2019 11:05,2018,80,UNITED STATES OF AMERICA,USA,2,GLASGOW,SANFORD,23072,0,23072,21755,0,21755,6.05378
03/03/2019 11:05,2018,80,UNITED STATES OF AMERICA,USA,2,LEEDS BRADFORD,NEW YORK (NEWARK),3090,3090,0,3067,3067,0,0.74992
03/03/2019 11:05,2018,80,UNITED STATES OF AMERICA,USA,2,LIVERPOOL (JOHN LENNON),NEW YORK (JF KENNEDY),326,326,0,0,0,0,0
03/03/2019 11:05,2018,80,UNITED STATES OF AMERICA,USA,2,LIVERPOOL (JOHN LENNON),OMAHA,0,0,0,165,165,0,-100
03/03/2019 11:05,2018,80,UNITED STATES OF AMERICA,USA,2,MANCHESTER,ATLANTA,118245,118245,0,130007,130007,0,-9.04721
03/03/2019 11:05,2018,80,UNITED STATES OF AMERICA,USA,2,MANCHESTER,BOSTON,44489,44489,0,53829,53829,0,-17.35124
03/03/2019 11:05,2018,80,UNITED STATES OF AMERICA,USA,2,MANCHESTER,CHARLOTTE,106,0,106,0,0,0,0
03/03/2019 11:05,2018,80,UNITED STATES OF AMERICA,USA,2,MANCHESTER,CHICAGO (O'HARE),34426,34339,87,77784,77784,0,-55.74154
03/03/2019 11:05,2018,80,UNITED STATES OF AMERICA,USA,2,MANCHESTER,DALLAS/FORT WORTH,131,131,0,0,0,0,0
03/03/2019 11:05,2018,80,UNITED STATES OF AMERICA,USA,2,MANCHESTER,DETROIT,118,0,118,0,0,0,0
03/03/2019 11:05,2018,80,UNITED STATES OF AMERICA,USA,2,MANCHESTER,HOUSTON,62580,62580,0,60292,60206,86,3.79486
03/03/2019 11:05,2018,80,UNITED STATES OF AMERICA,USA,2,MANCHESTER,LAS VEGAS,142334,142334,0,156302,156302,0,-8.93655
03/03/2019 11:05,2018,80,UNITED STATES OF AMERICA,USA,2,MANCHESTER,LOS ANGELES INTERNATIONAL,42921,42819,102,44108,43983,125,-2.69112
03/03/2019 11:05,2018,80,UNITED STATES OF AMERICA,USA,2,MANCHESTER,MIAMI INTERNATIONAL,197,0,197,27417,27417,0,-99.28147
03/03/2019 11:05,2018,80,UNITED STATES OF AMERICA,USA,2,MANCHESTER,MOLINE (QUAD CITY),0,0,0,69,0,69,-100
03/03/2019 11:05,2018,80,UNITED STATES OF AMERICA,USA,2,MANCHESTER,NASHVILLE METROPOLITAN,0,0,0,96,0,96,-100
03/03/2019 11:05,2018,80,UNITED STATES OF AMERICA,USA,2,MANCHESTER,NEW YORK (JF KENNEDY),347873,347873,0,317553,317553,0,9.54801
03/03/2019 11:05,2018,80,UNITED STATES OF AMERICA,USA,2,MANCHESTER,NEW YORK (NEWARK),113097,113097,0,108496,108496,0,4.24071
03/03/2019 11:05,2018,80,UNITED STATES OF AMERICA,USA,2,MANCHESTER,ORLANDO,484811,484811,0,479902,479902,0,1.02292
03/03/2019 11:05,2018,80,UNITED STATES OF AMERICA,USA,2,MANCHESTER,PHILADELPHIA INTERNATIONAL,129394,129394,0,126438,126438,0,2.3379
03/03/2019 11:05,2018,80,UNITED STATES OF AMERICA,USA,2,MANCHESTER,SAN FRANCISCO,62331,62331,0,55695,55695,0,11.91489
03/03/2019 11:05,2018,80,UNITED STATES OF AMERICA,USA,2,MANCHESTER,SANFORD,39320,0,39320,48150,293,47857,-18.33853
03/03/2019 11:05,2018,80,UNITED STATES OF AMERICA,USA,2,MANCHESTER,SEATTLE (TACOMA),18867,18867,0,0,0,0,0
03/03/2019 11:05,2018,80,UNITED STATES OF AMERICA,USA,2,MANCHESTER,WASHINGTON (DULLES),547,547,0,0,0,0,0
03/03/2019 11:05,2018,80,UNITED STATES OF AMERICA,USA,2,NEWCASTLE,NEW YORK (NEWARK),3147,3147,0,3303,3303,0,-4.72298
03/03/2019 11:05,2018,80,UNITED STATES OF AMERICA,USA,2,NEWCASTLE,SANFORD,22579,22579,0,23073,23073,0,-2.14103
03/03/2019 11:05,2018,85,CENTRAL AMERICA,COSTA RICA,1,GATWICK,LIBERIA,30409,0,30409,30443,0,30443,-0.11168
03/03/2019 11:05,2018,85,CENTRAL AMERICA,COSTA RICA,1,GATWICK,SAN JOSE COST RICA,54659,54659,0,55360,55360,0,-1.26626
03/03/2019 11:05,2018,85,CENTRAL AMERICA,CUBA,1,GATWICK,CUNAGUA (CAYO COCO),17163,17163,0,13056,13056,0,31.4568
03/03/2019 11:05,2018,85,CENTRAL AMERICA,CUBA,1,GATWICK,HAVANA,77462,77381,81,78831,78831,0,-1.73663
03/03/2019 11:05,2018,85,CENTRAL AMERICA,CUBA,1,GATWICK,HOLGUIN (FRANK PAIS),31796,31796,0,31699,31699,0,0.306
03/03/2019 11:05,2018,85,CENTRAL AMERICA,CUBA,1,GATWICK,VARADERO,25512,0,25512,44043,14317,29726,-42.07479
03/03/2019 11:05,2018,85,CENTRAL AMERICA,CUBA,1,HEATHROW,HAVANA,385,385,0,0,0,0,0
03/03/2019 11:05,2018,85,CENTRAL AMERICA,CUBA,2,BELFAST INTERNATIONAL,VARADERO,0,0,0,567,0,567,-100
03/03/2019 11:05,2018,85,CENTRAL AMERICA,CUBA,2,GLASGOW,CUNAGUA (CAYO COCO),640,640,0,614,308,306,4.23453
03/03/2019 11:05,2018,85,CENTRAL AMERICA,CUBA,2,MANCHESTER,CUNAGUA (CAYO COCO),31124,31124,0,34508,34508,0,-9.80642
03/03/2019 11:05,2018,85,CENTRAL AMERICA,CUBA,2,MANCHESTER,HOLGUIN (FRANK PAIS),51886,51886,0,56145,56145,0,-7.58572
03/03/2019 11:05,2018,85,CENTRAL AMERICA,CUBA,2,MANCHESTER,SANTA CLARA,14492,14492,0,11085,0,11085,30.73523
03/03/2019 11:05,2018,85,CENTRAL AMERICA,CUBA,2,MANCHESTER,VARADERO,31626,31626,0,30763,30520,243,2.80532
03/03/2019 11:05,2018,85,CENTRAL AMERICA,DOMINICAN REPUBLIC,1,GATWICK,LA ROMANA,6502,0,6502,3236,0,3236,100.92707
03/03/2019 11:05,2018,85,CENTRAL AMERICA,DOMINICAN REPUBLIC,1,GATWICK,PUERTO PLATA,9897,0,9897,30566,0,30566,-67.62089
03/03/2019 11:05,2018,85,CENTRAL AMERICA,DOMINICAN REPUBLIC,1,GATWICK,PUNTA CANA,168288,84743,83545,157638,71457,86181,6.75599
03/03/2019 11:05,2018,85,CENTRAL AMERICA,DOMINICAN REPUBLIC,2,BIRMINGHAM,LA ROMANA,6102,0,6102,3525,0,3525,73.10638
03/03/2019 11:05,2018,85,CENTRAL AMERICA,DOMINICAN REPUBLIC,2,BIRMINGHAM,PUNTA CANA,34761,291,34470,41908,213,41695,-17.05402
03/03/2019 11:05,2018,85,CENTRAL AMERICA,DOMINICAN REPUBLIC,2,BRISTOL,PUNTA CANA,13106,0,13106,0,0,0,0
03/03/2019 11:05,2018,85,CENTRAL AMERICA,DOMINICAN REPUBLIC,2,GLASGOW,LA ROMANA,214,0,214,0,0,0,0
03/03/2019 11:05,2018,85,CENTRAL AMERICA,DOMINICAN REPUBLIC,2,MANCHESTER,LA ROMANA,5856,0,5856,4013,0,4013,45.92574
03/03/2019 11:05,2018,85,CENTRAL AMERICA,DOMINICAN REPUBLIC,2,MANCHESTER,PUERTO PLATA,24452,0,24452,30494,0,30494,-19.81373
03/03/2019 11:05,2018,85,CENTRAL AMERICA,DOMINICAN REPUBLIC,2,MANCHESTER,PUNTA CANA,114169,50553,63616,104856,13359,91497,8.8817
03/03/2019 11:05,2018,85,CENTRAL AMERICA,MEXICO,1,GATWICK,CANCUN,397071,397071,0,403490,371732,31758,-1.59087
03/03/2019 11:05,2018,85,CENTRAL AMERICA,MEXICO,1,GATWICK,MERIDA,325,325,0,0,0,0,0
03/03/2019 11:05,2018,85,CENTRAL AMERICA,MEXICO,1,GATWICK,PUERTO VALLARTA,30800,0,30800,31446,0,31446,-2.05432
03/03/2019 11:05,2018,85,CENTRAL AMERICA,MEXICO,1,HEATHROW,MEXICO CITY,253958,253958,0,278469,278469,0,-8.80206
03/03/2019 11:05,2018,85,CENTRAL AMERICA,MEXICO,1,STANSTED,CANCUN,7089,7089,0,32645,25106,7539,-78.28458
03/03/2019 11:05,2018,85,CENTRAL AMERICA,MEXICO,1,STANSTED,PUERTO VALLARTA,301,0,301,0,0,0,0
03/03/2019 11:05,2018,85,CENTRAL AMERICA,MEXICO,2,BELFAST INTERNATIONAL,CANCUN,1288,0,1288,2849,0,2849,-54.79115
03/03/2019 11:05,2018,85,CENTRAL AMERICA,MEXICO,2,BIRMINGHAM,CANCUN,56410,56410,0,60486,45549,14937,-6.73875
03/03/2019 11:05,2018,85,CENTRAL AMERICA,MEXICO,2,BRISTOL,CANCUN,13923,13637,286,11843,9571,2272,17.56312
03/03/2019 11:05,2018,85,CENTRAL AMERICA,MEXICO,2,CARDIFF WALES,CANCUN,291,291,0,0,0,0,0
03/03/2019 11:05,2018,85,CENTRAL AMERICA,MEXICO,2,EAST MIDLANDS INTERNATIONAL,CANCUN,11750,11750,0,12055,12055,0,-2.53007
03/03/2019 11:05,2018,85,CENTRAL AMERICA,MEXICO,2,EDINBURGH,CANCUN,2356,2356,0,2334,2334,0,0.94259
03/03/2019 11:05,2018,85,CENTRAL AMERICA,MEXICO,2,GLASGOW,CANCUN,45948,22945,23003,37209,8612,28597,23.48625
03/03/2019 11:05,2018,85,CENTRAL AMERICA,MEXICO,2,MANCHESTER,CANCUN,287877,287877,0,231560,205831,25729,24.32069
03/03/2019 11:05,2018,85,CENTRAL AMERICA,MEXICO,2,MANCHESTER,PUERTO VALLARTA,30578,0,30578,30757,0,30757,-0.58198
03/03/2019 11:05,2018,85,CENTRAL AMERICA,MEXICO,2,NEWCASTLE,CANCUN,22868,22868,0,23876,23876,0,-4.22181
03/03/2019 11:05,2018,90,SOUTH AMERICA,ARGENTINA,1,GATWICK,BUENOS AIRES,105918,105918,0,0,0,0,0
03/03/2019 11:05,2018,90,SOUTH AMERICA,ARGENTINA,1,HEATHROW,BUENOS AIRES,173064,173064,0,177065,177065,0,-2.25962
03/03/2019 11:05,2018,90,SOUTH AMERICA,BRAZIL,1,HEATHROW,RIO DE JANEIRO (GALEAO),122280,122280,0,105685,105685,0,15.70232
03/03/2019 11:05,2018,90,SOUTH AMERICA,BRAZIL,1,HEATHROW,SAO PAULO (GUARULHOS),451517,451517,0,406101,406101,0,11.18342
03/03/2019 11:05,2018,90,SOUTH AMERICA,CHILE,1,HEATHROW,SANTIAGO DE CHILE,78256,78256,0,71817,71817,0,8.96584
03/03/2019 11:05,2018,90,SOUTH AMERICA,COLOMBIA,1,HEATHROW,BOGOTA,162566,162566,0,158548,158548,0,2.53425
03/03/2019 11:05,2018,90,SOUTH AMERICA,COLOMBIA,2,MANCHESTER,BOGOTA,0,0,0,1,1,0,-100
03/03/2019 11:05,2018,90,SOUTH AMERICA,PERU,1,GATWICK,LIMA,45815,45815,0,47807,47807,0,-4.16675
03/03/2019 11:05,2018,90,SOUTH AMERICA,PERU,1,HEATHROW,LIMA,0,0,0,274,274,0,-100
03/03/2019 11:05,2018,95,CARIBBEAN AREA,ANTIGUA AND BARBUDA,1,GATWICK,ANTIGUA,161620,161620,0,158955,158955,0,1.67658
03/03/2019 11:05,2018,95,CARIBBEAN AREA,ANTIGUA AND BARBUDA,1,HEATHROW,ANTIGUA,268,268,0,0,0,0,0
03/03/2019 11:05,2018,95,CARIBBEAN AREA,ANTIGUA AND BARBUDA,2,MANCHESTER,ANTIGUA,1220,1220,0,3314,3314,0,-63.18648
03/03/2019 11:05,2018,95,CARIBBEAN AREA,BAHAMAS,1,HEATHROW,NASSAU,60556,60556,0,55580,55580,0,8.95286
03/03/2019 11:05,2018,95,CARIBBEAN AREA,BARBADOS,1,GATWICK,BRIDGETOWN,463991,388696,75295,450836,383946,66890,2.91791
03/03/2019 11:05,2018,95,CARIBBEAN AREA,BARBADOS,1,HEATHROW,BRIDGETOWN,11840,9548,2292,4988,2438,2550,137.36969
03/03/2019 11:05,2018,95,CARIBBEAN AREA,BARBADOS,1,LUTON,BRIDGETOWN,300,300,0,0,0,0,0
03/03/2019 11:05,2018,95,CARIBBEAN AREA,BARBADOS,1,STANSTED,BRIDGETOWN,581,0,581,0,0,0,0
03/03/2019 11:05,2018,95,CARIBBEAN AREA,BARBADOS,2,BELFAST INTERNATIONAL,BRIDGETOWN,590,0,590,564,0,564,4.60993
03/03/2019 11:05,2018,95,CARIBBEAN AREA,BARBADOS,2,BIRMINGHAM,BRIDGETOWN,37959,0,37959,35686,278,35408,6.36944
03/03/2019 11:05,2018,95,CARIBBEAN AREA,BARBADOS,2,BOURNEMOUTH,BRIDGETOWN,853,0,853,2159,0,2159,-60.49097
03/03/2019 11:05,2018,95,CARIBBEAN AREA,BARBADOS,2,BRISTOL,BRIDGETOWN,596,0,596,576,0,576,3.47222
03/03/2019 11:05,2018,95,CARIBBEAN AREA,BARBADOS,2,CARDIFF WALES,BRIDGETOWN,3969,276,3693,4490,0,4490,-11.60356
03/03/2019 11:05,2018,95,CARIBBEAN AREA,BARBADOS,2,DONCASTER SHEFFIELD,BRIDGETOWN,597,0,597,597,0,597,0
03/03/2019 11:05,2018,95,CARIBBEAN AREA,BARBADOS,2,EAST MIDLANDS INTERNATIONAL,BRIDGETOWN,1173,0,1173,854,0,854,37.35363
03/03/2019 11:05,2018,95,CARIBBEAN AREA,BARBADOS,2,GLASGOW,BRIDGETOWN,8100,0,8100,7824,0,7824,3.52761
03/03/2019 11:05,2018,95,CARIBBEAN AREA,BARBADOS,2,MANCHESTER,BRIDGETOWN,140161,79368,60793,139204,75848,63356,0.68748
03/03/2019 11:05,2018,95,CARIBBEAN AREA,BARBADOS,2,NEWCASTLE,BRIDGETOWN,4054,4054,0,2728,2728,0,48.60704
03/03/2019 11:05,2018,95,CARIBBEAN AREA,BERMUDA,1,GATWICK,BERMUDA,94895,94595,300,98227,98227,0,-3.39214
03/03/2019 11:05,2018,95,CARIBBEAN AREA,CAYMAN ISLANDS,1,HEATHROW,GRAND CAYMAN,35911,35911,0,34935,34935,0,2.79376
03/03/2019 11:05,2018,95,CARIBBEAN AREA,GRENADA,1,GATWICK,GRENADA,30763,30763,0,35848,35848,0,-14.18489
03/03/2019 11:05,2018,95,CARIBBEAN AREA,GUADELOUPE,1,GATWICK,POINTE A PITRE GUADELOUPE,944,0,944,0,0,0,0
03/03/2019 11:05,2018,95,CARIBBEAN AREA,ISLE OF CURACAO NETH.ANTILLES,1,GATWICK,ARUBA,13534,0,13534,16627,0,16627,-18.60227
03/03/2019 11:05,2018,95,CARIBBEAN AREA,ISLE OF CURACAO NETH.ANTILLES,2,MANCHESTER,ARUBA,0,0,0,16122,0,16122,-100
03/03/2019 11:05,2018,95,CARIBBEAN AREA,JAMAICA,1,GATWICK,KINGSTON,91204,91204,0,97512,97362,150,-6.46895
03/03/2019 11:05,2018,95,CARIBBEAN AREA,JAMAICA,1,GATWICK,MONTEGO BAY,213295,99241,114054,220936,104708,116228,-3.45847
03/03/2019 11:05,2018,95,CARIBBEAN AREA,JAMAICA,1,STANSTED,MONTEGO BAY,612,0,612,10243,0,10243,-94.02519
03/03/2019 11:05,2018,95,CARIBBEAN AREA,JAMAICA,2,BIRMINGHAM,MONTEGO BAY,47617,0,47617,38189,0,38189,24.68774
03/03/2019 11:05,2018,95,CARIBBEAN AREA,JAMAICA,2,CARDIFF WALES,KINGSTON,183,183,0,0,0,0,0
03/03/2019 11:05,2018,95,CARIBBEAN AREA,JAMAICA,2,CARDIFF WALES,MONTEGO BAY,2086,0,2086,298,0,298,600
03/03/2019 11:05,2018,95,CARIBBEAN AREA,JAMAICA,2,DONCASTER SHEFFIELD,MONTEGO BAY,0,0,0,609,0,609,-100
03/03/2019 11:05,2018,95,CARIBBEAN AREA,JAMAICA,2,EAST MIDLANDS INTERNATIONAL,MONTEGO BAY,589,0,589,0,0,0,0
03/03/2019 11:05,2018,95,CARIBBEAN AREA,JAMAICA,2,GLASGOW,MONTEGO BAY,4615,0,4615,2965,0,2965,55.64924
03/03/2019 11:05,2018,95,CARIBBEAN AREA,JAMAICA,2,MANCHESTER,MONTEGO BAY,82441,0,82441,75872,0,75872,8.658
03/03/2019 11:05,2018,95,CARIBBEAN AREA,JAMAICA,2,NEWCASTLE,MONTEGO BAY,2258,2258,0,0,0,0,0
03/03/2019 11:05,2018,95,CARIBBEAN AREA,PUERTO RICO,1,GATWICK,SAN JUAN (PUERTO RICO),0,0,0,14756,14756,0,-100
03/03/2019 11:05,2018,95,CARIBBEAN AREA,SAINT KITTS AND NEVIS,1,GATWICK,ST KITTS,16928,16928,0,17673,17673,0,-4.21547
03/03/2019 11:05,2018,95,CARIBBEAN AREA,ST LUCIA,1,GATWICK,ST LUCIA (HEWANORRA),200141,168763,31378,184235,160432,23803,8.63354
03/03/2019 11:05,2018,95,CARIBBEAN AREA,ST LUCIA,2,MANCHESTER,ST LUCIA (HEWANORRA),8999,8999,0,6804,6804,0,32.26044
03/03/2019 11:05,2018,95,CARIBBEAN AREA,TRINIDAD AND TOBAGO,1,GATWICK,PORT OF SPAIN,60122,60122,0,61697,61697,0,-2.5528
03/03/2019 11:05,2018,95,CARIBBEAN AREA,TRINIDAD AND TOBAGO,1,GATWICK,TOBAGO,33240,33240,0,35267,35267,0,-5.74758
03/03/2019 11:05,2018,95,CARIBBEAN AREA,TRINIDAD AND TOBAGO,2,MANCHESTER,TOBAGO,5804,5804,0,5447,5447,0,6.55407
03/03/2019 11:05,2018,95,CARIBBEAN AREA,TURKS AND CAICOS ISLANDS,1,GATWICK,PROVIDENCIALES,16251,16251,0,14369,14369,0,13.09764
03/03/2019 11:05,2018,100,INDIAN OCEAN ISLANDS,MALDIVE ISLANDS,1,GATWICK,MALE INTERNATIONAL,28678,28678,0,27798,27798,0,3.1657
03/03/2019 11:05,2018,100,INDIAN OCEAN ISLANDS,MALDIVE ISLANDS,1,HEATHROW,MALE INTERNATIONAL,242,242,0,2118,2118,0,-88.57413
03/03/2019 11:05,2018,100,INDIAN OCEAN ISLANDS,MAURITIUS,1,GATWICK,MAURITIUS,131786,129722,2064,120673,118731,1942,9.20919
03/03/2019 11:05,2018,100,INDIAN OCEAN ISLANDS,MAURITIUS,1,HEATHROW,MAURITIUS,88545,88545,0,94101,94101,0,-5.90429
03/03/2019 11:05,2018,100,INDIAN OCEAN ISLANDS,MAURITIUS,2,MANCHESTER,MAURITIUS,1471,0,1471,6196,4440,1756,-76.25888
03/03/2019 11:05,2018,100,INDIAN OCEAN ISLANDS,SEYCHELLES,1,HEATHROW,SEYCHELLES,28368,28368,0,0,0,0,0
03/03/2019 11:05,2018,105,ATLANTIC OCEAN ISLANDS,ASCENSION ISLAND,1,STANSTED,ASCENSION ISLAND,0,0,0,32,0,32,-100
03/03/2019 11:05,2018,105,ATLANTIC OCEAN ISLANDS,CAPE VERDE ISLANDS,1,GATWICK,BOA VISTA (RABIL),68377,68377,0,66384,59064,7320,3.00223
03/03/2019 11:05,2018,105,ATLANTIC OCEAN ISLANDS,CAPE VERDE ISLANDS,1,GATWICK,ILHA DO SAL C.VERDE,82010,81631,379,86475,81215,5260,-5.16334
03/03/2019 11:05,2018,105,ATLANTIC OCEAN ISLANDS,CAPE VERDE ISLANDS,1,LUTON,BOA VISTA (RABIL),217,0,217,0,0,0,0
03/03/2019 11:05,2018,105,ATLANTIC OCEAN ISLANDS,CAPE VERDE ISLANDS,1,LUTON,ILHA DO SAL C.VERDE,196,0,196,0,0,0,0
03/03/2019 11:05,2018,105,ATLANTIC OCEAN ISLANDS,CAPE VERDE ISLANDS,1,STANSTED,ILHA DO SAL C.VERDE,228,228,0,0,0,0,0
03/03/2019 11:05,2018,105,ATLANTIC OCEAN ISLANDS,CAPE VERDE ISLANDS,2,BIRMINGHAM,BOA VISTA (RABIL),24476,24476,0,21764,21764,0,12.46094
03/03/2019 11:05,2018,105,ATLANTIC OCEAN ISLANDS,CAPE VERDE ISLANDS,2,BIRMINGHAM,ILHA DO SAL C.VERDE,35801,35801,0,34050,34050,0,5.14244
03/03/2019 11:05,2018,105,ATLANTIC OCEAN ISLANDS,CAPE VERDE ISLANDS,2,BRISTOL,ILHA DO SAL C.VERDE,24510,17996,6514,21693,21693,0,12.98576
03/03/2019 11:05,2018,105,ATLANTIC OCEAN ISLANDS,CAPE VERDE ISLANDS,2,GLASGOW,ILHA DO SAL C.VERDE,16030,0,16030,20772,1037,19735,-22.82881
03/03/2019 11:05,2018,105,ATLANTIC OCEAN ISLANDS,CAPE VERDE ISLANDS,2,MANCHESTER,BOA VISTA (RABIL),64642,64424,218,65677,65677,0,-1.57589
03/03/2019 11:05,2018,105,ATLANTIC OCEAN ISLANDS,CAPE VERDE ISLANDS,2,MANCHESTER,ILHA DO SAL C.VERDE,55256,54928,328,71782,71573,209,-23.02248
03/03/2019 11:05,2018,115,OIL RIGS,OIL RIGS,2,ABERDEEN,OIL RIGS,381492,0,381492,364999,0,364999,4.51864
03/03/2019 11:05,2018,115,OIL RIGS,OIL RIGS,2,BLACKPOOL,OIL RIGS,19321,0,19321,21485,0,21485,-10.07214
03/03/2019 11:05,2018,115,OIL RIGS,OIL RIGS,2,HUMBERSIDE,OIL RIGS,21158,0,21158,19684,0,19684,7.48832
03/03/2019 11:05,2018,115,OIL RIGS,OIL RIGS,2,INVERNESS,OIL RIGS,0,0,0,47,0,47,-100
03/03/2019 11:05,2018,115,OIL RIGS,OIL RIGS,2,KIRKWALL,OIL RIGS,19,0,19,16,0,16,18.75
03/03/2019 11:05,2018,115,OIL RIGS,OIL RIGS,2,NORWICH,OIL RIGS,93847,972,92875,105901,293,105608,-11.38233
03/03/2019 11:05,2018,115,OIL RIGS,OIL RIGS,2,SCATSTA,OIL RIGS,81575,0,81575,77901,0,77901,4.71624
03/03/2019 11:05,2018,115,OIL RIGS,OIL RIGS,2,SUMBURGH,OIL RIGS,24110,0,24110,26731,0,26731,-9.8051
03/03/2019 11:05,2018,115,OIL RIGS,OIL RIGS,2,WICK JOHN O GROATS,OIL RIGS,0,0,0,4,0,4,-100

