rundate,this_period,last_period,airport_cluster,rpt_apt_grp_cd,rpt_apt_grp_name,rpt_apt_name,total_pax_tp,total_pax_lp,total_pax_pc,term_pax_tp,term_pax_lp,term_pax_pc,tran_pax_tp,tran_pax_lp,tran_pax_pc
17/03/2016 11:40,2015,2014,1,1,London Area Airports,GATWICK,40269087,38103667,5.682970047,40260068,38093930,5.68630743,9019,9737,-7.373934269
17/03/2016 11:40,2015,2014,1,1,London Area Airports,HEATHROW,74985748,73405330,2.153001785,74953981,73371096,2.15736866,31767,34234,-7.206285954
17/03/2016 11:40,2015,2014,1,1,London Area Airports,LONDON CITY,4319301,3647824,18.40760422,4319301,3647824,18.40760422,0,0,
17/03/2016 11:40,2015,2014,1,1,London Area Airports,LUTON,12263505,10484938,16.9630661,12262581,10481501,16.99260521,924,3437,-73.11608887
17/03/2016 11:40,2015,2014,1,1,London Area Airports,SOUTHEND,900648,1102358,-18.29804802,900634,1102260,-18.29205513,14,98,-85.7142868
17/03/2016 11:40,2015,2014,1,1,London Area Airports,STANSTED,22519178,19965093,12.79275322,22513443,19958047,12.80383778,5735,7046,-18.60630226
17/03/2016 11:40,2015,2014,1,3,Other UK Airports,ABERDEEN,3469525,3723662,-6.824921131,3469328,3723411,-6.823931217,197,251,-21.51394463
17/03/2016 11:40,2015,2014,1,3,Other UK Airports,BARRA,10658,10521,1.30215764,10658,10521,1.30215764,0,0,
17/03/2016 11:40,2015,2014,1,3,Other UK Airports,BELFAST CITY (GEORGE BEST),2692713,2555145,5.383960724,2692713,2555111,5.385363102,0,34,
17/03/2016 11:40,2015,2014,1,3,Other UK Airports,BELFAST INTERNATIONAL,4391292,4033954,8.85825634,4389861,4031685,8.884027481,1431,2269,-36.9325676
17/03/2016 11:40,2015,2014,1,3,Other UK Airports,BENBECULA,32146,31213,2.98913908,32125,31190,2.997755766,21,23,-8.695652008
17/03/2016 11:40,2015,2014,1,3,Other UK Airports,BIGGIN HILL,644,497,29.57746506,644,497,29.57746506,0,0,
17/03/2016 11:40,2015,2014,1,3,Other UK Airports,BIRMINGHAM,10187122,9705955,4.957440853,10180059,9698488,4.965423584,7063,7467,-5.41047287
17/03/2016 11:40,2015,2014,1,3,Other UK Airports,BLACKPOOL,33494,223998,-85.04718781,33494,223998,-85.04718781,0,0,
17/03/2016 11:40,2015,2014,1,3,Other UK Airports,BOURNEMOUTH,706776,661584,6.830878735,705433,660374,6.823254585,1343,1210,10.99173546
17/03/2016 11:40,2015,2014,1,3,Other UK Airports,BRISTOL,6786790,6339805,7.050453663,6781195,6333058,7.076155186,5595,6747,-17.07425499
17/03/2016 11:40,2015,2014,1,3,Other UK Airports,CAMBRIDGE,5799,20663,-71.93534088,5799,20663,-71.93534088,0,0,
17/03/2016 11:40,2015,2014,1,3,Other UK Airports,CAMPBELTOWN,8511,9365,-9.119060516,8288,9331,-11.17779446,223,34,555.8823242
17/03/2016 11:40,2015,2014,1,3,Other UK Airports,CARDIFF WALES,1160506,1023932,13.33819008,1158383,1019545,13.61764336,2123,4387,-51.60702133
17/03/2016 11:40,2015,2014,1,3,Other UK Airports,CITY OF DERRY (EGLINTON),284485,350257,-18.77821159,284482,350257,-18.77906799,3,0,
17/03/2016 11:40,2015,2014,1,3,Other UK Airports,DONCASTER SHEFFIELD,857109,724885,18.24068642,856592,724252,18.27264595,517,633,-18.32543373
17/03/2016 11:40,2015,2014,1,3,Other UK Airports,DUNDEE,21973,22069,-0.434999317,21942,22069,-0.575467825,31,0,
17/03/2016 11:40,2015,2014,1,3,Other UK Airports,DURHAM TEES VALLEY,140902,142379,-1.037372112,140373,142274,-1.336154222,529,105,403.8095093
17/03/2016 11:40,2015,2014,1,3,Other UK Airports,EAST MIDLANDS INTERNATIONAL,4450862,4510544,-1.32316637,4446219,4506791,-1.344016194,4643,3753,23.71436119
17/03/2016 11:40,2015,2014,1,3,Other UK Airports,EDINBURGH,11114587,10160004,9.395498276,11113386,10158906,9.395500183,1201,1098,9.380692482
17/03/2016 11:40,2015,2014,1,3,Other UK Airports,EXETER,821789,767404,7.08687973,821165,766572,7.121705532,624,832,-25
17/03/2016 11:40,2015,2014,1,3,Other UK Airports,GLASGOW,8714307,7715988,12.9383173,8709531,7708867,12.9806881,4776,7121,-32.93076706
17/03/2016 11:40,2015,2014,1,3,Other UK Airports,GLOUCESTERSHIRE,12267,15172,-19.1471138,12253,15141,-19.07403755,14,31,-54.83871078
17/03/2016 11:40,2015,2014,1,3,Other UK Airports,HUMBERSIDE,222107,239173,-7.135420799,221190,237329,-6.800264835,917,1844,-50.27114868
17/03/2016 11:40,2015,2014,1,3,Other UK Airports,INVERNESS,669364,612725,9.243787766,667560,611150,9.230139732,1804,1575,14.53968239
17/03/2016 11:40,2015,2014,1,3,Other UK Airports,ISLAY,29346,27659,6.099280357,28993,27412,5.767547131,353,247,42.91497803
17/03/2016 11:40,2015,2014,1,3,Other UK Airports,ISLES OF SCILLY (ST.MARYS),94718,90944,4.149806499,94718,90944,4.149806499,0,0,
17/03/2016 11:40,2015,2014,1,3,Other UK Airports,KIRKWALL,160234,161347,-0.689817607,149524,150877,-0.896756947,10710,10470,2.292263508
17/03/2016 11:40,2015,2014,1,3,Other UK Airports,LANDS END (ST JUST),54169,44475,21.79651451,53704,44284,21.27179146,465,191,143.4554901
17/03/2016 11:40,2015,2014,1,3,Other UK Airports,LEEDS BRADFORD,3455445,3274474,5.52671957,3445291,3263247,5.578615189,10154,11227,-9.55731678
17/03/2016 11:40,2015,2014,1,3,Other UK Airports,LERWICK (TINGWALL),4267,3739,14.12142277,4175,3591,16.26288033,92,148,-37.83783722
17/03/2016 11:40,2015,2014,1,3,Other UK Airports,LIVERPOOL (JOHN LENNON),4301495,3986654,7.89737463,4295763,3984023,7.824754238,5732,2631,117.8639297
17/03/2016 11:40,2015,2014,1,3,Other UK Airports,LYDD,1134,1227,-7.579462051,1134,1227,-7.579462051,0,0,
17/03/2016 11:40,2015,2014,1,3,Other UK Airports,MANCHESTER,23136047,21989682,5.213194847,23094593,21950223,5.213477612,41454,39459,5.055881023
17/03/2016 11:40,2015,2014,1,3,Other UK Airports,MANSTON (KENT INT),0,12508,,0,12385,,0,123,
17/03/2016 11:40,2015,2014,1,3,Other UK Airports,NEWCASTLE,4562853,4516739,1.020957828,4559848,4512976,1.038605094,3005,3763,-20.14350319
17/03/2016 11:40,2015,2014,1,3,Other UK Airports,NEWQUAY,251987,221047,13.99702358,250278,219167,14.19511127,1709,1880,-9.095745087
17/03/2016 11:40,2015,2014,1,3,Other UK Airports,NORWICH,459664,458968,0.151644558,459664,458931,0.159719005,0,37,
17/03/2016 11:40,2015,2014,1,3,Other UK Airports,OXFORD (KIDLINGTON),166,1194,-86.09715271,166,1194,-86.09715271,0,0,
17/03/2016 11:40,2015,2014,1,3,Other UK Airports,PRESTWICK,610837,913685,-33.14577866,609589,912399,-33.1883316,1248,1286,-2.954898834
17/03/2016 11:40,2015,2014,1,3,Other UK Airports,SCATSTA,253526,279799,-9.389954567,253526,279799,-9.389954567,0,0,
17/03/2016 11:40,2015,2014,1,3,Other UK Airports,SHOREHAM,490,452,8.407079697,490,452,8.407079697,0,0,
17/03/2016 11:40,2015,2014,1,3,Other UK Airports,SOUTHAMPTON,1789470,1831700,-2.305508614,1775638,1829575,-2.948061705,13832,2125,550.9176636
17/03/2016 11:40,2015,2014,1,3,Other UK Airports,STORNOWAY,127282,129481,-1.69831872,124984,127237,-1.770711303,2298,2244,2.406417131
17/03/2016 11:40,2015,2014,1,3,Other UK Airports,SUMBURGH,271994,264521,2.825106621,270126,262626,2.855772018,1868,1895,-1.424802065
17/03/2016 11:40,2015,2014,1,3,Other UK Airports,TIREE,9856,9322,5.728384495,9564,9026,5.960558414,292,296,-1.35135138
17/03/2016 11:40,2015,2014,1,3,Other UK Airports,WICK JOHN O GROATS,25484,28145,-9.454609871,24152,27633,-12.59725666,1332,512,160.15625
17/03/2016 11:40,2015,2014,2,4,Non UK Reporting Airports,ALDERNEY,59843,61317,-2.4039011,59843,61317,-2.4039011,0,0,
17/03/2016 11:40,2015,2014,2,4,Non UK Reporting Airports,GUERNSEY,891616,894602,-0.333779722,857775,860213,-0.283418179,33841,34389,-1.593532801
17/03/2016 11:40,2015,2014,2,4,Non UK Reporting Airports,ISLE OF MAN,781601,729703,7.112208843,780857,728591,7.173572063,744,1112,-33.09352493
17/03/2016 11:40,2015,2014,2,4,Non UK Reporting Airports,JERSEY,1554390,1495707,3.923428774,1532492,1474279,3.948574066,21898,21428,2.1933918
