rundate,report_period,region_num,foreign_region,foreign_country,uk_group,uk_apt,foreign_apt,ty_t_pax,ty_s_pax,ty_c_pax,ly_t_pax,ly_s_pax,ly_c_pax,pc_change
17/03/2016 11:32,2015,1,WESTERN EUROPE-EU,AUSTRIA,1,GATWICK,GRAZ,622,0,622,822,0,822,-24.33090024
17/03/2016 11:32,2015,1,WESTERN EUROPE-EU,AUSTRIA,1,GATWICK,INNSBRUCK,189040,128271,60769,175024,105878,69146,8.008044611
17/03/2016 11:32,2015,1,WESTERN EUROPE-EU,AUSTRIA,1,GATWICK,SALZBURG,141008,110710,30298,131466,100695,30771,7.258150396
17/03/2016 11:32,2015,1,WESTERN EUROPE-EU,AUSTRIA,1,GATWICK,VIENNA,203630,203529,101,156271,156271,0,30.30568692
17/03/2016 11:32,2015,1,WESTERN EUROPE-EU,AUSTRIA,1,HEATHROW,SALZBURG,1585,1585,0,0,0,0,0
17/03/2016 11:32,2015,1,WESTERN EUROPE-EU,AUSTRIA,1,HEATHROW,VIENNA,787631,787631,0,759910,759910,0,3.647931992
17/03/2016 11:32,2015,1,WESTERN EUROPE-EU,AUSTRIA,1,LUTON,GRAZ,613,0,613,90,0,90,581.1111111
17/03/2016 11:32,2015,1,WESTERN EUROPE-EU,AUSTRIA,1,LUTON,INNSBRUCK,850,782,68,0,0,0,0
17/03/2016 11:32,2015,1,WESTERN EUROPE-EU,AUSTRIA,1,LUTON,KLAGENFURT,75,0,75,50,0,50,50
17/03/2016 11:32,2015,1,WESTERN EUROPE-EU,AUSTRIA,1,LUTON,SALZBURG,8614,4841,3773,7849,4444,3405,9.746464518
17/03/2016 11:32,2015,1,WESTERN EUROPE-EU,AUSTRIA,1,LUTON,VIENNA,5498,5434,64,0,0,0,0
17/03/2016 11:32,2015,1,WESTERN EUROPE-EU,AUSTRIA,1,STANSTED,INNSBRUCK,8995,0,8995,8939,0,8939,0.626468285
17/03/2016 11:32,2015,1,WESTERN EUROPE-EU,AUSTRIA,1,STANSTED,LINZ,45734,45734,0,45075,45075,0,1.462007765
17/03/2016 11:32,2015,1,WESTERN EUROPE-EU,AUSTRIA,1,STANSTED,SALZBURG,97864,93705,4159,92637,87617,5020,5.642453879
17/03/2016 11:32,2015,1,WESTERN EUROPE-EU,AUSTRIA,1,STANSTED,VIENNA,13766,13663,103,0,0,0,0
17/03/2016 11:32,2015,1,WESTERN EUROPE-EU,AUSTRIA,2,BELFAST CITY (GEORGE BEST),SALZBURG,0,0,0,2663,0,2663,0
17/03/2016 11:32,2015,1,WESTERN EUROPE-EU,AUSTRIA,2,BELFAST INTERNATIONAL,SALZBURG,3530,0,3530,3364,2938,426,4.934601665
17/03/2016 11:32,2015,1,WESTERN EUROPE-EU,AUSTRIA,2,BELFAST INTERNATIONAL,VIENNA,256,256,0,141,0,141,81.56028369
17/03/2016 11:32,2015,1,WESTERN EUROPE-EU,AUSTRIA,2,BIRMINGHAM,INNSBRUCK,17042,0,17042,15770,0,15770,8.065948003
17/03/2016 11:32,2015,1,WESTERN EUROPE-EU,AUSTRIA,2,BIRMINGHAM,KLAGENFURT,0,0,0,68,0,68,0
17/03/2016 11:32,2015,1,WESTERN EUROPE-EU,AUSTRIA,2,BIRMINGHAM,LINZ,128,0,128,0,0,0,0
17/03/2016 11:32,2015,1,WESTERN EUROPE-EU,AUSTRIA,2,BIRMINGHAM,SALZBURG,14770,4242,10528,15189,561,14628,-2.758575285
17/03/2016 11:32,2015,1,WESTERN EUROPE-EU,AUSTRIA,2,BIRMINGHAM,VIENNA,380,0,380,0,0,0,0
17/03/2016 11:32,2015,1,WESTERN EUROPE-EU,AUSTRIA,2,BOURNEMOUTH,SALZBURG,117,0,117,0,0,0,0
17/03/2016 11:32,2015,1,WESTERN EUROPE-EU,AUSTRIA,2,BRISTOL,INNSBRUCK,19139,8634,10505,16664,8919,7745,14.85237638
17/03/2016 11:32,2015,1,WESTERN EUROPE-EU,AUSTRIA,2,BRISTOL,SALZBURG,9825,5688,4137,9035,4899,4136,8.743774211
17/03/2016 11:32,2015,1,WESTERN EUROPE-EU,AUSTRIA,2,BRISTOL,VIENNA,3373,3373,0,0,0,0,0
17/03/2016 11:32,2015,1,WESTERN EUROPE-EU,AUSTRIA,2,EAST MIDLANDS INTERNATIONAL,GRAZ,94,0,94,88,0,88,6.818181818
17/03/2016 11:32,2015,1,WESTERN EUROPE-EU,AUSTRIA,2,EAST MIDLANDS INTERNATIONAL,SALZBURG,3876,0,3876,3981,0,3981,-2.637528259
17/03/2016 11:32,2015,1,WESTERN EUROPE-EU,AUSTRIA,2,EAST MIDLANDS INTERNATIONAL,VIENNA,24,0,24,0,0,0,0
17/03/2016 11:32,2015,1,WESTERN EUROPE-EU,AUSTRIA,2,EDINBURGH,INNSBRUCK,11465,0,11465,13545,0,13545,-15.35622001
17/03/2016 11:32,2015,1,WESTERN EUROPE-EU,AUSTRIA,2,EDINBURGH,LINZ,377,0,377,0,0,0,0
17/03/2016 11:32,2015,1,WESTERN EUROPE-EU,AUSTRIA,2,EDINBURGH,SALZBURG,5051,4488,563,4185,4185,0,20.69295102
17/03/2016 11:32,2015,1,WESTERN EUROPE-EU,AUSTRIA,2,EDINBURGH,VIENNA,947,0,947,746,0,746,26.94369973
17/03/2016 11:32,2015,1,WESTERN EUROPE-EU,AUSTRIA,2,EXETER,GRAZ,240,0,240,332,0,332,-27.71084337
17/03/2016 11:32,2015,1,WESTERN EUROPE-EU,AUSTRIA,2,EXETER,INNSBRUCK,55,0,55,0,0,0,0
17/03/2016 11:32,2015,1,WESTERN EUROPE-EU,AUSTRIA,2,EXETER,KLAGENFURT,0,0,0,145,0,145,0
17/03/2016 11:32,2015,1,WESTERN EUROPE-EU,AUSTRIA,2,EXETER,LINZ,356,0,356,644,0,644,-44.72049689
17/03/2016 11:32,2015,1,WESTERN EUROPE-EU,AUSTRIA,2,EXETER,SALZBURG,321,0,321,1909,1537,372,-83.18491357
17/03/2016 11:32,2015,1,WESTERN EUROPE-EU,AUSTRIA,2,EXETER,VIENNA,1476,0,1476,2502,0,2502,-41.00719424
17/03/2016 11:32,2015,1,WESTERN EUROPE-EU,AUSTRIA,2,GLASGOW,GRAZ,413,0,413,680,0,680,-39.26470588
17/03/2016 11:32,2015,1,WESTERN EUROPE-EU,AUSTRIA,2,GLASGOW,INNSBRUCK,0,0,0,280,0,280,0
17/03/2016 11:32,2015,1,WESTERN EUROPE-EU,AUSTRIA,2,GLASGOW,LINZ,631,0,631,437,0,437,44.39359268
17/03/2016 11:32,2015,1,WESTERN EUROPE-EU,AUSTRIA,2,GLASGOW,SALZBURG,7767,285,7482,7701,0,7701,0.857031554
17/03/2016 11:32,2015,1,WESTERN EUROPE-EU,AUSTRIA,2,GLASGOW,VIENNA,2309,0,2309,2288,0,2288,0.917832168
17/03/2016 11:32,2015,1,WESTERN EUROPE-EU,AUSTRIA,2,HUMBERSIDE,SALZBURG,76,0,76,0,0,0,0
17/03/2016 11:32,2015,1,WESTERN EUROPE-EU,AUSTRIA,2,JERSEY,VIENNA,1442,1442,0,1048,0,1048,37.59541985
17/03/2016 11:32,2015,1,WESTERN EUROPE-EU,AUSTRIA,2,LEEDS BRADFORD,INNSBRUCK,1279,0,1279,4863,0,4863,-73.69936253
17/03/2016 11:32,2015,1,WESTERN EUROPE-EU,AUSTRIA,2,LEEDS BRADFORD,SALZBURG,4389,4389,0,3871,3871,0,13.38155515
17/03/2016 11:32,2015,1,WESTERN EUROPE-EU,AUSTRIA,2,LEEDS BRADFORD,VIENNA,278,0,278,288,0,288,-3.472222222
17/03/2016 11:32,2015,1,WESTERN EUROPE-EU,AUSTRIA,2,LIVERPOOL (JOHN LENNON),INNSBRUCK,4236,4236,0,4759,4759,0,-10.98970372
17/03/2016 11:32,2015,1,WESTERN EUROPE-EU,AUSTRIA,2,LIVERPOOL (JOHN LENNON),SALZBURG,4570,4570,0,4512,4512,0,1.285460993
17/03/2016 11:32,2015,1,WESTERN EUROPE-EU,AUSTRIA,2,LIVERPOOL (JOHN LENNON),VIENNA,0,0,0,89,0,89,0
17/03/2016 11:32,2015,1,WESTERN EUROPE-EU,AUSTRIA,2,MANCHESTER,INNSBRUCK,48977,11131,37846,43211,10604,32607,13.34382449
17/03/2016 11:32,2015,1,WESTERN EUROPE-EU,AUSTRIA,2,MANCHESTER,SALZBURG,35488,5824,29664,32972,5050,27922,7.630716972
17/03/2016 11:32,2015,1,WESTERN EUROPE-EU,AUSTRIA,2,MANCHESTER,VIENNA,50136,50129,7,25530,25530,0,96.38072855
17/03/2016 11:32,2015,1,WESTERN EUROPE-EU,AUSTRIA,2,NEWCASTLE,INNSBRUCK,4579,0,4579,4576,0,4576,0.065559441
17/03/2016 11:32,2015,1,WESTERN EUROPE-EU,AUSTRIA,2,NEWCASTLE,SALZBURG,10005,0,10005,10176,0,10176,-1.680424528
17/03/2016 11:32,2015,1,WESTERN EUROPE-EU,AUSTRIA,2,NEWCASTLE,VIENNA,292,292,0,265,0,265,10.18867925
17/03/2016 11:32,2015,1,WESTERN EUROPE-EU,AUSTRIA,2,SOUTHAMPTON,INNSBRUCK,2476,0,2476,1969,0,1969,25.74911122
17/03/2016 11:32,2015,1,WESTERN EUROPE-EU,AUSTRIA,2,SOUTHAMPTON,SALZBURG,1626,1626,0,2135,2135,0,-23.84074941
17/03/2016 11:32,2015,1,WESTERN EUROPE-EU,BELGIUM,1,GATWICK,BRUSSELS,93791,93791,0,97731,97731,0,-4.031474148
17/03/2016 11:32,2015,1,WESTERN EUROPE-EU,BELGIUM,1,HEATHROW,BRUSSELS,628148,628148,0,574569,574569,0,9.32507671
17/03/2016 11:32,2015,1,WESTERN EUROPE-EU,BELGIUM,1,LONDON CITY,ANTWERP,58548,58548,0,56379,56379,0,3.84717714
17/03/2016 11:32,2015,1,WESTERN EUROPE-EU,BELGIUM,1,LUTON,ANTWERP,0,0,0,110,0,110,0
17/03/2016 11:32,2015,1,WESTERN EUROPE-EU,BELGIUM,1,LUTON,BRUSSELS,168,0,168,105,0,105,60
17/03/2016 11:32,2015,1,WESTERN EUROPE-EU,BELGIUM,1,LUTON,CHARLEROI,0,0,0,2,0,2,0
17/03/2016 11:32,2015,1,WESTERN EUROPE-EU,BELGIUM,1,LUTON,LIEGE,99,0,99,37,0,37,167.5675676
17/03/2016 11:32,2015,1,WESTERN EUROPE-EU,BELGIUM,1,LUTON,OSTEND,74,0,74,0,0,0,0
17/03/2016 11:32,2015,1,WESTERN EUROPE-EU,BELGIUM,1,SOUTHEND,ANTWERP,663,663,0,10662,10662,0,-93.78165447
17/03/2016 11:32,2015,1,WESTERN EUROPE-EU,BELGIUM,1,STANSTED,BRUSSELS,98,0,98,0,0,0,0
17/03/2016 11:32,2015,1,WESTERN EUROPE-EU,BELGIUM,2,ABERDEEN,OSTEND,43,0,43,0,0,0,0
17/03/2016 11:32,2015,1,WESTERN EUROPE-EU,BELGIUM,2,BELFAST INTERNATIONAL,LIEGE,0,0,0,41,0,41,0
17/03/2016 11:32,2015,1,WESTERN EUROPE-EU,BELGIUM,2,BIRMINGHAM,ANTWERP,764,665,99,148,0,148,416.2162162
17/03/2016 11:32,2015,1,WESTERN EUROPE-EU,BELGIUM,2,BIRMINGHAM,BRUSSELS,143643,143643,0,119658,119658,0,20.04462719
17/03/2016 11:32,2015,1,WESTERN EUROPE-EU,BELGIUM,2,BIRMINGHAM,KORTRIJK/WEVELGEM,0,0,0,65,0,65,0
17/03/2016 11:32,2015,1,WESTERN EUROPE-EU,BELGIUM,2,BIRMINGHAM,LIEGE,0,0,0,42,0,42,0
17/03/2016 11:32,2015,1,WESTERN EUROPE-EU,BELGIUM,2,BRISTOL,ANTWERP,55,0,55,0,0,0,0
17/03/2016 11:32,2015,1,WESTERN EUROPE-EU,BELGIUM,2,BRISTOL,BRUSSELS,56638,56638,0,52484,52449,35,7.91479308
17/03/2016 11:32,2015,1,WESTERN EUROPE-EU,BELGIUM,2,CARDIFF WALES,ANTWERP,86,0,86,0,0,0,0
17/03/2016 11:32,2015,1,WESTERN EUROPE-EU,BELGIUM,2,CARDIFF WALES,BRUSSELS,217,0,217,563,0,563,-61.45648313
17/03/2016 11:32,2015,1,WESTERN EUROPE-EU,BELGIUM,2,DURHAM TEES VALLEY,LIEGE,20,0,20,34,0,34,-41.17647059
17/03/2016 11:32,2015,1,WESTERN EUROPE-EU,BELGIUM,2,EAST MIDLANDS INTERNATIONAL,BRUSSELS,23668,23592,76,21143,21143,0,11.94248688
17/03/2016 11:32,2015,1,WESTERN EUROPE-EU,BELGIUM,2,EAST MIDLANDS INTERNATIONAL,LIEGE,12,0,12,0,0,0,0
17/03/2016 11:32,2015,1,WESTERN EUROPE-EU,BELGIUM,2,EDINBURGH,BRUSSELS,100433,99928,505,89642,89306,336,12.03788403
17/03/2016 11:32,2015,1,WESTERN EUROPE-EU,BELGIUM,2,EDINBURGH,CHARLEROI,71701,71701,0,63364,63364,0,13.1573133
17/03/2016 11:32,2015,1,WESTERN EUROPE-EU,BELGIUM,2,HUMBERSIDE,ANTWERP,0,0,0,149,0,149,0
17/03/2016 11:32,2015,1,WESTERN EUROPE-EU,BELGIUM,2,HUMBERSIDE,BRUSSELS,0,0,0,49,0,49,0
17/03/2016 11:32,2015,1,WESTERN EUROPE-EU,BELGIUM,2,HUMBERSIDE,OSTEND,0,0,0,430,0,430,0
17/03/2016 11:32,2015,1,WESTERN EUROPE-EU,BELGIUM,2,ISLE OF MAN,ANTWERP,80,0,80,0,0,0,0
17/03/2016 11:32,2015,1,WESTERN EUROPE-EU,BELGIUM,2,LIVERPOOL (JOHN LENNON),ANTWERP,0,0,0,47,0,47,0
17/03/2016 11:32,2015,1,WESTERN EUROPE-EU,BELGIUM,2,LIVERPOOL (JOHN LENNON),BRUSSELS,0,0,0,82,0,82,0
17/03/2016 11:32,2015,1,WESTERN EUROPE-EU,BELGIUM,2,MANCHESTER,ANTWERP,199,0,199,0,0,0,0
17/03/2016 11:32,2015,1,WESTERN EUROPE-EU,BELGIUM,2,MANCHESTER,BRUSSELS,200093,199676,417,164827,164734,93,21.39576647
17/03/2016 11:32,2015,1,WESTERN EUROPE-EU,BELGIUM,2,MANCHESTER,CHARLEROI,183551,183551,0,166671,166671,0,10.12773668
17/03/2016 11:32,2015,1,WESTERN EUROPE-EU,BELGIUM,2,MANCHESTER,OSTEND,1688,0,1688,0,0,0,0
17/03/2016 11:32,2015,1,WESTERN EUROPE-EU,BELGIUM,2,NEWCASTLE,BRUSSELS,26403,26403,0,20549,20549,0,28.48800428
17/03/2016 11:32,2015,1,WESTERN EUROPE-EU,BELGIUM,2,OXFORD (KIDLINGTON),ANTWERP,122,0,122,0,0,0,0
17/03/2016 11:32,2015,1,WESTERN EUROPE-EU,BELGIUM,2,SOUTHAMPTON,ANTWERP,629,629,0,0,0,0,0
17/03/2016 11:32,2015,1,WESTERN EUROPE-EU,CROATIA,1,GATWICK,DUBROVNIK,199741,199109,632,191478,180560,10918,4.315378268
17/03/2016 11:32,2015,1,WESTERN EUROPE-EU,CROATIA,1,GATWICK,PULA,31582,16226,15356,15358,0,15358,105.638755
17/03/2016 11:32,2015,1,WESTERN EUROPE-EU,CROATIA,1,GATWICK,SPLIT,124661,118420,6241,112199,112199,0,11.10705086
17/03/2016 11:32,2015,1,WESTERN EUROPE-EU,CROATIA,1,GATWICK,ZAGREB,0,0,0,52971,52971,0,0
17/03/2016 11:32,2015,1,WESTERN EUROPE-EU,CROATIA,1,HEATHROW,RIJEKA,89,89,0,0,0,0,0
17/03/2016 11:32,2015,1,WESTERN EUROPE-EU,CROATIA,1,HEATHROW,SPLIT,18445,18445,0,7962,7962,0,131.6628988
17/03/2016 11:32,2015,1,WESTERN EUROPE-EU,CROATIA,1,HEATHROW,ZAGREB,181789,181479,310,167712,167712,0,8.393555619
17/03/2016 11:32,2015,1,WESTERN EUROPE-EU,CROATIA,1,LUTON,DUBROVNIK,0,0,0,29,0,29,0
17/03/2016 11:32,2015,1,WESTERN EUROPE-EU,CROATIA,1,LUTON,PULA,0,0,0,148,0,148,0
17/03/2016 11:32,2015,1,WESTERN EUROPE-EU,CROATIA,1,LUTON,SPLIT,49424,49424,0,15859,15859,0,211.6463838
17/03/2016 11:32,2015,1,WESTERN EUROPE-EU,CROATIA,1,LUTON,ZAGREB,194,0,194,0,0,0,0
17/03/2016 11:32,2015,1,WESTERN EUROPE-EU,CROATIA,1,STANSTED,DUBROVNIK,19137,19137,0,19901,19649,252,-3.839003065
17/03/2016 11:32,2015,1,WESTERN EUROPE-EU,CROATIA,1,STANSTED,OSIJEK,20980,20980,0,18110,18110,0,15.84759801
17/03/2016 11:32,2015,1,WESTERN EUROPE-EU,CROATIA,1,STANSTED,PULA,22927,22927,0,25477,25477,0,-10.00902775
17/03/2016 11:32,2015,1,WESTERN EUROPE-EU,CROATIA,1,STANSTED,RIJEKA,8670,8670,0,7976,7976,0,8.70110331
17/03/2016 11:32,2015,1,WESTERN EUROPE-EU,CROATIA,1,STANSTED,SPLIT,16002,16002,0,15953,15953,0,0.30715226
17/03/2016 11:32,2015,1,WESTERN EUROPE-EU,CROATIA,1,STANSTED,ZADAR,33211,33211,0,33965,33965,0,-2.219932283
17/03/2016 11:32,2015,1,WESTERN EUROPE-EU,CROATIA,2,ABERDEEN,RIJEKA,359,0,359,0,0,0,0
17/03/2016 11:32,2015,1,WESTERN EUROPE-EU,CROATIA,2,BELFAST INTERNATIONAL,DUBROVNIK,5860,5860,0,6157,6033,124,-4.823777814
17/03/2016 11:32,2015,1,WESTERN EUROPE-EU,CROATIA,2,BELFAST INTERNATIONAL,SPLIT,5442,5146,296,699,0,699,678.5407725
17/03/2016 11:32,2015,1,WESTERN EUROPE-EU,CROATIA,2,BIRMINGHAM,DUBROVNIK,27595,27595,0,35480,26475,9005,-22.22378805
17/03/2016 11:32,2015,1,WESTERN EUROPE-EU,CROATIA,2,BIRMINGHAM,OSIJEK,0,0,0,81,0,81,0
17/03/2016 11:32,2015,1,WESTERN EUROPE-EU,CROATIA,2,BIRMINGHAM,PULA,15261,0,15261,13951,0,13951,9.390007885
17/03/2016 11:32,2015,1,WESTERN EUROPE-EU,CROATIA,2,BIRMINGHAM,SPLIT,0,0,0,17346,17346,0,0
17/03/2016 11:32,2015,1,WESTERN EUROPE-EU,CROATIA,2,BOURNEMOUTH,DUBROVNIK,0,0,0,289,0,289,0
17/03/2016 11:32,2015,1,WESTERN EUROPE-EU,CROATIA,2,BRISTOL,DUBROVNIK,9076,9076,0,0,0,0,0
17/03/2016 11:32,2015,1,WESTERN EUROPE-EU,CROATIA,2,BRISTOL,PULA,6860,0,6860,0,0,0,0
17/03/2016 11:32,2015,1,WESTERN EUROPE-EU,CROATIA,2,BRISTOL,SPLIT,16897,16897,0,15469,15469,0,9.231365958
17/03/2016 11:32,2015,1,WESTERN EUROPE-EU,CROATIA,2,CARDIFF WALES,DUBROVNIK,185,0,185,290,0,290,-36.20689655
17/03/2016 11:32,2015,1,WESTERN EUROPE-EU,CROATIA,2,CARDIFF WALES,OSIJEK,0,0,0,130,0,130,0
17/03/2016 11:32,2015,1,WESTERN EUROPE-EU,CROATIA,2,EAST MIDLANDS INTERNATIONAL,DUBROVNIK,12425,12425,0,11453,11252,201,8.486859338
17/03/2016 11:32,2015,1,WESTERN EUROPE-EU,CROATIA,2,EDINBURGH,DUBROVNIK,23290,23290,0,28258,28258,0,-17.58086206
17/03/2016 11:32,2015,1,WESTERN EUROPE-EU,CROATIA,2,EDINBURGH,PULA,5015,5015,0,4737,4737,0,5.868693266
17/03/2016 11:32,2015,1,WESTERN EUROPE-EU,CROATIA,2,EDINBURGH,SPLIT,5030,5030,0,143,143,0,3417.482517
17/03/2016 11:32,2015,1,WESTERN EUROPE-EU,CROATIA,2,EXETER,DUBROVNIK,0,0,0,550,0,550,0
17/03/2016 11:32,2015,1,WESTERN EUROPE-EU,CROATIA,2,GLASGOW,DUBROVNIK,11141,10588,553,603,0,603,1747.595357
17/03/2016 11:32,2015,1,WESTERN EUROPE-EU,CROATIA,2,GLASGOW,SPLIT,11439,11439,0,7481,7481,0,52.90736533
17/03/2016 11:32,2015,1,WESTERN EUROPE-EU,CROATIA,2,GLASGOW,ZAGREB,0,0,0,811,0,811,0
17/03/2016 11:32,2015,1,WESTERN EUROPE-EU,CROATIA,2,HUMBERSIDE,DUBROVNIK,0,0,0,294,0,294,0
17/03/2016 11:32,2015,1,WESTERN EUROPE-EU,CROATIA,2,INVERNESS,DUBROVNIK,0,0,0,587,0,587,0
17/03/2016 11:32,2015,1,WESTERN EUROPE-EU,CROATIA,2,ISLE OF MAN,DUBROVNIK,0,0,0,298,0,298,0
17/03/2016 11:32,2015,1,WESTERN EUROPE-EU,CROATIA,2,JERSEY,DUBROVNIK,0,0,0,270,0,270,0
17/03/2016 11:32,2015,1,WESTERN EUROPE-EU,CROATIA,2,LEEDS BRADFORD,DUBROVNIK,12569,12569,0,12532,12532,0,0.295244175
17/03/2016 11:32,2015,1,WESTERN EUROPE-EU,CROATIA,2,LEEDS BRADFORD,PULA,4966,4966,0,4670,4670,0,6.338329764
17/03/2016 11:32,2015,1,WESTERN EUROPE-EU,CROATIA,2,LEEDS BRADFORD,SPLIT,4980,4980,0,4929,4929,0,1.034692635
17/03/2016 11:32,2015,1,WESTERN EUROPE-EU,CROATIA,2,MANCHESTER,DUBROVNIK,49104,49104,0,57007,46911,10096,-13.86320978
17/03/2016 11:32,2015,1,WESTERN EUROPE-EU,CROATIA,2,MANCHESTER,PULA,24246,8751,15495,25089,9767,15322,-3.360038264
17/03/2016 11:32,2015,1,WESTERN EUROPE-EU,CROATIA,2,MANCHESTER,SPLIT,31054,22913,8141,10325,10325,0,200.7651332
17/03/2016 11:32,2015,1,WESTERN EUROPE-EU,CROATIA,2,MANCHESTER,ZADAR,20168,20168,0,17845,17845,0,13.017652
17/03/2016 11:32,2015,1,WESTERN EUROPE-EU,CROATIA,2,MANCHESTER,ZAGREB,96,0,96,0,0,0,0
17/03/2016 11:32,2015,1,WESTERN EUROPE-EU,CROATIA,2,NEWCASTLE,DUBROVNIK,19896,19896,0,10460,10460,0,90.21032505
17/03/2016 11:32,2015,1,WESTERN EUROPE-EU,CROATIA,2,NEWCASTLE,PULA,0,0,0,2558,2558,0,0
17/03/2016 11:32,2015,1,WESTERN EUROPE-EU,CROATIA,2,NEWCASTLE,SPLIT,8852,8852,0,0,0,0,0
17/03/2016 11:32,2015,1,WESTERN EUROPE-EU,CROATIA,2,NORWICH,DUBROVNIK,0,0,0,296,0,296,0
17/03/2016 11:32,2015,1,WESTERN EUROPE-EU,CYPRUS,1,GATWICK,LARNACA,273777,193429,80348,281269,199661,81608,-2.663642278
17/03/2016 11:32,2015,1,WESTERN EUROPE-EU,CYPRUS,1,GATWICK,PAPHOS,357614,248397,109217,341589,255442,86147,4.691310317
17/03/2016 11:32,2015,1,WESTERN EUROPE-EU,CYPRUS,1,HEATHROW,LARNACA,279038,279038,0,230807,230807,0,20.89667991
17/03/2016 11:32,2015,1,WESTERN EUROPE-EU,CYPRUS,1,LUTON,LARNACA,53307,44367,8940,46535,37263,9272,14.55248738
17/03/2016 11:32,2015,1,WESTERN EUROPE-EU,CYPRUS,1,LUTON,PAPHOS,77908,48363,29545,74386,50901,23485,4.734761918
17/03/2016 11:32,2015,1,WESTERN EUROPE-EU,CYPRUS,1,STANSTED,LARNACA,2413,2287,126,26505,26347,158,-90.89605735
17/03/2016 11:32,2015,1,WESTERN EUROPE-EU,CYPRUS,1,STANSTED,PAPHOS,156241,134665,21576,122531,102249,20282,27.51140528
17/03/2016 11:32,2015,1,WESTERN EUROPE-EU,CYPRUS,2,BELFAST INTERNATIONAL,LARNACA,19327,0,19327,12734,0,12734,51.77477619
17/03/2016 11:32,2015,1,WESTERN EUROPE-EU,CYPRUS,2,BIRMINGHAM,LARNACA,109752,65886,43866,101349,66094,35255,8.291152355
17/03/2016 11:32,2015,1,WESTERN EUROPE-EU,CYPRUS,2,BIRMINGHAM,PAPHOS,77985,28770,49215,63259,22254,41005,23.27890103
17/03/2016 11:32,2015,1,WESTERN EUROPE-EU,CYPRUS,2,BOURNEMOUTH,PAPHOS,13523,0,13523,12922,0,12922,4.65098282
17/03/2016 11:32,2015,1,WESTERN EUROPE-EU,CYPRUS,2,BRISTOL,LARNACA,25888,0,25888,21401,0,21401,20.96630999
17/03/2016 11:32,2015,1,WESTERN EUROPE-EU,CYPRUS,2,BRISTOL,PAPHOS,56062,43554,12508,57015,42457,14558,-1.671489959
17/03/2016 11:32,2015,1,WESTERN EUROPE-EU,CYPRUS,2,CARDIFF WALES,LARNACA,17985,0,17985,18261,0,18261,-1.511417776
17/03/2016 11:32,2015,1,WESTERN EUROPE-EU,CYPRUS,2,CARDIFF WALES,PAPHOS,13747,0,13747,12163,0,12163,13.02310285
17/03/2016 11:32,2015,1,WESTERN EUROPE-EU,CYPRUS,2,DONCASTER SHEFFIELD,PAPHOS,23159,0,23159,22140,0,22140,4.602529359
17/03/2016 11:32,2015,1,WESTERN EUROPE-EU,CYPRUS,2,EAST MIDLANDS INTERNATIONAL,LARNACA,29479,7791,21688,27635,7679,19956,6.672697666
17/03/2016 11:32,2015,1,WESTERN EUROPE-EU,CYPRUS,2,EAST MIDLANDS INTERNATIONAL,PAPHOS,68433,20177,48256,65810,19427,46383,3.985716456
17/03/2016 11:32,2015,1,WESTERN EUROPE-EU,CYPRUS,2,EDINBURGH,PAPHOS,44664,33902,10762,45746,35694,10052,-2.365234119
17/03/2016 11:32,2015,1,WESTERN EUROPE-EU,CYPRUS,2,EXETER,LARNACA,9512,0,9512,8997,0,8997,5.724130266
17/03/2016 11:32,2015,1,WESTERN EUROPE-EU,CYPRUS,2,EXETER,PAPHOS,13797,0,13797,13310,0,13310,3.65890308
17/03/2016 11:32,2015,1,WESTERN EUROPE-EU,CYPRUS,2,GLASGOW,LARNACA,44102,8991,35111,30909,0,30909,42.68336083
17/03/2016 11:32,2015,1,WESTERN EUROPE-EU,CYPRUS,2,GLASGOW,PAPHOS,45518,18472,27046,35735,19025,16710,27.37652162
17/03/2016 11:32,2015,1,WESTERN EUROPE-EU,CYPRUS,2,LEEDS BRADFORD,LARNACA,37756,37756,0,35610,35455,155,6.026397079
17/03/2016 11:32,2015,1,WESTERN EUROPE-EU,CYPRUS,2,LEEDS BRADFORD,PAPHOS,24541,24541,0,23769,23769,0,3.247927973
17/03/2016 11:32,2015,1,WESTERN EUROPE-EU,CYPRUS,2,LIVERPOOL (JOHN LENNON),LARNACA,34555,34555,0,32727,32727,0,5.585602102
17/03/2016 11:32,2015,1,WESTERN EUROPE-EU,CYPRUS,2,MANCHESTER,LARNACA,138707,38680,100027,160829,95378,65451,-13.754982
17/03/2016 11:32,2015,1,WESTERN EUROPE-EU,CYPRUS,2,MANCHESTER,PAPHOS,267604,154613,112991,289243,197059,92184,-7.481252787
17/03/2016 11:32,2015,1,WESTERN EUROPE-EU,CYPRUS,2,NEWCASTLE,LARNACA,40899,7809,33090,30315,0,30315,34.9134092
17/03/2016 11:32,2015,1,WESTERN EUROPE-EU,CYPRUS,2,NEWCASTLE,PAPHOS,46336,20379,25957,47541,24090,23451,-2.534654298
17/03/2016 11:32,2015,1,WESTERN EUROPE-EU,DENMARK,1,GATWICK,AALBORG,28221,28221,0,30985,30888,97,-8.920445377
17/03/2016 11:32,2015,1,WESTERN EUROPE-EU,DENMARK,1,GATWICK,COPENHAGEN,724417,724417,0,734328,734328,0,-1.349669358
17/03/2016 11:32,2015,1,WESTERN EUROPE-EU,DENMARK,1,HEATHROW,COPENHAGEN,997988,997988,0,997463,997195,268,0.052633531
17/03/2016 11:32,2015,1,WESTERN EUROPE-EU,DENMARK,1,LONDON CITY,BILLUND,23428,23428,0,20079,20079,0,16.67911749
17/03/2016 11:32,2015,1,WESTERN EUROPE-EU,DENMARK,1,LUTON,BILLUND,25,0,25,0,0,0,0
17/03/2016 11:32,2015,1,WESTERN EUROPE-EU,DENMARK,1,LUTON,COPENHAGEN,408929,408929,0,22530,22530,0,1715.042166
17/03/2016 11:32,2015,1,WESTERN EUROPE-EU,DENMARK,1,LUTON,ODENSE,46,0,46,19,0,19,142.1052632
17/03/2016 11:32,2015,1,WESTERN EUROPE-EU,DENMARK,1,LUTON,ROSKILDE,112,0,112,0,0,0,0
17/03/2016 11:32,2015,1,WESTERN EUROPE-EU,DENMARK,1,LUTON,SONDERBORG,0,0,0,93,0,93,0
17/03/2016 11:32,2015,1,WESTERN EUROPE-EU,DENMARK,1,STANSTED,AARHUS (TIRSTRUP),90344,90344,0,81219,81219,0,11.23505584
17/03/2016 11:32,2015,1,WESTERN EUROPE-EU,DENMARK,1,STANSTED,BILLUND,258203,258203,0,256523,256523,0,0.654912035
17/03/2016 11:32,2015,1,WESTERN EUROPE-EU,DENMARK,1,STANSTED,COPENHAGEN,22551,22551,0,147577,147577,0,-84.71916356
17/03/2016 11:32,2015,1,WESTERN EUROPE-EU,DENMARK,2,ABERDEEN,COPENHAGEN,50838,50838,0,53045,53045,0,-4.160618343
17/03/2016 11:32,2015,1,WESTERN EUROPE-EU,DENMARK,2,ABERDEEN,ESBJERG,9991,9433,558,11964,11842,122,-16.49114009
17/03/2016 11:32,2015,1,WESTERN EUROPE-EU,DENMARK,2,BELFAST INTERNATIONAL,COPENHAGEN,61,0,61,0,0,0,0
17/03/2016 11:32,2015,1,WESTERN EUROPE-EU,DENMARK,2,BIRMINGHAM,COPENHAGEN,93013,92894,119,95671,95671,0,-2.778271367
17/03/2016 11:32,2015,1,WESTERN EUROPE-EU,DENMARK,2,BOURNEMOUTH,BILLUND,88,0,88,0,0,0,0
17/03/2016 11:32,2015,1,WESTERN EUROPE-EU,DENMARK,2,BOURNEMOUTH,KARUP,47,0,47,0,0,0,0
17/03/2016 11:32,2015,1,WESTERN EUROPE-EU,DENMARK,2,BRISTOL,COPENHAGEN,39254,39254,0,50186,50186,0,-21.78296736
17/03/2016 11:32,2015,1,WESTERN EUROPE-EU,DENMARK,2,CITY OF DERRY (EGLINTON),BILLUND,0,0,0,96,0,96,0
17/03/2016 11:32,2015,1,WESTERN EUROPE-EU,DENMARK,2,DONCASTER SHEFFIELD,COPENHAGEN,0,0,0,60,0,60,0
17/03/2016 11:32,2015,1,WESTERN EUROPE-EU,DENMARK,2,DUNDEE,BILLUND,18,0,18,0,0,0,0
17/03/2016 11:32,2015,1,WESTERN EUROPE-EU,DENMARK,2,DUNDEE,ODENSE,0,0,0,61,0,61,0
17/03/2016 11:32,2015,1,WESTERN EUROPE-EU,DENMARK,2,EDINBURGH,BILLUND,425,0,425,431,0,431,-1.392111369
17/03/2016 11:32,2015,1,WESTERN EUROPE-EU,DENMARK,2,EDINBURGH,COPENHAGEN,191896,191896,0,121349,121349,0,58.13562535
17/03/2016 11:32,2015,1,WESTERN EUROPE-EU,DENMARK,2,EDINBURGH,ODENSE,0,0,0,181,0,181,0
17/03/2016 11:32,2015,1,WESTERN EUROPE-EU,DENMARK,2,EXETER,COPENHAGEN,10,0,10,0,0,0,0
17/03/2016 11:32,2015,1,WESTERN EUROPE-EU,DENMARK,2,GLASGOW,COPENHAGEN,889,0,889,0,0,0,0
17/03/2016 11:32,2015,1,WESTERN EUROPE-EU,DENMARK,2,HUMBERSIDE,BILLUND,31,0,31,0,0,0,0
17/03/2016 11:32,2015,1,WESTERN EUROPE-EU,DENMARK,2,HUMBERSIDE,COPENHAGEN,0,0,0,1535,1535,0,0
17/03/2016 11:32,2015,1,WESTERN EUROPE-EU,DENMARK,2,JERSEY,BILLUND,0,0,0,85,0,85,0
17/03/2016 11:32,2015,1,WESTERN EUROPE-EU,DENMARK,2,LEEDS BRADFORD,COPENHAGEN,276,276,0,3097,3033,64,-91.08814982
17/03/2016 11:32,2015,1,WESTERN EUROPE-EU,DENMARK,2,LIVERPOOL (JOHN LENNON),COPENHAGEN,0,0,0,4725,4639,86,0
17/03/2016 11:32,2015,1,WESTERN EUROPE-EU,DENMARK,2,MANCHESTER,AARHUS (TIRSTRUP),5197,5197,0,6098,6098,0,-14.77533618
17/03/2016 11:32,2015,1,WESTERN EUROPE-EU,DENMARK,2,MANCHESTER,BILLUND,22373,22373,0,24078,24078,0,-7.08115292
17/03/2016 11:32,2015,1,WESTERN EUROPE-EU,DENMARK,2,MANCHESTER,COPENHAGEN,297187,297187,0,294885,294885,0,0.780643302
17/03/2016 11:32,2015,1,WESTERN EUROPE-EU,DENMARK,2,NEWCASTLE,COPENHAGEN,22798,22542,256,20202,20202,0,12.85021285
17/03/2016 11:32,2015,1,WESTERN EUROPE-EU,DENMARK,2,NEWCASTLE,ESBJERG,282,0,282,0,0,0,0
17/03/2016 11:32,2015,1,WESTERN EUROPE-EU,DENMARK,2,NORWICH,BILLUND,182,0,182,0,0,0,0
17/03/2016 11:32,2015,1,WESTERN EUROPE-EU,DENMARK,2,SOUTHAMPTON,BILLUND,170,0,170,0,0,0,0
17/03/2016 11:32,2015,1,WESTERN EUROPE-EU,DENMARK,2,SOUTHAMPTON,KARUP,44,0,44,0,0,0,0
17/03/2016 11:32,2015,1,WESTERN EUROPE-EU,FINLAND,1,GATWICK,ENONTEKIO,4015,0,4015,4570,0,4570,-12.14442013
17/03/2016 11:32,2015,1,WESTERN EUROPE-EU,FINLAND,1,GATWICK,HELSINKI,183174,183174,0,202065,202065,0,-9.348971865
17/03/2016 11:32,2015,1,WESTERN EUROPE-EU,FINLAND,1,GATWICK,IVALO,8738,0,8738,7366,0,7366,18.62612001
17/03/2016 11:32,2015,1,WESTERN EUROPE-EU,FINLAND,1,GATWICK,KITTILA,19581,177,19404,17914,0,17914,9.305571062
17/03/2016 11:32,2015,1,WESTERN EUROPE-EU,FINLAND,1,GATWICK,KUUSAMO,3579,0,3579,3806,0,3806,-5.964266947
17/03/2016 11:32,2015,1,WESTERN EUROPE-EU,FINLAND,1,GATWICK,ROVANIEMI,10721,0,10721,8355,0,8355,28.31837223
17/03/2016 11:32,2015,1,WESTERN EUROPE-EU,FINLAND,1,GATWICK,TAMPERE,0,0,0,101,0,101,0
17/03/2016 11:32,2015,1,WESTERN EUROPE-EU,FINLAND,1,HEATHROW,HELSINKI,655532,655532,0,638495,638495,0,2.668305938
17/03/2016 11:32,2015,1,WESTERN EUROPE-EU,FINLAND,1,LUTON,ENONTEKIO,378,0,378,0,0,0,0
17/03/2016 11:32,2015,1,WESTERN EUROPE-EU,FINLAND,1,LUTON,IVALO,317,0,317,284,0,284,11.61971831
17/03/2016 11:32,2015,1,WESTERN EUROPE-EU,FINLAND,1,LUTON,KITTILA,62,0,62,0,0,0,0
17/03/2016 11:32,2015,1,WESTERN EUROPE-EU,FINLAND,1,LUTON,TAMPERE,59,0,59,0,0,0,0
17/03/2016 11:32,2015,1,WESTERN EUROPE-EU,FINLAND,1,STANSTED,ENONTEKIO,1634,0,1634,664,0,664,146.0843373
17/03/2016 11:32,2015,1,WESTERN EUROPE-EU,FINLAND,1,STANSTED,IVALO,1079,0,1079,0,0,0,0
17/03/2016 11:32,2015,1,WESTERN EUROPE-EU,FINLAND,1,STANSTED,ROVANIEMI,374,0,374,380,0,380,-1.578947368
17/03/2016 11:32,2015,1,WESTERN EUROPE-EU,FINLAND,1,STANSTED,TAMPERE,42021,42021,0,51325,51325,0,-18.12761812
17/03/2016 11:32,2015,1,WESTERN EUROPE-EU,FINLAND,2,ABERDEEN,ENONTEKIO,376,0,376,0,0,0,0
17/03/2016 11:32,2015,1,WESTERN EUROPE-EU,FINLAND,2,BELFAST CITY (GEORGE BEST),HELSINKI,72,0,72,0,0,0,0
17/03/2016 11:32,2015,1,WESTERN EUROPE-EU,FINLAND,2,BELFAST INTERNATIONAL,HELSINKI,360,0,360,0,0,0,0
17/03/2016 11:32,2015,1,WESTERN EUROPE-EU,FINLAND,2,BELFAST INTERNATIONAL,ROVANIEMI,1692,0,1692,1256,0,1256,34.7133758
17/03/2016 11:32,2015,1,WESTERN EUROPE-EU,FINLAND,2,BIRMINGHAM,ENONTEKIO,1968,0,1968,1971,0,1971,-0.152207002
17/03/2016 11:32,2015,1,WESTERN EUROPE-EU,FINLAND,2,BIRMINGHAM,IVALO,360,0,360,0,0,0,0
17/03/2016 11:32,2015,1,WESTERN EUROPE-EU,FINLAND,2,BIRMINGHAM,KITTILA,947,0,947,5039,0,5039,-81.20658861
17/03/2016 11:32,2015,1,WESTERN EUROPE-EU,FINLAND,2,BIRMINGHAM,ROVANIEMI,3798,0,3798,3436,0,3436,10.5355064
17/03/2016 11:32,2015,1,WESTERN EUROPE-EU,FINLAND,2,BOURNEMOUTH,ENONTEKIO,378,0,378,330,0,330,14.54545455
17/03/2016 11:32,2015,1,WESTERN EUROPE-EU,FINLAND,2,BOURNEMOUTH,KITTILA,0,0,0,189,0,189,0
17/03/2016 11:32,2015,1,WESTERN EUROPE-EU,FINLAND,2,BRISTOL,ENONTEKIO,1737,0,1737,1691,0,1691,2.720283856
17/03/2016 11:32,2015,1,WESTERN EUROPE-EU,FINLAND,2,BRISTOL,IVALO,1387,0,1387,1180,0,1180,17.54237288
17/03/2016 11:32,2015,1,WESTERN EUROPE-EU,FINLAND,2,BRISTOL,KITTILA,4757,0,4757,3028,0,3028,57.1003963
17/03/2016 11:32,2015,1,WESTERN EUROPE-EU,FINLAND,2,BRISTOL,ROVANIEMI,432,0,432,0,0,0,0
17/03/2016 11:32,2015,1,WESTERN EUROPE-EU,FINLAND,2,CARDIFF WALES,ENONTEKIO,336,0,336,169,0,169,98.81656805
17/03/2016 11:32,2015,1,WESTERN EUROPE-EU,FINLAND,2,DONCASTER SHEFFIELD,ENONTEKIO,727,0,727,672,0,672,8.18452381
17/03/2016 11:32,2015,1,WESTERN EUROPE-EU,FINLAND,2,DONCASTER SHEFFIELD,KITTILA,378,0,378,0,0,0,0
17/03/2016 11:32,2015,1,WESTERN EUROPE-EU,FINLAND,2,EAST MIDLANDS INTERNATIONAL,ENONTEKIO,1285,0,1285,964,0,964,33.29875519
17/03/2016 11:32,2015,1,WESTERN EUROPE-EU,FINLAND,2,EAST MIDLANDS INTERNATIONAL,IVALO,700,0,700,880,0,880,-20.45454545
17/03/2016 11:32,2015,1,WESTERN EUROPE-EU,FINLAND,2,EAST MIDLANDS INTERNATIONAL,KITTILA,3060,0,3060,3423,0,3423,-10.60473269
17/03/2016 11:32,2015,1,WESTERN EUROPE-EU,FINLAND,2,EAST MIDLANDS INTERNATIONAL,ROVANIEMI,1881,0,1881,1158,0,1158,62.43523316
17/03/2016 11:32,2015,1,WESTERN EUROPE-EU,FINLAND,2,EDINBURGH,ENONTEKIO,1011,0,1011,625,0,625,61.76
17/03/2016 11:32,2015,1,WESTERN EUROPE-EU,FINLAND,2,EDINBURGH,HELSINKI,0,0,0,64,0,64,0
17/03/2016 11:32,2015,1,WESTERN EUROPE-EU,FINLAND,2,EDINBURGH,IVALO,327,0,327,592,0,592,-44.76351351
17/03/2016 11:32,2015,1,WESTERN EUROPE-EU,FINLAND,2,EDINBURGH,JOENSUU,0,0,0,20,0,20,0
17/03/2016 11:32,2015,1,WESTERN EUROPE-EU,FINLAND,2,EDINBURGH,KITTILA,378,0,378,442,0,442,-14.47963801
17/03/2016 11:32,2015,1,WESTERN EUROPE-EU,FINLAND,2,EXETER,ENONTEKIO,334,0,334,330,0,330,1.212121212
17/03/2016 11:32,2015,1,WESTERN EUROPE-EU,FINLAND,2,EXETER,IVALO,275,0,275,0,0,0,0
17/03/2016 11:32,2015,1,WESTERN EUROPE-EU,FINLAND,2,GLASGOW,ENONTEKIO,671,0,671,926,0,926,-27.53779698
17/03/2016 11:32,2015,1,WESTERN EUROPE-EU,FINLAND,2,GLASGOW,HELSINKI,0,0,0,66,0,66,0
17/03/2016 11:32,2015,1,WESTERN EUROPE-EU,FINLAND,2,GLASGOW,IVALO,345,0,345,0,0,0,0
17/03/2016 11:32,2015,1,WESTERN EUROPE-EU,FINLAND,2,GLASGOW,KITTILA,882,0,882,442,0,442,99.54751131
17/03/2016 11:32,2015,1,WESTERN EUROPE-EU,FINLAND,2,GLASGOW,ROVANIEMI,441,0,441,906,0,906,-51.32450331
17/03/2016 11:32,2015,1,WESTERN EUROPE-EU,FINLAND,2,HUMBERSIDE,ENONTEKIO,372,0,372,330,0,330,12.72727273
17/03/2016 11:32,2015,1,WESTERN EUROPE-EU,FINLAND,2,HUMBERSIDE,ROVANIEMI,0,0,0,424,0,424,0
17/03/2016 11:32,2015,1,WESTERN EUROPE-EU,FINLAND,2,JERSEY,HELSINKI,109,0,109,0,0,0,0
17/03/2016 11:32,2015,1,WESTERN EUROPE-EU,FINLAND,2,JERSEY,MARIEHAMN,340,0,340,0,0,0,0
17/03/2016 11:32,2015,1,WESTERN EUROPE-EU,FINLAND,2,LEEDS BRADFORD,ENONTEKIO,1160,0,1160,1130,0,1130,2.654867257
17/03/2016 11:32,2015,1,WESTERN EUROPE-EU,FINLAND,2,LEEDS BRADFORD,IVALO,707,0,707,591,0,591,19.62774958
17/03/2016 11:32,2015,1,WESTERN EUROPE-EU,FINLAND,2,LIVERPOOL (JOHN LENNON),HELSINKI,101,0,101,0,0,0,0
17/03/2016 11:32,2015,1,WESTERN EUROPE-EU,FINLAND,2,LIVERPOOL (JOHN LENNON),IVALO,349,0,349,0,0,0,0
17/03/2016 11:32,2015,1,WESTERN EUROPE-EU,FINLAND,2,MANCHESTER,ENONTEKIO,3047,0,3047,3192,0,3192,-4.542606516
17/03/2016 11:32,2015,1,WESTERN EUROPE-EU,FINLAND,2,MANCHESTER,HELSINKI,108057,108057,0,111391,111391,0,-2.993060481
17/03/2016 11:32,2015,1,WESTERN EUROPE-EU,FINLAND,2,MANCHESTER,IVALO,7599,0,7599,7098,0,7098,7.058326289
17/03/2016 11:32,2015,1,WESTERN EUROPE-EU,FINLAND,2,MANCHESTER,KITTILA,18015,0,18015,14675,0,14675,22.75979557
17/03/2016 11:32,2015,1,WESTERN EUROPE-EU,FINLAND,2,MANCHESTER,KUUSAMO,3426,0,3426,559,0,559,512.8801431
17/03/2016 11:32,2015,1,WESTERN EUROPE-EU,FINLAND,2,MANCHESTER,ROVANIEMI,7507,0,7507,6849,0,6849,9.607241933
17/03/2016 11:32,2015,1,WESTERN EUROPE-EU,FINLAND,2,MANCHESTER,VAASA,0,0,0,235,0,235,0
17/03/2016 11:32,2015,1,WESTERN EUROPE-EU,FINLAND,2,NEWCASTLE,ENONTEKIO,335,0,335,378,0,378,-11.37566138
17/03/2016 11:32,2015,1,WESTERN EUROPE-EU,FINLAND,2,NEWCASTLE,IVALO,652,0,652,296,0,296,120.2702703
17/03/2016 11:32,2015,1,WESTERN EUROPE-EU,FINLAND,2,NEWCASTLE,KITTILA,0,0,0,376,0,376,0
17/03/2016 11:32,2015,1,WESTERN EUROPE-EU,FINLAND,2,NEWCASTLE,ROVANIEMI,818,0,818,814,0,814,0.491400491
17/03/2016 11:32,2015,1,WESTERN EUROPE-EU,FINLAND,2,NORWICH,ENONTEKIO,0,0,0,336,0,336,0
17/03/2016 11:32,2015,1,WESTERN EUROPE-EU,FINLAND,2,PRESTWICK,ROVANIEMI,368,0,368,386,0,386,-4.663212435
17/03/2016 11:32,2015,1,WESTERN EUROPE-EU,FINLAND,2,SOUTHAMPTON,ENONTEKIO,1126,0,1126,470,0,470,139.5744681
17/03/2016 11:32,2015,1,WESTERN EUROPE-EU,FINLAND,2,SOUTHAMPTON,IVALO,300,0,300,0,0,0,0
17/03/2016 11:32,2015,1,WESTERN EUROPE-EU,FRANCE,1,GATWICK,AJACCIO,7290,7290,0,10106,9748,358,-27.86463487
17/03/2016 11:32,2015,1,WESTERN EUROPE-EU,FRANCE,1,GATWICK,BASTIA,11313,10984,329,8821,8821,0,28.25076522
17/03/2016 11:32,2015,1,WESTERN EUROPE-EU,FRANCE,1,GATWICK,BIARRITZ,22046,22046,0,17781,17781,0,23.98627749
17/03/2016 11:32,2015,1,WESTERN EUROPE-EU,FRANCE,1,GATWICK,BORDEAUX,293052,292783,269,282443,282443,0,3.756156109
17/03/2016 11:32,2015,1,WESTERN EUROPE-EU,FRANCE,1,GATWICK,BREST,5592,5592,0,5459,5459,0,2.436343653
17/03/2016 11:32,2015,1,WESTERN EUROPE-EU,FRANCE,1,GATWICK,CANNES,0,0,0,44,0,44,0
17/03/2016 11:32,2015,1,WESTERN EUROPE-EU,FRANCE,1,GATWICK,CHAMBERY,45671,0,45671,42212,0,42212,8.194352317
17/03/2016 11:32,2015,1,WESTERN EUROPE-EU,FRANCE,1,GATWICK,CLERMONT FERRAND,1012,0,1012,1034,0,1034,-2.127659574
17/03/2016 11:32,2015,1,WESTERN EUROPE-EU,FRANCE,1,GATWICK,FIGARI,8201,8201,0,0,0,0,0
17/03/2016 11:32,2015,1,WESTERN EUROPE-EU,FRANCE,1,GATWICK,GRENOBLE,121002,40325,80677,132094,36320,95774,-8.397050585
17/03/2016 11:32,2015,1,WESTERN EUROPE-EU,FRANCE,1,GATWICK,LA ROCHELLE,22242,22242,0,14572,14572,0,52.63519078
17/03/2016 11:32,2015,1,WESTERN EUROPE-EU,FRANCE,1,GATWICK,LILLE,144,0,144,66,0,66,118.1818182
17/03/2016 11:32,2015,1,WESTERN EUROPE-EU,FRANCE,1,GATWICK,LYON,215791,186746,29045,214729,192203,22526,0.494576885
17/03/2016 11:32,2015,1,WESTERN EUROPE-EU,FRANCE,1,GATWICK,MARSEILLE,149453,149031,422,138468,138468,0,7.933240893
17/03/2016 11:32,2015,1,WESTERN EUROPE-EU,FRANCE,1,GATWICK,MONTPELLIER,117963,117963,0,110820,110820,0,6.445587439
17/03/2016 11:32,2015,1,WESTERN EUROPE-EU,FRANCE,1,GATWICK,NANTES,117851,117536,315,80554,80554,0,46.30061822
17/03/2016 11:32,2015,1,WESTERN EUROPE-EU,FRANCE,1,GATWICK,NICE,649357,647242,2115,673586,671510,2076,-3.597016565
17/03/2016 11:32,2015,1,WESTERN EUROPE-EU,FRANCE,1,GATWICK,PARIS (CHARLES DE GAULLE),206338,206128,210,144865,144628,237,42.43468056
17/03/2016 11:32,2015,1,WESTERN EUROPE-EU,FRANCE,1,GATWICK,PARIS (LE BOURGET),705,0,705,0,0,0,0
17/03/2016 11:32,2015,1,WESTERN EUROPE-EU,FRANCE,1,GATWICK,STRASBOURG,49387,49387,0,34544,34544,0,42.96838814
17/03/2016 11:32,2015,1,WESTERN EUROPE-EU,FRANCE,1,GATWICK,TARBES-LOURDES INTERNATIONAL,1730,0,1730,1574,0,1574,9.911054638
17/03/2016 11:32,2015,1,WESTERN EUROPE-EU,FRANCE,1,GATWICK,TOULON / HYERES,751,0,751,0,0,0,0
17/03/2016 11:32,2015,1,WESTERN EUROPE-EU,FRANCE,1,GATWICK,TOULOUSE (BLAGNAC),274756,266760,7996,269357,262572,6785,2.004403078
17/03/2016 11:32,2015,1,WESTERN EUROPE-EU,FRANCE,1,HEATHROW,BASTIA,5299,0,5299,5352,0,5352,-0.990284006
17/03/2016 11:32,2015,1,WESTERN EUROPE-EU,FRANCE,1,HEATHROW,FIGARI,3132,0,3132,5515,0,5515,-43.20942883
17/03/2016 11:32,2015,1,WESTERN EUROPE-EU,FRANCE,1,HEATHROW,GRENOBLE,6044,0,6044,6031,0,6031,0.215552976
17/03/2016 11:32,2015,1,WESTERN EUROPE-EU,FRANCE,1,HEATHROW,LYON,232631,232631,0,220654,220654,0,5.427955079
17/03/2016 11:32,2015,1,WESTERN EUROPE-EU,FRANCE,1,HEATHROW,MARSEILLE,228226,228226,0,216840,216840,0,5.250876222
17/03/2016 11:32,2015,1,WESTERN EUROPE-EU,FRANCE,1,HEATHROW,NICE,497290,496805,485,440735,440409,326,12.83197386
17/03/2016 11:32,2015,1,WESTERN EUROPE-EU,FRANCE,1,HEATHROW,PARIS (CHARLES DE GAULLE),1252777,1252777,0,1247665,1247665,0,0.409725367
17/03/2016 11:32,2015,1,WESTERN EUROPE-EU,FRANCE,1,HEATHROW,PARIS (LE BOURGET),33,0,33,5,0,5,560
17/03/2016 11:32,2015,1,WESTERN EUROPE-EU,FRANCE,1,HEATHROW,PARIS (ORLY),321622,321622,0,298414,298414,0,7.777115015
17/03/2016 11:32,2015,1,WESTERN EUROPE-EU,FRANCE,1,HEATHROW,TOULOUSE (BLAGNAC),259567,259567,0,237241,237241,0,9.410683651
17/03/2016 11:32,2015,1,WESTERN EUROPE-EU,FRANCE,1,LONDON CITY,ANGERS- MARCE,3285,3285,0,3247,3247,0,1.170311056
17/03/2016 11:32,2015,1,WESTERN EUROPE-EU,FRANCE,1,LONDON CITY,AVIGNON,1400,1400,0,1795,1795,0,-22.00557103
17/03/2016 11:32,2015,1,WESTERN EUROPE-EU,FRANCE,1,LONDON CITY,BREST,0,0,0,3077,3077,0,0
17/03/2016 11:32,2015,1,WESTERN EUROPE-EU,FRANCE,1,LONDON CITY,BRIVE-LA-GAILLARDE,2445,2445,0,6406,6406,0,-61.83265688
17/03/2016 11:32,2015,1,WESTERN EUROPE-EU,FRANCE,1,LONDON CITY,CHAMBERY,6019,6019,0,4731,4731,0,27.22468823
17/03/2016 11:32,2015,1,WESTERN EUROPE-EU,FRANCE,1,LONDON CITY,DEAUVILLE,0,0,0,4162,4162,0,0
17/03/2016 11:32,2015,1,WESTERN EUROPE-EU,FRANCE,1,LONDON CITY,MARSEILLE,20,0,20,0,0,0,0
17/03/2016 11:32,2015,1,WESTERN EUROPE-EU,FRANCE,1,LONDON CITY,NANTES,22281,22281,0,24904,24904,0,-10.53244459
17/03/2016 11:32,2015,1,WESTERN EUROPE-EU,FRANCE,1,LONDON CITY,NICE,32438,32438,0,28735,28628,107,12.88672351
17/03/2016 11:32,2015,1,WESTERN EUROPE-EU,FRANCE,1,LONDON CITY,PARIS (CHARLES DE GAULLE),0,0,0,58,58,0,0
17/03/2016 11:32,2015,1,WESTERN EUROPE-EU,FRANCE,1,LONDON CITY,PARIS (ORLY),123214,123214,0,91323,91323,0,34.92110421
17/03/2016 11:32,2015,1,WESTERN EUROPE-EU,FRANCE,1,LONDON CITY,QUIMPER,4539,4539,0,4175,4175,0,8.718562874
17/03/2016 11:32,2015,1,WESTERN EUROPE-EU,FRANCE,1,LONDON CITY,RENNES,0,0,0,38,38,0,0
17/03/2016 11:32,2015,1,WESTERN EUROPE-EU,FRANCE,1,LONDON CITY,TOULON / HYERES,4252,4252,0,2830,2830,0,50.24734982
17/03/2016 11:32,2015,1,WESTERN EUROPE-EU,FRANCE,1,LUTON,BEZIERS,56284,56284,0,47282,47282,0,19.03895774
17/03/2016 11:32,2015,1,WESTERN EUROPE-EU,FRANCE,1,LUTON,BIARRITZ,0,0,0,92,0,92,0
17/03/2016 11:32,2015,1,WESTERN EUROPE-EU,FRANCE,1,LUTON,BORDEAUX,75177,73782,1395,70793,70717,76,6.192702668
17/03/2016 11:32,2015,1,WESTERN EUROPE-EU,FRANCE,1,LUTON,CHAMBERY,327,0,327,0,0,0,0
17/03/2016 11:32,2015,1,WESTERN EUROPE-EU,FRANCE,1,LUTON,CLERMONT FERRAND,3164,0,3164,81,0,81,3806.17284
17/03/2016 11:32,2015,1,WESTERN EUROPE-EU,FRANCE,1,LUTON,DEAUVILLE,12,0,12,0,0,0,0
17/03/2016 11:32,2015,1,WESTERN EUROPE-EU,FRANCE,1,LUTON,GRENOBLE,5382,5382,0,6813,6813,0,-21.00396301
17/03/2016 11:32,2015,1,WESTERN EUROPE-EU,FRANCE,1,LUTON,LILLE,86,0,86,0,0,0,0
17/03/2016 11:32,2015,1,WESTERN EUROPE-EU,FRANCE,1,LUTON,LYON,86499,85519,980,11877,11645,232,628.2899722
17/03/2016 11:32,2015,1,WESTERN EUROPE-EU,FRANCE,1,LUTON,LYON(BRON),133,0,133,0,0,0,0
17/03/2016 11:32,2015,1,WESTERN EUROPE-EU,FRANCE,1,LUTON,MARSEILLE,0,0,0,302,0,302,0
17/03/2016 11:32,2015,1,WESTERN EUROPE-EU,FRANCE,1,LUTON,METZ,10,0,10,0,0,0,0
17/03/2016 11:32,2015,1,WESTERN EUROPE-EU,FRANCE,1,LUTON,MONTPELLIER,16753,16670,83,16837,16837,0,-0.498901229
17/03/2016 11:32,2015,1,WESTERN EUROPE-EU,FRANCE,1,LUTON,NANTES,0,0,0,118,0,118,0
17/03/2016 11:32,2015,1,WESTERN EUROPE-EU,FRANCE,1,LUTON,NICE,153468,152405,1063,146010,145679,331,5.107869324
17/03/2016 11:32,2015,1,WESTERN EUROPE-EU,FRANCE,1,LUTON,NIMES,78292,78292,0,78879,78879,0,-0.744177791
17/03/2016 11:32,2015,1,WESTERN EUROPE-EU,FRANCE,1,LUTON,PARIS (CHARLES DE GAULLE),267014,266971,43,248726,248726,0,7.352669202
17/03/2016 11:32,2015,1,WESTERN EUROPE-EU,FRANCE,1,LUTON,PARIS (LE BOURGET),223,0,223,164,0,164,35.97560976
17/03/2016 11:32,2015,1,WESTERN EUROPE-EU,FRANCE,1,LUTON,PAU,369,0,369,0,0,0,0
17/03/2016 11:32,2015,1,WESTERN EUROPE-EU,FRANCE,1,LUTON,PERPIGNAN,0,0,0,66,0,66,0
17/03/2016 11:32,2015,1,WESTERN EUROPE-EU,FRANCE,1,LUTON,POITIERS,38,0,38,0,0,0,0
17/03/2016 11:32,2015,1,WESTERN EUROPE-EU,FRANCE,1,LUTON,ST ETIENNE,204,0,204,0,0,0,0
17/03/2016 11:32,2015,1,WESTERN EUROPE-EU,FRANCE,1,LUTON,STRASBOURG,9,0,9,0,0,0,0
17/03/2016 11:32,2015,1,WESTERN EUROPE-EU,FRANCE,1,LUTON,TOULON / HYERES,1046,0,1046,0,0,0,0
17/03/2016 11:32,2015,1,WESTERN EUROPE-EU,FRANCE,1,LUTON,TOULOUSE (BLAGNAC),1452,0,1452,260,0,260,458.4615385
17/03/2016 11:32,2015,1,WESTERN EUROPE-EU,FRANCE,1,LUTON,VARY (CHALONS SUR MARNE),0,0,0,37,0,37,0
17/03/2016 11:32,2015,1,WESTERN EUROPE-EU,FRANCE,1,SOUTHEND,CAEN,10363,10363,0,7102,7102,0,45.9166432
17/03/2016 11:32,2015,1,WESTERN EUROPE-EU,FRANCE,1,SOUTHEND,LYON,498,498,0,0,0,0,0
17/03/2016 11:32,2015,1,WESTERN EUROPE-EU,FRANCE,1,SOUTHEND,PARIS (LE BOURGET),0,0,0,22,0,22,0
17/03/2016 11:32,2015,1,WESTERN EUROPE-EU,FRANCE,1,SOUTHEND,PAU,366,0,366,0,0,0,0
17/03/2016 11:32,2015,1,WESTERN EUROPE-EU,FRANCE,1,SOUTHEND,RENNES,34468,34468,0,22482,22482,0,53.31376212
17/03/2016 11:32,2015,1,WESTERN EUROPE-EU,FRANCE,1,STANSTED,BERGERAC,105474,105474,0,100508,100508,0,4.940900227
17/03/2016 11:32,2015,1,WESTERN EUROPE-EU,FRANCE,1,STANSTED,BIARRITZ,98115,98115,0,95999,95999,0,2.204189627
17/03/2016 11:32,2015,1,WESTERN EUROPE-EU,FRANCE,1,STANSTED,BORDEAUX,46757,46574,183,36386,36386,0,28.50272083
17/03/2016 11:32,2015,1,WESTERN EUROPE-EU,FRANCE,1,STANSTED,BRIVE-LA-GAILLARDE,18548,18548,0,16101,16101,0,15.1978138
17/03/2016 11:32,2015,1,WESTERN EUROPE-EU,FRANCE,1,STANSTED,CALVI,4369,0,4369,4026,0,4026,8.519622454
17/03/2016 11:32,2015,1,WESTERN EUROPE-EU,FRANCE,1,STANSTED,CARCASSONNE,100016,100016,0,93734,93734,0,6.701943798
17/03/2016 11:32,2015,1,WESTERN EUROPE-EU,FRANCE,1,STANSTED,CHAMBERY,19143,0,19143,17116,0,17116,11.84272026
17/03/2016 11:32,2015,1,WESTERN EUROPE-EU,FRANCE,1,STANSTED,CLERMONT FERRAND,5894,5894,0,0,0,0,0
17/03/2016 11:32,2015,1,WESTERN EUROPE-EU,FRANCE,1,STANSTED,DEAUVILLE,17612,17612,0,0,0,0,0
17/03/2016 11:32,2015,1,WESTERN EUROPE-EU,FRANCE,1,STANSTED,DINARD,86654,86654,0,77940,77940,0,11.18039518
17/03/2016 11:32,2015,1,WESTERN EUROPE-EU,FRANCE,1,STANSTED,GRENOBLE,20048,16624,3424,18875,15904,2971,6.214569536
17/03/2016 11:32,2015,1,WESTERN EUROPE-EU,FRANCE,1,STANSTED,LA ROCHELLE,60970,60970,0,59042,59042,0,3.265472037
17/03/2016 11:32,2015,1,WESTERN EUROPE-EU,FRANCE,1,STANSTED,LIMOGES,94681,94681,0,94541,94541,0,0.1480839
17/03/2016 11:32,2015,1,WESTERN EUROPE-EU,FRANCE,1,STANSTED,LYON,584,0,584,78090,77266,824,-99.25214496
17/03/2016 11:32,2015,1,WESTERN EUROPE-EU,FRANCE,1,STANSTED,MARSEILLE,140144,140144,0,127961,127961,0,9.52086964
17/03/2016 11:32,2015,1,WESTERN EUROPE-EU,FRANCE,1,STANSTED,NICE,65330,65206,124,71880,71218,662,-9.112409572
17/03/2016 11:32,2015,1,WESTERN EUROPE-EU,FRANCE,1,STANSTED,PARIS (CHARLES DE GAULLE),252,0,252,0,0,0,0
17/03/2016 11:32,2015,1,WESTERN EUROPE-EU,FRANCE,1,STANSTED,PAU,27,0,27,0,0,0,0
17/03/2016 11:32,2015,1,WESTERN EUROPE-EU,FRANCE,1,STANSTED,PERPIGNAN,59463,59463,0,59600,59600,0,-0.229865772
17/03/2016 11:32,2015,1,WESTERN EUROPE-EU,FRANCE,1,STANSTED,POITIERS,59550,59550,0,51220,51220,0,16.26317845
17/03/2016 11:32,2015,1,WESTERN EUROPE-EU,FRANCE,1,STANSTED,RODEZ,26382,26382,0,28735,28735,0,-8.18862015
17/03/2016 11:32,2015,1,WESTERN EUROPE-EU,FRANCE,1,STANSTED,STRASBOURG,42579,42579,0,32917,32917,0,29.35261415
17/03/2016 11:32,2015,1,WESTERN EUROPE-EU,FRANCE,1,STANSTED,TARBES-LOURDES INTERNATIONAL,42951,36811,6140,40561,33206,7355,5.892359656
17/03/2016 11:32,2015,1,WESTERN EUROPE-EU,FRANCE,1,STANSTED,TOULON / HYERES,0,0,0,34401,34401,0,0
17/03/2016 11:32,2015,1,WESTERN EUROPE-EU,FRANCE,1,STANSTED,TOURS,57072,57072,0,50828,50828,0,12.28456756
17/03/2016 11:32,2015,1,WESTERN EUROPE-EU,FRANCE,2,ABERDEEN,BIARRITZ,0,0,0,264,0,264,0
17/03/2016 11:32,2015,1,WESTERN EUROPE-EU,FRANCE,2,ABERDEEN,PARIS (CHARLES DE GAULLE),110739,110739,0,110541,110541,0,0.17911906
17/03/2016 11:32,2015,1,WESTERN EUROPE-EU,FRANCE,2,ABERDEEN,PARIS (LE BOURGET),0,0,0,29,0,29,0
17/03/2016 11:32,2015,1,WESTERN EUROPE-EU,FRANCE,2,BELFAST CITY (GEORGE BEST),PARIS (CHARLES DE GAULLE),0,0,0,1754,1754,0,0
17/03/2016 11:32,2015,1,WESTERN EUROPE-EU,FRANCE,2,BELFAST CITY (GEORGE BEST),TOULOUSE (BLAGNAC),0,0,0,2318,0,2318,0
17/03/2016 11:32,2015,1,WESTERN EUROPE-EU,FRANCE,2,BELFAST INTERNATIONAL,BORDEAUX,7299,7299,0,3408,3408,0,114.1725352
17/03/2016 11:32,2015,1,WESTERN EUROPE-EU,FRANCE,2,BELFAST INTERNATIONAL,LE TOUQUET,78,0,78,0,0,0,0
17/03/2016 11:32,2015,1,WESTERN EUROPE-EU,FRANCE,2,BELFAST INTERNATIONAL,LILLE,0,0,0,90,0,90,0
17/03/2016 11:32,2015,1,WESTERN EUROPE-EU,FRANCE,2,BELFAST INTERNATIONAL,LYON,619,450,169,0,0,0,0
17/03/2016 11:32,2015,1,WESTERN EUROPE-EU,FRANCE,2,BELFAST INTERNATIONAL,NICE,20081,20081,0,19503,19503,0,2.963646618
17/03/2016 11:32,2015,1,WESTERN EUROPE-EU,FRANCE,2,BELFAST INTERNATIONAL,PARIS (CHARLES DE GAULLE),77969,77912,57,79820,79706,114,-2.318967677
17/03/2016 11:32,2015,1,WESTERN EUROPE-EU,FRANCE,2,BELFAST INTERNATIONAL,PARIS (LE BOURGET),80,0,80,0,0,0,0
17/03/2016 11:32,2015,1,WESTERN EUROPE-EU,FRANCE,2,BELFAST INTERNATIONAL,TARBES-LOURDES INTERNATIONAL,6668,0,6668,7140,0,7140,-6.610644258
17/03/2016 11:32,2015,1,WESTERN EUROPE-EU,FRANCE,2,BELFAST INTERNATIONAL,TOULON / HYERES,347,0,347,187,0,187,85.56149733
17/03/2016 11:32,2015,1,WESTERN EUROPE-EU,FRANCE,2,BELFAST INTERNATIONAL,TOULOUSE (BLAGNAC),2834,0,2834,252,0,252,1024.603175
17/03/2016 11:32,2015,1,WESTERN EUROPE-EU,FRANCE,2,BIGGIN HILL,AVIGNON,0,0,0,10,0,10,0
17/03/2016 11:32,2015,1,WESTERN EUROPE-EU,FRANCE,2,BIGGIN HILL,CLERMONT FERRAND,0,0,0,10,0,10,0
17/03/2016 11:32,2015,1,WESTERN EUROPE-EU,FRANCE,2,BIGGIN HILL,NICE,40,0,40,8,0,8,400
17/03/2016 11:32,2015,1,WESTERN EUROPE-EU,FRANCE,2,BIGGIN HILL,ST NAZAIRE,0,0,0,44,0,44,0
17/03/2016 11:32,2015,1,WESTERN EUROPE-EU,FRANCE,2,BIRMINGHAM,AVIGNON,3087,3087,0,2066,2066,0,49.41916747
17/03/2016 11:32,2015,1,WESTERN EUROPE-EU,FRANCE,2,BIRMINGHAM,BASTIA,2018,2018,0,0,0,0,0
17/03/2016 11:32,2015,1,WESTERN EUROPE-EU,FRANCE,2,BIRMINGHAM,BEAUVAIS,0,0,0,145,0,145,0
17/03/2016 11:32,2015,1,WESTERN EUROPE-EU,FRANCE,2,BIRMINGHAM,BERGERAC,6914,6914,0,4852,4852,0,42.49793899
17/03/2016 11:32,2015,1,WESTERN EUROPE-EU,FRANCE,2,BIRMINGHAM,BIARRITZ,2181,2181,0,0,0,0,0
17/03/2016 11:32,2015,1,WESTERN EUROPE-EU,FRANCE,2,BIRMINGHAM,BORDEAUX,15784,15634,150,13614,13614,0,15.93947407
17/03/2016 11:32,2015,1,WESTERN EUROPE-EU,FRANCE,2,BIRMINGHAM,BREST,2520,2520,0,3474,3474,0,-27.4611399
17/03/2016 11:32,2015,1,WESTERN EUROPE-EU,FRANCE,2,BIRMINGHAM,BRIVE-LA-GAILLARDE,0,0,0,96,0,96,0
17/03/2016 11:32,2015,1,WESTERN EUROPE-EU,FRANCE,2,BIRMINGHAM,CHAMBERY,16560,3339,13221,13929,2795,11134,18.88864958
17/03/2016 11:32,2015,1,WESTERN EUROPE-EU,FRANCE,2,BIRMINGHAM,CLERMONT FERRAND,0,0,0,136,0,136,0
17/03/2016 11:32,2015,1,WESTERN EUROPE-EU,FRANCE,2,BIRMINGHAM,DEAUVILLE,3094,3094,0,0,0,0,0
17/03/2016 11:32,2015,1,WESTERN EUROPE-EU,FRANCE,2,BIRMINGHAM,GRENOBLE,20236,14438,5798,20854,11856,8998,-2.963460247
17/03/2016 11:32,2015,1,WESTERN EUROPE-EU,FRANCE,2,BIRMINGHAM,LA ROCHELLE,4429,4273,156,2929,2929,0,51.21201775
17/03/2016 11:32,2015,1,WESTERN EUROPE-EU,FRANCE,2,BIRMINGHAM,LE CASTELLET,36,0,36,0,0,0,0
17/03/2016 11:32,2015,1,WESTERN EUROPE-EU,FRANCE,2,BIRMINGHAM,LYON,49043,48358,685,44363,44094,269,10.54933165
17/03/2016 11:32,2015,1,WESTERN EUROPE-EU,FRANCE,2,BIRMINGHAM,NANTES,25,0,25,0,0,0,0
17/03/2016 11:32,2015,1,WESTERN EUROPE-EU,FRANCE,2,BIRMINGHAM,NICE,29954,29954,0,31907,31703,204,-6.120913906
17/03/2016 11:32,2015,1,WESTERN EUROPE-EU,FRANCE,2,BIRMINGHAM,PARIS (CHARLES DE GAULLE),402975,402708,267,386403,386257,146,4.288786578
17/03/2016 11:32,2015,1,WESTERN EUROPE-EU,FRANCE,2,BIRMINGHAM,PARIS (LE BOURGET),0,0,0,94,0,94,0
17/03/2016 11:32,2015,1,WESTERN EUROPE-EU,FRANCE,2,BIRMINGHAM,PAU,0,0,0,5,0,5,0
17/03/2016 11:32,2015,1,WESTERN EUROPE-EU,FRANCE,2,BIRMINGHAM,PERPIGNAN,8254,8254,0,7428,7320,108,11.12008616
17/03/2016 11:32,2015,1,WESTERN EUROPE-EU,FRANCE,2,BIRMINGHAM,TARBES-LOURDES INTERNATIONAL,1542,0,1542,1337,0,1337,15.3328347
17/03/2016 11:32,2015,1,WESTERN EUROPE-EU,FRANCE,2,BIRMINGHAM,TOULON / HYERES,145,0,145,124,0,124,16.93548387
17/03/2016 11:32,2015,1,WESTERN EUROPE-EU,FRANCE,2,BIRMINGHAM,TOULOUSE (BLAGNAC),11712,7952,3760,29593,23716,5877,-60.42307302
17/03/2016 11:32,2015,1,WESTERN EUROPE-EU,FRANCE,2,BOURNEMOUTH,BIARRITZ,2245,2245,0,0,0,0,0
17/03/2016 11:32,2015,1,WESTERN EUROPE-EU,FRANCE,2,BOURNEMOUTH,CARCASSONNE,0,0,0,17230,17230,0,0
17/03/2016 11:32,2015,1,WESTERN EUROPE-EU,FRANCE,2,BOURNEMOUTH,CHAMPFORGEUIL,0,0,0,72,0,72,0
17/03/2016 11:32,2015,1,WESTERN EUROPE-EU,FRANCE,2,BOURNEMOUTH,DEAUVILLE,2597,2597,0,0,0,0,0
17/03/2016 11:32,2015,1,WESTERN EUROPE-EU,FRANCE,2,BOURNEMOUTH,NANTES,68,0,68,0,0,0,0
17/03/2016 11:32,2015,1,WESTERN EUROPE-EU,FRANCE,2,BOURNEMOUTH,PARIS (CHARLES DE GAULLE),12988,12988,0,0,0,0,0
17/03/2016 11:32,2015,1,WESTERN EUROPE-EU,FRANCE,2,BOURNEMOUTH,TOULON / HYERES,8151,8151,0,0,0,0,0
17/03/2016 11:32,2015,1,WESTERN EUROPE-EU,FRANCE,2,BRISTOL,BASTIA,1199,0,1199,1070,0,1070,12.05607477
17/03/2016 11:32,2015,1,WESTERN EUROPE-EU,FRANCE,2,BRISTOL,BERGERAC,24649,24649,0,23479,23479,0,4.983176456
17/03/2016 11:32,2015,1,WESTERN EUROPE-EU,FRANCE,2,BRISTOL,BEZIERS,39059,39059,0,34646,34646,0,12.73740114
17/03/2016 11:32,2015,1,WESTERN EUROPE-EU,FRANCE,2,BRISTOL,BORDEAUX,35214,35214,0,33956,33956,0,3.70479444
17/03/2016 11:32,2015,1,WESTERN EUROPE-EU,FRANCE,2,BRISTOL,BRIVE-LA-GAILLARDE,0,0,0,83,0,83,0
17/03/2016 11:32,2015,1,WESTERN EUROPE-EU,FRANCE,2,BRISTOL,CHAMBERY,12097,0,12097,14919,0,14919,-18.91547691
17/03/2016 11:32,2015,1,WESTERN EUROPE-EU,FRANCE,2,BRISTOL,GRENOBLE,9059,9059,0,9433,9433,0,-3.96480441
17/03/2016 11:32,2015,1,WESTERN EUROPE-EU,FRANCE,2,BRISTOL,LA ROCHELLE,7635,7635,0,12532,12532,0,-39.07596553
17/03/2016 11:32,2015,1,WESTERN EUROPE-EU,FRANCE,2,BRISTOL,LIMOGES,21369,21369,0,17722,17722,0,20.57894143
17/03/2016 11:32,2015,1,WESTERN EUROPE-EU,FRANCE,2,BRISTOL,LYON,5514,5337,177,5246,5246,0,5.108654213
17/03/2016 11:32,2015,1,WESTERN EUROPE-EU,FRANCE,2,BRISTOL,MARSEILLE,10717,10717,0,10399,10399,0,3.057986345
17/03/2016 11:32,2015,1,WESTERN EUROPE-EU,FRANCE,2,BRISTOL,MONTPELLIER,0,0,0,84,0,84,0
17/03/2016 11:32,2015,1,WESTERN EUROPE-EU,FRANCE,2,BRISTOL,NANTES,846,846,0,370,0,370,128.6486486
17/03/2016 11:32,2015,1,WESTERN EUROPE-EU,FRANCE,2,BRISTOL,NICE,72405,72377,28,70040,70040,0,3.376641919
17/03/2016 11:32,2015,1,WESTERN EUROPE-EU,FRANCE,2,BRISTOL,PARIS (CHARLES DE GAULLE),131899,131047,852,120341,120164,177,9.604374237
17/03/2016 11:32,2015,1,WESTERN EUROPE-EU,FRANCE,2,BRISTOL,TARBES-LOURDES INTERNATIONAL,495,0,495,479,0,479,3.340292276
17/03/2016 11:32,2015,1,WESTERN EUROPE-EU,FRANCE,2,BRISTOL,TOULON / HYERES,82,0,82,0,0,0,0
17/03/2016 11:32,2015,1,WESTERN EUROPE-EU,FRANCE,2,BRISTOL,TOULOUSE (BLAGNAC),110399,89763,20636,112061,86844,25217,-1.4831208
17/03/2016 11:32,2015,1,WESTERN EUROPE-EU,FRANCE,2,CAMBRIDGE,PARIS (CHARLES DE GAULLE),0,0,0,279,279,0,0
17/03/2016 11:32,2015,1,WESTERN EUROPE-EU,FRANCE,2,CARDIFF WALES,BORDEAUX,1849,0,1849,127,0,127,1355.905512
17/03/2016 11:32,2015,1,WESTERN EUROPE-EU,FRANCE,2,CARDIFF WALES,CHAMBERY,201,201,0,1606,1606,0,-87.48443337
17/03/2016 11:32,2015,1,WESTERN EUROPE-EU,FRANCE,2,CARDIFF WALES,CLERMONT FERRAND,92,0,92,137,0,137,-32.84671533
17/03/2016 11:32,2015,1,WESTERN EUROPE-EU,FRANCE,2,CARDIFF WALES,GRENOBLE,181,0,181,614,278,336,-70.52117264
17/03/2016 11:32,2015,1,WESTERN EUROPE-EU,FRANCE,2,CARDIFF WALES,LE MANS,0,0,0,86,0,86,0
17/03/2016 11:32,2015,1,WESTERN EUROPE-EU,FRANCE,2,CARDIFF WALES,LYON,2002,0,2002,2078,448,1630,-3.657362849
17/03/2016 11:32,2015,1,WESTERN EUROPE-EU,FRANCE,2,CARDIFF WALES,LYON(BRON),0,0,0,100,0,100,0
17/03/2016 11:32,2015,1,WESTERN EUROPE-EU,FRANCE,2,CARDIFF WALES,MARSEILLE,642,0,642,239,0,239,168.6192469
17/03/2016 11:32,2015,1,WESTERN EUROPE-EU,FRANCE,2,CARDIFF WALES,MONTPELLIER,242,0,242,0,0,0,0
17/03/2016 11:32,2015,1,WESTERN EUROPE-EU,FRANCE,2,CARDIFF WALES,NANTES,45,0,45,198,0,198,-77.27272727
17/03/2016 11:32,2015,1,WESTERN EUROPE-EU,FRANCE,2,CARDIFF WALES,NICE,0,0,0,174,0,174,0
17/03/2016 11:32,2015,1,WESTERN EUROPE-EU,FRANCE,2,CARDIFF WALES,PARIS (CHARLES DE GAULLE),30442,27628,2814,3174,1685,1489,859.10523
17/03/2016 11:32,2015,1,WESTERN EUROPE-EU,FRANCE,2,CARDIFF WALES,PARIS (LE BOURGET),126,0,126,41,0,41,207.3170732
17/03/2016 11:32,2015,1,WESTERN EUROPE-EU,FRANCE,2,CARDIFF WALES,PARIS (ORLY),13153,10759,2394,20714,19240,1474,-36.50188278
17/03/2016 11:32,2015,1,WESTERN EUROPE-EU,FRANCE,2,CARDIFF WALES,PAU,78,0,78,0,0,0,0
17/03/2016 11:32,2015,1,WESTERN EUROPE-EU,FRANCE,2,CARDIFF WALES,TARBES-LOURDES INTERNATIONAL,323,0,323,343,0,343,-5.83090379
17/03/2016 11:32,2015,1,WESTERN EUROPE-EU,FRANCE,2,CARDIFF WALES,TOULON / HYERES,178,0,178,3762,0,3762,-95.26847422
17/03/2016 11:32,2015,1,WESTERN EUROPE-EU,FRANCE,2,CARDIFF WALES,TOULOUSE (BLAGNAC),2059,0,2059,2148,0,2148,-4.143389199
17/03/2016 11:32,2015,1,WESTERN EUROPE-EU,FRANCE,2,DONCASTER SHEFFIELD,LILLE,0,0,0,45,0,45,0
17/03/2016 11:32,2015,1,WESTERN EUROPE-EU,FRANCE,2,DONCASTER SHEFFIELD,TARBES-LOURDES INTERNATIONAL,470,0,470,0,0,0,0
17/03/2016 11:32,2015,1,WESTERN EUROPE-EU,FRANCE,2,DURHAM TEES VALLEY,PARIS (CHARLES DE GAULLE),0,0,0,49,0,49,0
17/03/2016 11:32,2015,1,WESTERN EUROPE-EU,FRANCE,2,DURHAM TEES VALLEY,TARBES-LOURDES INTERNATIONAL,601,0,601,604,0,604,-0.496688742
17/03/2016 11:32,2015,1,WESTERN EUROPE-EU,FRANCE,2,EAST MIDLANDS INTERNATIONAL,BERGERAC,20722,20722,0,18807,18807,0,10.1823789
17/03/2016 11:32,2015,1,WESTERN EUROPE-EU,FRANCE,2,EAST MIDLANDS INTERNATIONAL,BORDEAUX,121,0,121,0,0,0,0
17/03/2016 11:32,2015,1,WESTERN EUROPE-EU,FRANCE,2,EAST MIDLANDS INTERNATIONAL,BREST,0,0,0,42,0,42,0
17/03/2016 11:32,2015,1,WESTERN EUROPE-EU,FRANCE,2,EAST MIDLANDS INTERNATIONAL,CARCASSONNE,30736,30736,0,29702,29702,0,3.481247054
17/03/2016 11:32,2015,1,WESTERN EUROPE-EU,FRANCE,2,EAST MIDLANDS INTERNATIONAL,CHAMBERY,13087,7368,5719,13812,8056,5756,-5.249058789
17/03/2016 11:32,2015,1,WESTERN EUROPE-EU,FRANCE,2,EAST MIDLANDS INTERNATIONAL,DINARD,31931,31931,0,26840,26840,0,18.96795827
17/03/2016 11:32,2015,1,WESTERN EUROPE-EU,FRANCE,2,EAST MIDLANDS INTERNATIONAL,LA ROCHELLE,8619,8619,0,12494,12494,0,-31.01488715
17/03/2016 11:32,2015,1,WESTERN EUROPE-EU,FRANCE,2,EAST MIDLANDS INTERNATIONAL,LIMOGES,49216,49216,0,48692,48692,0,1.07615214
17/03/2016 11:32,2015,1,WESTERN EUROPE-EU,FRANCE,2,EAST MIDLANDS INTERNATIONAL,LYON,103,0,103,297,0,297,-65.31986532
17/03/2016 11:32,2015,1,WESTERN EUROPE-EU,FRANCE,2,EAST MIDLANDS INTERNATIONAL,MARSEILLE,85,0,85,0,0,0,0
17/03/2016 11:32,2015,1,WESTERN EUROPE-EU,FRANCE,2,EAST MIDLANDS INTERNATIONAL,NANTES,152,0,152,0,0,0,0
17/03/2016 11:32,2015,1,WESTERN EUROPE-EU,FRANCE,2,EAST MIDLANDS INTERNATIONAL,NICE,0,0,0,188,0,188,0
17/03/2016 11:32,2015,1,WESTERN EUROPE-EU,FRANCE,2,EAST MIDLANDS INTERNATIONAL,PARIS (CHARLES DE GAULLE),589,0,589,18280,18117,163,-96.77789934
17/03/2016 11:32,2015,1,WESTERN EUROPE-EU,FRANCE,2,EAST MIDLANDS INTERNATIONAL,TARBES-LOURDES INTERNATIONAL,281,0,281,252,0,252,11.50793651
17/03/2016 11:32,2015,1,WESTERN EUROPE-EU,FRANCE,2,EDINBURGH,BEAUVAIS,0,0,0,10601,10601,0,0
17/03/2016 11:32,2015,1,WESTERN EUROPE-EU,FRANCE,2,EDINBURGH,BERGERAC,2104,2104,0,2193,2193,0,-4.058367533
17/03/2016 11:32,2015,1,WESTERN EUROPE-EU,FRANCE,2,EDINBURGH,BEZIERS,21424,21424,0,20269,20269,0,5.698357097
17/03/2016 11:32,2015,1,WESTERN EUROPE-EU,FRANCE,2,EDINBURGH,BIARRITZ,0,0,0,103,0,103,0
17/03/2016 11:32,2015,1,WESTERN EUROPE-EU,FRANCE,2,EDINBURGH,BORDEAUX,33250,33121,129,31068,29717,1351,7.023303721
17/03/2016 11:32,2015,1,WESTERN EUROPE-EU,FRANCE,2,EDINBURGH,CHAMBERY,6874,4033,2841,9801,4214,5587,-29.86429956
17/03/2016 11:32,2015,1,WESTERN EUROPE-EU,FRANCE,2,EDINBURGH,CLERMONT FERRAND,92,0,92,0,0,0,0
17/03/2016 11:32,2015,1,WESTERN EUROPE-EU,FRANCE,2,EDINBURGH,GRENOBLE,4841,4659,182,6044,5305,739,-19.90403706
17/03/2016 11:32,2015,1,WESTERN EUROPE-EU,FRANCE,2,EDINBURGH,LA ROCHELLE,0,0,0,2571,2571,0,0
17/03/2016 11:32,2015,1,WESTERN EUROPE-EU,FRANCE,2,EDINBURGH,LYON,19533,19533,0,23439,21887,1552,-16.66453347
17/03/2016 11:32,2015,1,WESTERN EUROPE-EU,FRANCE,2,EDINBURGH,LYON(BRON),0,0,0,85,0,85,0
17/03/2016 11:32,2015,1,WESTERN EUROPE-EU,FRANCE,2,EDINBURGH,MARSEILLE,22338,22338,0,16733,15650,1083,33.4966832
17/03/2016 11:32,2015,1,WESTERN EUROPE-EU,FRANCE,2,EDINBURGH,MONTPELLIER,0,0,0,361,0,361,0
17/03/2016 11:32,2015,1,WESTERN EUROPE-EU,FRANCE,2,EDINBURGH,NANTES,0,0,0,370,0,370,0
17/03/2016 11:32,2015,1,WESTERN EUROPE-EU,FRANCE,2,EDINBURGH,NICE,51057,51057,0,43669,43649,20,16.91817994
17/03/2016 11:32,2015,1,WESTERN EUROPE-EU,FRANCE,2,EDINBURGH,PARIS (CHARLES DE GAULLE),300611,299293,1318,303647,299182,4465,-0.999845215
17/03/2016 11:32,2015,1,WESTERN EUROPE-EU,FRANCE,2,EDINBURGH,PARIS (LE BOURGET),0,0,0,175,0,175,0
17/03/2016 11:32,2015,1,WESTERN EUROPE-EU,FRANCE,2,EDINBURGH,PARIS (ORLY),0,0,0,1295,0,1295,0
17/03/2016 11:32,2015,1,WESTERN EUROPE-EU,FRANCE,2,EDINBURGH,PAU,0,0,0,326,0,326,0
17/03/2016 11:32,2015,1,WESTERN EUROPE-EU,FRANCE,2,EDINBURGH,PERPIGNAN,0,0,0,227,0,227,0
17/03/2016 11:32,2015,1,WESTERN EUROPE-EU,FRANCE,2,EDINBURGH,POITIERS,6113,6113,0,5375,5375,0,13.73023256
17/03/2016 11:32,2015,1,WESTERN EUROPE-EU,FRANCE,2,EDINBURGH,TARBES-LOURDES INTERNATIONAL,1101,0,1101,1294,0,1294,-14.91499227
17/03/2016 11:32,2015,1,WESTERN EUROPE-EU,FRANCE,2,EDINBURGH,TOULOUSE (BLAGNAC),1539,0,1539,11778,9815,1963,-86.93326541
17/03/2016 11:32,2015,1,WESTERN EUROPE-EU,FRANCE,2,EXETER,BERGERAC,2532,2532,0,2594,2594,0,-2.390131072
17/03/2016 11:32,2015,1,WESTERN EUROPE-EU,FRANCE,2,EXETER,BORDEAUX,80,0,80,0,0,0,0
17/03/2016 11:32,2015,1,WESTERN EUROPE-EU,FRANCE,2,EXETER,CHAMBERY,2131,2131,0,2656,2568,88,-19.76656627
17/03/2016 11:32,2015,1,WESTERN EUROPE-EU,FRANCE,2,EXETER,CLERMONT FERRAND,314,0,314,0,0,0,0
17/03/2016 11:32,2015,1,WESTERN EUROPE-EU,FRANCE,2,EXETER,DEAUVILLE,1831,1831,0,0,0,0,0
17/03/2016 11:32,2015,1,WESTERN EUROPE-EU,FRANCE,2,EXETER,LA ROCHELLE,0,0,0,99,0,99,0
17/03/2016 11:32,2015,1,WESTERN EUROPE-EU,FRANCE,2,EXETER,PARIS (CHARLES DE GAULLE),43063,43063,0,50519,50519,0,-14.75880362
17/03/2016 11:32,2015,1,WESTERN EUROPE-EU,FRANCE,2,EXETER,PARIS (LE BOURGET),0,0,0,57,57,0,0
17/03/2016 11:32,2015,1,WESTERN EUROPE-EU,FRANCE,2,EXETER,RENNES,829,829,0,2033,2033,0,-59.22282341
17/03/2016 11:32,2015,1,WESTERN EUROPE-EU,FRANCE,2,EXETER,TARBES-LOURDES INTERNATIONAL,288,0,288,286,0,286,0.699300699
17/03/2016 11:32,2015,1,WESTERN EUROPE-EU,FRANCE,2,GLASGOW,BORDEAUX,5265,5265,0,0,0,0,0
17/03/2016 11:32,2015,1,WESTERN EUROPE-EU,FRANCE,2,GLASGOW,CANNES,0,0,0,4,0,4,0
17/03/2016 11:32,2015,1,WESTERN EUROPE-EU,FRANCE,2,GLASGOW,CARCASSONNE,19404,19404,0,0,0,0,0
17/03/2016 11:32,2015,1,WESTERN EUROPE-EU,FRANCE,2,GLASGOW,CHAMBERY,6197,0,6197,5912,0,5912,4.820703654
17/03/2016 11:32,2015,1,WESTERN EUROPE-EU,FRANCE,2,GLASGOW,LE TOUQUET,0,0,0,4,0,4,0
17/03/2016 11:32,2015,1,WESTERN EUROPE-EU,FRANCE,2,GLASGOW,LYON(BRON),18,0,18,0,0,0,0
17/03/2016 11:32,2015,1,WESTERN EUROPE-EU,FRANCE,2,GLASGOW,MONTPELLIER,72,0,72,88,0,88,-18.18181818
17/03/2016 11:32,2015,1,WESTERN EUROPE-EU,FRANCE,2,GLASGOW,NICE,345,0,345,194,0,194,77.83505155
17/03/2016 11:32,2015,1,WESTERN EUROPE-EU,FRANCE,2,GLASGOW,PARIS (CHARLES DE GAULLE),110833,110722,111,98924,98687,237,12.03853463
17/03/2016 11:32,2015,1,WESTERN EUROPE-EU,FRANCE,2,GLASGOW,PARIS (LE BOURGET),35,0,35,42,0,42,-16.66666667
17/03/2016 11:32,2015,1,WESTERN EUROPE-EU,FRANCE,2,GLASGOW,RENNES,35,0,35,60,0,60,-41.66666667
17/03/2016 11:32,2015,1,WESTERN EUROPE-EU,FRANCE,2,GLASGOW,TARBES-LOURDES INTERNATIONAL,1657,0,1657,1381,0,1381,19.98551774
17/03/2016 11:32,2015,1,WESTERN EUROPE-EU,FRANCE,2,GLASGOW,TOULON / HYERES,0,0,0,228,0,228,0
17/03/2016 11:32,2015,1,WESTERN EUROPE-EU,FRANCE,2,GLASGOW,TOULOUSE (BLAGNAC),0,0,0,244,0,244,0
17/03/2016 11:32,2015,1,WESTERN EUROPE-EU,FRANCE,2,GUERNSEY,CHAMBERY,0,0,0,7,0,7,0
17/03/2016 11:32,2015,1,WESTERN EUROPE-EU,FRANCE,2,GUERNSEY,CHERBOURG,0,0,0,45,0,45,0
17/03/2016 11:32,2015,1,WESTERN EUROPE-EU,FRANCE,2,GUERNSEY,DINARD,2698,2698,0,2987,2933,54,-9.675259458
17/03/2016 11:32,2015,1,WESTERN EUROPE-EU,FRANCE,2,GUERNSEY,GRENOBLE,822,822,0,887,887,0,-7.328072153
17/03/2016 11:32,2015,1,WESTERN EUROPE-EU,FRANCE,2,HUMBERSIDE,NICE,324,0,324,15,0,15,2060
17/03/2016 11:32,2015,1,WESTERN EUROPE-EU,FRANCE,2,HUMBERSIDE,PARIS (CHARLES DE GAULLE),44,0,44,0,0,0,0
17/03/2016 11:32,2015,1,WESTERN EUROPE-EU,FRANCE,2,HUMBERSIDE,PERPIGNAN,0,0,0,33,0,33,0
17/03/2016 11:32,2015,1,WESTERN EUROPE-EU,FRANCE,2,ISLE OF MAN,RENNES,238,0,238,0,0,0,0
17/03/2016 11:32,2015,1,WESTERN EUROPE-EU,FRANCE,2,ISLE OF MAN,TOULOUSE (BLAGNAC),0,0,0,62,0,62,0
17/03/2016 11:32,2015,1,WESTERN EUROPE-EU,FRANCE,2,JERSEY,CHAMBERY,390,390,0,771,771,0,-49.41634241
17/03/2016 11:32,2015,1,WESTERN EUROPE-EU,FRANCE,2,JERSEY,DINARD,0,0,0,16,16,0,0
17/03/2016 11:32,2015,1,WESTERN EUROPE-EU,FRANCE,2,JERSEY,NANTES,0,0,0,163,0,163,0
17/03/2016 11:32,2015,1,WESTERN EUROPE-EU,FRANCE,2,JERSEY,PARIS (CHARLES DE GAULLE),421,130,291,8338,8178,160,-94.95082754
17/03/2016 11:32,2015,1,WESTERN EUROPE-EU,FRANCE,2,JERSEY,TARBES-LOURDES INTERNATIONAL,0,0,0,138,0,138,0
17/03/2016 11:32,2015,1,WESTERN EUROPE-EU,FRANCE,2,LEEDS BRADFORD,BERGERAC,4680,4680,0,4315,4315,0,8.458864426
17/03/2016 11:32,2015,1,WESTERN EUROPE-EU,FRANCE,2,LEEDS BRADFORD,CALVI,0,0,0,11,0,11,0
17/03/2016 11:32,2015,1,WESTERN EUROPE-EU,FRANCE,2,LEEDS BRADFORD,CHAMBERY,6857,6857,0,6407,6407,0,7.023567973
17/03/2016 11:32,2015,1,WESTERN EUROPE-EU,FRANCE,2,LEEDS BRADFORD,DINARD,7850,7850,0,5450,5450,0,44.03669725
17/03/2016 11:32,2015,1,WESTERN EUROPE-EU,FRANCE,2,LEEDS BRADFORD,FREJUS,0,0,0,2055,2055,0,0
17/03/2016 11:32,2015,1,WESTERN EUROPE-EU,FRANCE,2,LEEDS BRADFORD,GRENOBLE,774,774,0,2228,2228,0,-65.26032316
17/03/2016 11:32,2015,1,WESTERN EUROPE-EU,FRANCE,2,LEEDS BRADFORD,LA ROCHELLE,0,0,0,3545,3545,0,0
17/03/2016 11:32,2015,1,WESTERN EUROPE-EU,FRANCE,2,LEEDS BRADFORD,LIMOGES,24624,24624,0,17764,17764,0,38.61742851
17/03/2016 11:32,2015,1,WESTERN EUROPE-EU,FRANCE,2,LEEDS BRADFORD,LYON,465,0,465,295,0,295,57.62711864
17/03/2016 11:32,2015,1,WESTERN EUROPE-EU,FRANCE,2,LEEDS BRADFORD,MONTPELLIER,11635,11635,0,16917,16917,0,-31.22303009
17/03/2016 11:32,2015,1,WESTERN EUROPE-EU,FRANCE,2,LEEDS BRADFORD,NICE,17713,17713,0,19628,19628,0,-9.756470348
17/03/2016 11:32,2015,1,WESTERN EUROPE-EU,FRANCE,2,LEEDS BRADFORD,PARIS (CHARLES DE GAULLE),49110,49110,0,61286,61045,241,-19.86750645
17/03/2016 11:32,2015,1,WESTERN EUROPE-EU,FRANCE,2,LEEDS BRADFORD,PARIS (LE BOURGET),12,0,12,0,0,0,0
17/03/2016 11:32,2015,1,WESTERN EUROPE-EU,FRANCE,2,LEEDS BRADFORD,PERPIGNAN,912,0,912,508,0,508,79.52755906
17/03/2016 11:32,2015,1,WESTERN EUROPE-EU,FRANCE,2,LEEDS BRADFORD,TARBES-LOURDES INTERNATIONAL,321,0,321,336,0,336,-4.464285714
17/03/2016 11:32,2015,1,WESTERN EUROPE-EU,FRANCE,2,LEEDS BRADFORD,TOULOUSE (BLAGNAC),0,0,0,3630,3630,0,0
17/03/2016 11:32,2015,1,WESTERN EUROPE-EU,FRANCE,2,LIVERPOOL (JOHN LENNON),BERGERAC,22762,22762,0,20492,20492,0,11.07749366
17/03/2016 11:32,2015,1,WESTERN EUROPE-EU,FRANCE,2,LIVERPOOL (JOHN LENNON),BORDEAUX,15710,14980,730,13423,13423,0,17.03791999
17/03/2016 11:32,2015,1,WESTERN EUROPE-EU,FRANCE,2,LIVERPOOL (JOHN LENNON),CARCASSONNE,37082,37082,0,33457,33457,0,10.83480288
17/03/2016 11:32,2015,1,WESTERN EUROPE-EU,FRANCE,2,LIVERPOOL (JOHN LENNON),GRENOBLE,3547,3547,0,3888,3888,0,-8.770576132
17/03/2016 11:32,2015,1,WESTERN EUROPE-EU,FRANCE,2,LIVERPOOL (JOHN LENNON),LILLE,0,0,0,793,0,793,0
17/03/2016 11:32,2015,1,WESTERN EUROPE-EU,FRANCE,2,LIVERPOOL (JOHN LENNON),LIMOGES,47380,47380,0,44467,44467,0,6.550925405
17/03/2016 11:32,2015,1,WESTERN EUROPE-EU,FRANCE,2,LIVERPOOL (JOHN LENNON),NANTES,5568,5568,0,4700,4700,0,18.46808511
17/03/2016 11:32,2015,1,WESTERN EUROPE-EU,FRANCE,2,LIVERPOOL (JOHN LENNON),NICE,86440,86440,0,88757,88757,0,-2.610498327
17/03/2016 11:32,2015,1,WESTERN EUROPE-EU,FRANCE,2,LIVERPOOL (JOHN LENNON),NIMES,11686,11686,0,15380,15380,0,-24.01820546
17/03/2016 11:32,2015,1,WESTERN EUROPE-EU,FRANCE,2,LIVERPOOL (JOHN LENNON),PARIS (CHARLES DE GAULLE),88943,88818,125,89484,89371,113,-0.604577355
17/03/2016 11:32,2015,1,WESTERN EUROPE-EU,FRANCE,2,LIVERPOOL (JOHN LENNON),PERPIGNAN,273,0,273,178,0,178,53.37078652
17/03/2016 11:32,2015,1,WESTERN EUROPE-EU,FRANCE,2,LIVERPOOL (JOHN LENNON),TARBES-LOURDES INTERNATIONAL,1479,0,1479,960,0,960,54.0625
17/03/2016 11:32,2015,1,WESTERN EUROPE-EU,FRANCE,2,LYDD,CHAMBERY,24,0,24,9,0,9,166.6666667
17/03/2016 11:32,2015,1,WESTERN EUROPE-EU,FRANCE,2,MANCHESTER,BASTIA,3893,3893,0,4352,4352,0,-10.546875
17/03/2016 11:32,2015,1,WESTERN EUROPE-EU,FRANCE,2,MANCHESTER,BEAUVAIS,30858,30858,0,28487,28487,0,8.323094745
17/03/2016 11:32,2015,1,WESTERN EUROPE-EU,FRANCE,2,MANCHESTER,BERGERAC,1341,1341,0,6964,6964,0,-80.74382539
17/03/2016 11:32,2015,1,WESTERN EUROPE-EU,FRANCE,2,MANCHESTER,BEZIERS,22566,22566,0,20499,20499,0,10.0834187
17/03/2016 11:32,2015,1,WESTERN EUROPE-EU,FRANCE,2,MANCHESTER,CALVI,2764,0,2764,2341,0,2341,18.0692012
17/03/2016 11:32,2015,1,WESTERN EUROPE-EU,FRANCE,2,MANCHESTER,CHAMBERY,26725,15198,11527,26484,14678,11806,0.909983386
17/03/2016 11:32,2015,1,WESTERN EUROPE-EU,FRANCE,2,MANCHESTER,CLERMONT FERRAND,80,0,80,0,0,0,0
17/03/2016 11:32,2015,1,WESTERN EUROPE-EU,FRANCE,2,MANCHESTER,FIGARI,0,0,0,857,0,857,0
17/03/2016 11:32,2015,1,WESTERN EUROPE-EU,FRANCE,2,MANCHESTER,GRENOBLE,39933,15381,24552,37492,10178,27314,6.510722287
17/03/2016 11:32,2015,1,WESTERN EUROPE-EU,FRANCE,2,MANCHESTER,LA ROCHELLE,3249,3249,0,3040,3040,0,6.875
17/03/2016 11:32,2015,1,WESTERN EUROPE-EU,FRANCE,2,MANCHESTER,LILLE,0,0,0,433,0,433,0
17/03/2016 11:32,2015,1,WESTERN EUROPE-EU,FRANCE,2,MANCHESTER,LYON,13745,8175,5570,10898,5500,5398,26.12405946
17/03/2016 11:32,2015,1,WESTERN EUROPE-EU,FRANCE,2,MANCHESTER,MARSEILLE,14731,14731,0,0,0,0,0
17/03/2016 11:32,2015,1,WESTERN EUROPE-EU,FRANCE,2,MANCHESTER,NANTES,17772,17692,80,16436,16436,0,8.128498418
17/03/2016 11:32,2015,1,WESTERN EUROPE-EU,FRANCE,2,MANCHESTER,NICE,40105,39602,503,37299,36174,1125,7.522989892
17/03/2016 11:32,2015,1,WESTERN EUROPE-EU,FRANCE,2,MANCHESTER,PARIS (CHARLES DE GAULLE),477743,477306,437,506018,506018,0,-5.58774589
17/03/2016 11:32,2015,1,WESTERN EUROPE-EU,FRANCE,2,MANCHESTER,PAU,80,0,80,0,0,0,0
17/03/2016 11:32,2015,1,WESTERN EUROPE-EU,FRANCE,2,MANCHESTER,PERPIGNAN,979,0,979,467,0,467,109.6359743
17/03/2016 11:32,2015,1,WESTERN EUROPE-EU,FRANCE,2,MANCHESTER,RENNES,2258,2258,0,2214,2214,0,1.987353207
17/03/2016 11:32,2015,1,WESTERN EUROPE-EU,FRANCE,2,MANCHESTER,TARBES-LOURDES INTERNATIONAL,3105,0,3105,3586,0,3586,-13.41327384
17/03/2016 11:32,2015,1,WESTERN EUROPE-EU,FRANCE,2,MANCHESTER,TOULOUSE (BLAGNAC),16981,11478,5503,24952,19225,5727,-31.94533504
17/03/2016 11:32,2015,1,WESTERN EUROPE-EU,FRANCE,2,NEWCASTLE,BIARRITZ,0,0,0,76,0,76,0
17/03/2016 11:32,2015,1,WESTERN EUROPE-EU,FRANCE,2,NEWCASTLE,BRIVE-LA-GAILLARDE,73,0,73,45,0,45,62.22222222
17/03/2016 11:32,2015,1,WESTERN EUROPE-EU,FRANCE,2,NEWCASTLE,CHAMBERY,4294,4294,0,4290,4290,0,0.093240093
17/03/2016 11:32,2015,1,WESTERN EUROPE-EU,FRANCE,2,NEWCASTLE,DEAUVILLE,0,0,0,22,0,22,0
17/03/2016 11:32,2015,1,WESTERN EUROPE-EU,FRANCE,2,NEWCASTLE,NICE,21112,21102,10,20076,20076,0,5.160390516
17/03/2016 11:32,2015,1,WESTERN EUROPE-EU,FRANCE,2,NEWCASTLE,PARIS (CHARLES DE GAULLE),153870,153815,55,150709,150517,192,2.09741953
17/03/2016 11:32,2015,1,WESTERN EUROPE-EU,FRANCE,2,NEWCASTLE,PARIS (ORLY),0,0,0,33,0,33,0
17/03/2016 11:32,2015,1,WESTERN EUROPE-EU,FRANCE,2,NEWCASTLE,PERPIGNAN,71,0,71,0,0,0,0
17/03/2016 11:32,2015,1,WESTERN EUROPE-EU,FRANCE,2,NEWCASTLE,TARBES-LOURDES INTERNATIONAL,860,0,860,870,0,870,-1.149425287
17/03/2016 11:32,2015,1,WESTERN EUROPE-EU,FRANCE,2,NEWQUAY,TOULON / HYERES,97,0,97,0,0,0,0
17/03/2016 11:32,2015,1,WESTERN EUROPE-EU,FRANCE,2,NORWICH,NANTES,60,0,60,0,0,0,0
17/03/2016 11:32,2015,1,WESTERN EUROPE-EU,FRANCE,2,PRESTWICK,CARCASSONNE,0,0,0,17756,17756,0,0
17/03/2016 11:32,2015,1,WESTERN EUROPE-EU,FRANCE,2,PRESTWICK,PARIS (LE BOURGET),0,0,0,73,0,73,0
17/03/2016 11:32,2015,1,WESTERN EUROPE-EU,FRANCE,2,PRESTWICK,TARBES-LOURDES INTERNATIONAL,221,0,221,0,0,0,0
17/03/2016 11:32,2015,1,WESTERN EUROPE-EU,FRANCE,2,SOUTHAMPTON,AVIGNON,4149,4149,0,4345,4287,58,-4.510932106
17/03/2016 11:32,2015,1,WESTERN EUROPE-EU,FRANCE,2,SOUTHAMPTON,BASTIA,5089,5089,0,0,0,0,0
17/03/2016 11:32,2015,1,WESTERN EUROPE-EU,FRANCE,2,SOUTHAMPTON,BERGERAC,33283,33283,0,34272,34272,0,-2.885737628
17/03/2016 11:32,2015,1,WESTERN EUROPE-EU,FRANCE,2,SOUTHAMPTON,BORDEAUX,1962,1962,0,2198,2198,0,-10.73703367
17/03/2016 11:32,2015,1,WESTERN EUROPE-EU,FRANCE,2,SOUTHAMPTON,BREST,3308,3308,0,10980,10980,0,-69.87249545
17/03/2016 11:32,2015,1,WESTERN EUROPE-EU,FRANCE,2,SOUTHAMPTON,CHAMBERY,6604,5908,696,8266,4651,3615,-20.1064602
17/03/2016 11:32,2015,1,WESTERN EUROPE-EU,FRANCE,2,SOUTHAMPTON,CLERMONT FERRAND,0,0,0,5446,5446,0,0
17/03/2016 11:32,2015,1,WESTERN EUROPE-EU,FRANCE,2,SOUTHAMPTON,GRENOBLE,1637,1637,0,838,838,0,95.34606205
17/03/2016 11:32,2015,1,WESTERN EUROPE-EU,FRANCE,2,SOUTHAMPTON,LA ROCHELLE,14213,14213,0,13142,13142,0,8.149444529
17/03/2016 11:32,2015,1,WESTERN EUROPE-EU,FRANCE,2,SOUTHAMPTON,LIMOGES,19308,19308,0,19745,19745,0,-2.213218536
17/03/2016 11:32,2015,1,WESTERN EUROPE-EU,FRANCE,2,SOUTHAMPTON,NANTES,20517,20517,0,29708,29708,0,-30.93779453
17/03/2016 11:32,2015,1,WESTERN EUROPE-EU,FRANCE,2,SOUTHAMPTON,NICE,0,0,0,12810,12810,0,0
17/03/2016 11:32,2015,1,WESTERN EUROPE-EU,FRANCE,2,SOUTHAMPTON,PARIS (ORLY),70028,70028,0,77539,77539,0,-9.686738287
17/03/2016 11:32,2015,1,WESTERN EUROPE-EU,FRANCE,2,SOUTHAMPTON,PERPIGNAN,2395,2395,0,2267,2267,0,5.646228496
17/03/2016 11:32,2015,1,WESTERN EUROPE-EU,FRANCE,2,SOUTHAMPTON,RENNES,18073,18073,0,22195,22195,0,-18.57175039
17/03/2016 11:32,2015,1,WESTERN EUROPE-EU,FRANCE,2,SOUTHAMPTON,TARBES-LOURDES INTERNATIONAL,813,0,813,235,0,235,245.9574468
17/03/2016 11:32,2015,1,WESTERN EUROPE-EU,FRANCE,2,WICK JOHN O GROATS,PARIS (CHARLES DE GAULLE),120,0,120,0,0,0,0
17/03/2016 11:32,2015,1,WESTERN EUROPE-EU,GERMANY,1,GATWICK,BERLIN (SCHONEFELD),523645,522208,1437,413136,413040,96,26.74881879
17/03/2016 11:32,2015,1,WESTERN EUROPE-EU,GERMANY,1,GATWICK,BERLIN (TEGEL),213,0,213,893,0,893,-76.14781635
17/03/2016 11:32,2015,1,WESTERN EUROPE-EU,GERMANY,1,GATWICK,COLOGNE BONN,103592,103570,22,149622,149622,0,-30.76419243
17/03/2016 11:32,2015,1,WESTERN EUROPE-EU,GERMANY,1,GATWICK,DUSSELDORF,93910,93910,0,136667,136555,112,-31.28553345
17/03/2016 11:32,2015,1,WESTERN EUROPE-EU,GERMANY,1,GATWICK,ERFURT,9308,9308,0,12341,12341,0,-24.57661454
17/03/2016 11:32,2015,1,WESTERN EUROPE-EU,GERMANY,1,GATWICK,FRIEDRICHSHAFEN,19294,12270,7024,19050,9184,9866,1.280839895
17/03/2016 11:32,2015,1,WESTERN EUROPE-EU,GERMANY,1,GATWICK,HAMBURG,174641,174641,0,171859,171361,498,1.618768874
17/03/2016 11:32,2015,1,WESTERN EUROPE-EU,GERMANY,1,GATWICK,LEIPZIG,133,0,133,270,0,270,-50.74074074
17/03/2016 11:32,2015,1,WESTERN EUROPE-EU,GERMANY,1,GATWICK,MUNICH,231744,231532,212,225727,225008,719,2.665609342
17/03/2016 11:32,2015,1,WESTERN EUROPE-EU,GERMANY,1,GATWICK,MUNSTER-OSNABRUCK,0,0,0,108,0,108,0
17/03/2016 11:32,2015,1,WESTERN EUROPE-EU,GERMANY,1,GATWICK,STUTTGART,103540,103540,0,0,0,0,0
17/03/2016 11:32,2015,1,WESTERN EUROPE-EU,GERMANY,1,HEATHROW,BERLIN (TEGEL),822496,822496,0,774947,774947,0,6.135774447
17/03/2016 11:32,2015,1,WESTERN EUROPE-EU,GERMANY,1,HEATHROW,COLOGNE BONN,168657,168657,0,163731,163731,0,3.008593364
17/03/2016 11:32,2015,1,WESTERN EUROPE-EU,GERMANY,1,HEATHROW,DUSSELDORF,663142,663142,0,623942,623942,0,6.282635245
17/03/2016 11:32,2015,1,WESTERN EUROPE-EU,GERMANY,1,HEATHROW,FRANKFURT MAIN,1530986,1530986,0,1506705,1506705,0,1.611529795
17/03/2016 11:32,2015,1,WESTERN EUROPE-EU,GERMANY,1,HEATHROW,FRIEDRICHSHAFEN,797,0,797,4088,0,4088,-80.50391389
17/03/2016 11:32,2015,1,WESTERN EUROPE-EU,GERMANY,1,HEATHROW,HAMBURG,577653,577653,0,549178,549178,0,5.185021978
17/03/2016 11:32,2015,1,WESTERN EUROPE-EU,GERMANY,1,HEATHROW,HANOVER,199781,199781,0,194425,194425,0,2.754789765
17/03/2016 11:32,2015,1,WESTERN EUROPE-EU,GERMANY,1,HEATHROW,MUNICH,1230618,1230618,0,1178614,1178614,0,4.412301228
17/03/2016 11:32,2015,1,WESTERN EUROPE-EU,GERMANY,1,HEATHROW,STUTTGART,333656,333656,0,343075,343075,0,-2.74546382
17/03/2016 11:32,2015,1,WESTERN EUROPE-EU,GERMANY,1,LONDON CITY,DRESDEN,14097,14097,0,20918,20918,0,-32.60827995
17/03/2016 11:32,2015,1,WESTERN EUROPE-EU,GERMANY,1,LONDON CITY,DUSSELDORF,59830,59830,0,65963,65963,0,-9.297636554
17/03/2016 11:32,2015,1,WESTERN EUROPE-EU,GERMANY,1,LONDON CITY,FRANKFURT MAIN,240973,240973,0,232568,232568,0,3.613996767
17/03/2016 11:32,2015,1,WESTERN EUROPE-EU,GERMANY,1,LONDON CITY,HAMBURG,12455,12455,0,2289,2289,0,444.1240716
17/03/2016 11:32,2015,1,WESTERN EUROPE-EU,GERMANY,1,LONDON CITY,MUNSTER-OSNABRUCK,0,0,0,1522,1522,0,0
17/03/2016 11:32,2015,1,WESTERN EUROPE-EU,GERMANY,1,LONDON CITY,NUREMBERG,0,0,0,10812,10812,0,0
17/03/2016 11:32,2015,1,WESTERN EUROPE-EU,GERMANY,1,LONDON CITY,PADERBORN,0,0,0,1701,1701,0,0
17/03/2016 11:32,2015,1,WESTERN EUROPE-EU,GERMANY,1,LUTON,BERLIN (SCHONEFELD),182834,182458,376,187203,187186,17,-2.33383012
17/03/2016 11:32,2015,1,WESTERN EUROPE-EU,GERMANY,1,LUTON,BERLIN (TEGEL),149,0,149,300,0,300,-50.33333333
17/03/2016 11:32,2015,1,WESTERN EUROPE-EU,GERMANY,1,LUTON,COLOGNE BONN,447,0,447,288,0,288,55.20833333
17/03/2016 11:32,2015,1,WESTERN EUROPE-EU,GERMANY,1,LUTON,DORTMUND,108709,108709,0,147264,146892,372,-26.18087245
17/03/2016 11:32,2015,1,WESTERN EUROPE-EU,GERMANY,1,LUTON,DUSSELDORF,0,0,0,239,0,239,0
17/03/2016 11:32,2015,1,WESTERN EUROPE-EU,GERMANY,1,LUTON,FRANKFURT MAIN,42,0,42,156,149,7,-73.07692308
17/03/2016 11:32,2015,1,WESTERN EUROPE-EU,GERMANY,1,LUTON,FRIEDRICHSHAFEN,157,0,157,0,0,0,0
17/03/2016 11:32,2015,1,WESTERN EUROPE-EU,GERMANY,1,LUTON,HAMBURG,84039,84003,36,81944,81944,0,2.556624036
17/03/2016 11:32,2015,1,WESTERN EUROPE-EU,GERMANY,1,LUTON,HANOVER,452,0,452,0,0,0,0
17/03/2016 11:32,2015,1,WESTERN EUROPE-EU,GERMANY,1,LUTON,INGOLSTADT-MANCHING,41,0,41,0,0,0,0
17/03/2016 11:32,2015,1,WESTERN EUROPE-EU,GERMANY,1,LUTON,KARLSRUHE/BADEN BADEN,3,0,3,20,0,20,-85
17/03/2016 11:32,2015,1,WESTERN EUROPE-EU,GERMANY,1,LUTON,LEIPZIG,0,0,0,45,0,45,0
17/03/2016 11:32,2015,1,WESTERN EUROPE-EU,GERMANY,1,LUTON,MAGDEBURG COCHSTEDT,11,0,11,0,0,0,0
17/03/2016 11:32,2015,1,WESTERN EUROPE-EU,GERMANY,1,LUTON,MUNICH,61626,61162,464,14096,13395,701,337.1878547
17/03/2016 11:32,2015,1,WESTERN EUROPE-EU,GERMANY,1,LUTON,MUNSTER-OSNABRUCK,90,0,90,106,0,106,-15.09433962
17/03/2016 11:32,2015,1,WESTERN EUROPE-EU,GERMANY,1,LUTON,NUREMBERG,24,0,24,22,0,22,9.090909091
17/03/2016 11:32,2015,1,WESTERN EUROPE-EU,GERMANY,1,LUTON,PADERBORN,102,0,102,34,0,34,200
17/03/2016 11:32,2015,1,WESTERN EUROPE-EU,GERMANY,1,SOUTHEND,BERLIN (SCHONEFELD),54904,54904,0,71263,71263,0,-22.95581157
17/03/2016 11:32,2015,1,WESTERN EUROPE-EU,GERMANY,1,SOUTHEND,MUNSTER-OSNABRUCK,13761,13761,0,11136,11136,0,23.57219828
17/03/2016 11:32,2015,1,WESTERN EUROPE-EU,GERMANY,1,STANSTED,BERLIN (SCHONEFELD),331488,331488,0,239395,239298,97,38.46905742
17/03/2016 11:32,2015,1,WESTERN EUROPE-EU,GERMANY,1,STANSTED,BERLIN (TEGEL),94,0,94,0,0,0,0
17/03/2016 11:32,2015,1,WESTERN EUROPE-EU,GERMANY,1,STANSTED,BREMEN,195930,195854,76,220823,220823,0,-11.27282937
17/03/2016 11:32,2015,1,WESTERN EUROPE-EU,GERMANY,1,STANSTED,COLOGNE BONN,389788,389788,0,168512,168039,473,131.3117167
17/03/2016 11:32,2015,1,WESTERN EUROPE-EU,GERMANY,1,STANSTED,DORTMUND,109469,109469,0,89743,89743,0,21.98054444
17/03/2016 11:32,2015,1,WESTERN EUROPE-EU,GERMANY,1,STANSTED,DUSSELDORF,35518,35239,279,97732,97692,40,-63.65775795
17/03/2016 11:32,2015,1,WESTERN EUROPE-EU,GERMANY,1,STANSTED,HAHN,237194,237194,0,234889,234889,0,0.981314578
17/03/2016 11:32,2015,1,WESTERN EUROPE-EU,GERMANY,1,STANSTED,HAMBURG,97,0,97,0,0,0,0
17/03/2016 11:32,2015,1,WESTERN EUROPE-EU,GERMANY,1,STANSTED,HANOVER,77445,77445,0,111331,111331,0,-30.43716485
17/03/2016 11:32,2015,1,WESTERN EUROPE-EU,GERMANY,1,STANSTED,KARLSRUHE/BADEN BADEN,105207,105207,0,100760,100760,0,4.413457721
17/03/2016 11:32,2015,1,WESTERN EUROPE-EU,GERMANY,1,STANSTED,LEIPZIG,59259,59259,0,57227,57227,0,3.550771489
17/03/2016 11:32,2015,1,WESTERN EUROPE-EU,GERMANY,1,STANSTED,MEMMINGEN ALLGAU,103681,103681,0,97305,97305,0,6.552592364
17/03/2016 11:32,2015,1,WESTERN EUROPE-EU,GERMANY,1,STANSTED,MUNICH,107084,105417,1667,108583,107644,939,-1.380510761
17/03/2016 11:32,2015,1,WESTERN EUROPE-EU,GERMANY,1,STANSTED,MUNSTER-OSNABRUCK,89,0,89,255,0,255,-65.09803922
17/03/2016 11:32,2015,1,WESTERN EUROPE-EU,GERMANY,1,STANSTED,NIEDERRHEIN,125665,125665,0,110407,110407,0,13.81977592
17/03/2016 11:32,2015,1,WESTERN EUROPE-EU,GERMANY,1,STANSTED,NUREMBERG,121858,121858,0,109153,109153,0,11.63962511
17/03/2016 11:32,2015,1,WESTERN EUROPE-EU,GERMANY,1,STANSTED,STUTTGART,69423,69382,41,65985,65985,0,5.210275063
17/03/2016 11:32,2015,1,WESTERN EUROPE-EU,GERMANY,2,ABERDEEN,DRESDEN,41,0,41,0,0,0,0
17/03/2016 11:32,2015,1,WESTERN EUROPE-EU,GERMANY,2,ABERDEEN,DUSSELDORF,95,0,95,0,0,0,0
17/03/2016 11:32,2015,1,WESTERN EUROPE-EU,GERMANY,2,ABERDEEN,FRANKFURT MAIN,151684,151684,0,164240,164240,0,-7.644909888
17/03/2016 11:32,2015,1,WESTERN EUROPE-EU,GERMANY,2,ABERDEEN,STUTTGART,1,0,1,0,0,0,0
17/03/2016 11:32,2015,1,WESTERN EUROPE-EU,GERMANY,2,BELFAST INTERNATIONAL,HAMBURG,272,0,272,80,0,80,240
17/03/2016 11:32,2015,1,WESTERN EUROPE-EU,GERMANY,2,BELFAST INTERNATIONAL,MUNICH,0,0,0,223,223,0,0
17/03/2016 11:32,2015,1,WESTERN EUROPE-EU,GERMANY,2,BELFAST INTERNATIONAL,PADERBORN,0,0,0,17,0,17,0
17/03/2016 11:32,2015,1,WESTERN EUROPE-EU,GERMANY,2,BIRMINGHAM,BERLIN (TEGEL),49077,49077,0,32917,32917,0,49.09317374
17/03/2016 11:32,2015,1,WESTERN EUROPE-EU,GERMANY,2,BIRMINGHAM,BRAUNSCHWEIG,11,0,11,0,0,0,0
17/03/2016 11:32,2015,1,WESTERN EUROPE-EU,GERMANY,2,BIRMINGHAM,BREMEN,0,0,0,86,0,86,0
17/03/2016 11:32,2015,1,WESTERN EUROPE-EU,GERMANY,2,BIRMINGHAM,COLOGNE BONN,7250,6863,387,26086,25488,598,-72.20731427
17/03/2016 11:32,2015,1,WESTERN EUROPE-EU,GERMANY,2,BIRMINGHAM,DUSSELDORF,219051,218964,87,198477,198347,130,10.36593661
17/03/2016 11:32,2015,1,WESTERN EUROPE-EU,GERMANY,2,BIRMINGHAM,FRANKFURT MAIN,314685,314509,176,302968,302968,0,3.867405138
17/03/2016 11:32,2015,1,WESTERN EUROPE-EU,GERMANY,2,BIRMINGHAM,HAMBURG,38017,38017,0,38238,38238,0,-0.577959098
17/03/2016 11:32,2015,1,WESTERN EUROPE-EU,GERMANY,2,BIRMINGHAM,HANOVER,56850,47182,9668,67488,61546,5942,-15.76280228
17/03/2016 11:32,2015,1,WESTERN EUROPE-EU,GERMANY,2,BIRMINGHAM,LEIPZIG,124,0,124,0,0,0,0
17/03/2016 11:32,2015,1,WESTERN EUROPE-EU,GERMANY,2,BIRMINGHAM,MEMMINGEN ALLGAU,86,0,86,0,0,0,0
17/03/2016 11:32,2015,1,WESTERN EUROPE-EU,GERMANY,2,BIRMINGHAM,MUNICH,185185,183658,1527,176941,176382,559,4.659180179
17/03/2016 11:32,2015,1,WESTERN EUROPE-EU,GERMANY,2,BIRMINGHAM,MUNSTER-OSNABRUCK,0,0,0,195,0,195,0
17/03/2016 11:32,2015,1,WESTERN EUROPE-EU,GERMANY,2,BIRMINGHAM,NUREMBERG,49,0,49,0,0,0,0
17/03/2016 11:32,2015,1,WESTERN EUROPE-EU,GERMANY,2,BIRMINGHAM,PADERBORN,10849,0,10849,3300,3300,0,228.7575758
17/03/2016 11:32,2015,1,WESTERN EUROPE-EU,GERMANY,2,BIRMINGHAM,STUTTGART,70567,70480,87,65383,65383,0,7.928666473
17/03/2016 11:32,2015,1,WESTERN EUROPE-EU,GERMANY,2,BOURNEMOUTH,COLOGNE BONN,0,0,0,96,0,96,0
17/03/2016 11:32,2015,1,WESTERN EUROPE-EU,GERMANY,2,BOURNEMOUTH,LUBECK,41,0,41,0,0,0,0
17/03/2016 11:32,2015,1,WESTERN EUROPE-EU,GERMANY,2,BRISTOL,BERLIN (SCHONEFELD),83224,83224,0,73863,73863,0,12.67346303
17/03/2016 11:32,2015,1,WESTERN EUROPE-EU,GERMANY,2,BRISTOL,BREMEN,0,0,0,94,0,94,0
17/03/2016 11:32,2015,1,WESTERN EUROPE-EU,GERMANY,2,BRISTOL,COLOGNE BONN,151,0,151,0,0,0,0
17/03/2016 11:32,2015,1,WESTERN EUROPE-EU,GERMANY,2,BRISTOL,DUSSELDORF,8355,8355,0,96,0,96,8603.125
17/03/2016 11:32,2015,1,WESTERN EUROPE-EU,GERMANY,2,BRISTOL,FRANKFURT MAIN,44026,44026,0,29448,29448,0,49.50421081
17/03/2016 11:32,2015,1,WESTERN EUROPE-EU,GERMANY,2,BRISTOL,HAMBURG,16128,16128,0,21552,21552,0,-25.16703786
17/03/2016 11:32,2015,1,WESTERN EUROPE-EU,GERMANY,2,BRISTOL,MUNICH,30567,29938,629,18298,18018,280,67.05104383
17/03/2016 11:32,2015,1,WESTERN EUROPE-EU,GERMANY,2,CARDIFF WALES,BRAUNSCHWEIG,0,0,0,41,0,41,0
17/03/2016 11:32,2015,1,WESTERN EUROPE-EU,GERMANY,2,CARDIFF WALES,DORTMUND,0,0,0,146,0,146,0
17/03/2016 11:32,2015,1,WESTERN EUROPE-EU,GERMANY,2,CARDIFF WALES,DUSSELDORF,6123,6123,0,2459,2459,0,149.00366
17/03/2016 11:32,2015,1,WESTERN EUROPE-EU,GERMANY,2,CARDIFF WALES,HANOVER,46,0,46,0,0,0,0
17/03/2016 11:32,2015,1,WESTERN EUROPE-EU,GERMANY,2,CARDIFF WALES,LAHR,93,0,93,0,0,0,0
17/03/2016 11:32,2015,1,WESTERN EUROPE-EU,GERMANY,2,CARDIFF WALES,MUNICH,7531,7453,78,0,0,0,0
17/03/2016 11:32,2015,1,WESTERN EUROPE-EU,GERMANY,2,CARDIFF WALES,STUTTGART,0,0,0,40,0,40,0
17/03/2016 11:32,2015,1,WESTERN EUROPE-EU,GERMANY,2,DONCASTER SHEFFIELD,HAHN,66,0,66,0,0,0,0
17/03/2016 11:32,2015,1,WESTERN EUROPE-EU,GERMANY,2,DURHAM TEES VALLEY,COLOGNE BONN,8,0,8,0,0,0,0
17/03/2016 11:32,2015,1,WESTERN EUROPE-EU,GERMANY,2,DURHAM TEES VALLEY,DUSSELDORF,40,0,40,0,0,0,0
17/03/2016 11:32,2015,1,WESTERN EUROPE-EU,GERMANY,2,DURHAM TEES VALLEY,GEILENKIRCHEN,0,0,0,20,0,20,0
17/03/2016 11:32,2015,1,WESTERN EUROPE-EU,GERMANY,2,DURHAM TEES VALLEY,PADERBORN,48,0,48,0,0,0,0
17/03/2016 11:32,2015,1,WESTERN EUROPE-EU,GERMANY,2,EAST MIDLANDS INTERNATIONAL,BERLIN (SCHONEFELD),51043,51043,0,37433,37433,0,36.35829348
17/03/2016 11:32,2015,1,WESTERN EUROPE-EU,GERMANY,2,EAST MIDLANDS INTERNATIONAL,GEILENKIRCHEN,38,0,38,0,0,0,0
17/03/2016 11:32,2015,1,WESTERN EUROPE-EU,GERMANY,2,EAST MIDLANDS INTERNATIONAL,HAMBURG,0,0,0,43,0,43,0
17/03/2016 11:32,2015,1,WESTERN EUROPE-EU,GERMANY,2,EDINBURGH,BERLIN (SCHONEFELD),51636,51636,0,44740,44740,0,15.41350022
17/03/2016 11:32,2015,1,WESTERN EUROPE-EU,GERMANY,2,EDINBURGH,BREMEN,29356,29356,0,32078,31811,267,-8.485566432
17/03/2016 11:32,2015,1,WESTERN EUROPE-EU,GERMANY,2,EDINBURGH,COLOGNE BONN,50874,50874,0,50612,50478,134,0.517663795
17/03/2016 11:32,2015,1,WESTERN EUROPE-EU,GERMANY,2,EDINBURGH,DUSSELDORF,0,0,0,176,0,176,0
17/03/2016 11:32,2015,1,WESTERN EUROPE-EU,GERMANY,2,EDINBURGH,ERFURT,0,0,0,278,0,278,0
17/03/2016 11:32,2015,1,WESTERN EUROPE-EU,GERMANY,2,EDINBURGH,FRANKFURT MAIN,192077,192077,0,197221,196941,280,-2.608241516
17/03/2016 11:32,2015,1,WESTERN EUROPE-EU,GERMANY,2,EDINBURGH,FRIEDRICHSHAFEN,0,0,0,216,0,216,0
17/03/2016 11:32,2015,1,WESTERN EUROPE-EU,GERMANY,2,EDINBURGH,HAHN,36232,36232,0,29060,28877,183,24.67997247
17/03/2016 11:32,2015,1,WESTERN EUROPE-EU,GERMANY,2,EDINBURGH,HAMBURG,59204,59204,0,56600,56600,0,4.600706714
17/03/2016 11:32,2015,1,WESTERN EUROPE-EU,GERMANY,2,EDINBURGH,LUBECK,0,0,0,71,0,71,0
17/03/2016 11:32,2015,1,WESTERN EUROPE-EU,GERMANY,2,EDINBURGH,MUNICH,95437,95147,290,89268,89197,71,6.910651073
17/03/2016 11:32,2015,1,WESTERN EUROPE-EU,GERMANY,2,EDINBURGH,MUNSTER-OSNABRUCK,0,0,0,100,0,100,0
17/03/2016 11:32,2015,1,WESTERN EUROPE-EU,GERMANY,2,EDINBURGH,NIEDERRHEIN,50930,50930,0,46862,46862,0,8.680807477
17/03/2016 11:32,2015,1,WESTERN EUROPE-EU,GERMANY,2,EDINBURGH,PADERBORN,0,0,0,232,0,232,0
17/03/2016 11:32,2015,1,WESTERN EUROPE-EU,GERMANY,2,EDINBURGH,STUTTGART,6945,6945,0,264,0,264,2530.681818
17/03/2016 11:32,2015,1,WESTERN EUROPE-EU,GERMANY,2,EXETER,DUSSELDORF,0,0,0,1974,1974,0,0
17/03/2016 11:32,2015,1,WESTERN EUROPE-EU,GERMANY,2,EXETER,FRIEDRICHSHAFEN,138,0,138,0,0,0,0
17/03/2016 11:32,2015,1,WESTERN EUROPE-EU,GERMANY,2,GLASGOW,BERLIN (SCHONEFELD),88061,88061,0,71865,71865,0,22.53670076
17/03/2016 11:32,2015,1,WESTERN EUROPE-EU,GERMANY,2,GLASGOW,BRAUNSCHWEIG,34,0,34,40,0,40,-15
17/03/2016 11:32,2015,1,WESTERN EUROPE-EU,GERMANY,2,GLASGOW,BUCHEL,33,0,33,0,0,0,0
17/03/2016 11:32,2015,1,WESTERN EUROPE-EU,GERMANY,2,GLASGOW,COLOGNE BONN,168,0,168,0,0,0,0
17/03/2016 11:32,2015,1,WESTERN EUROPE-EU,GERMANY,2,GLASGOW,DORTMUND,0,0,0,108,0,108,0
17/03/2016 11:32,2015,1,WESTERN EUROPE-EU,GERMANY,2,GLASGOW,DRESDEN,0,0,0,76,0,76,0
17/03/2016 11:32,2015,1,WESTERN EUROPE-EU,GERMANY,2,GLASGOW,DUSSELDORF,34987,34987,0,39099,39097,2,-10.51689302
17/03/2016 11:32,2015,1,WESTERN EUROPE-EU,GERMANY,2,GLASGOW,FRANKFURT MAIN,476,158,318,0,0,0,0
17/03/2016 11:32,2015,1,WESTERN EUROPE-EU,GERMANY,2,GLASGOW,HAMBURG,0,0,0,66,0,66,0
17/03/2016 11:32,2015,1,WESTERN EUROPE-EU,GERMANY,2,GLASGOW,MEMMINGEN ALLGAU,35,0,35,0,0,0,0
17/03/2016 11:32,2015,1,WESTERN EUROPE-EU,GERMANY,2,GLASGOW,MUNICH,4320,4320,0,0,0,0,0
17/03/2016 11:32,2015,1,WESTERN EUROPE-EU,GERMANY,2,GLASGOW,MUNSTER-OSNABRUCK,0,0,0,108,0,108,0
17/03/2016 11:32,2015,1,WESTERN EUROPE-EU,GERMANY,2,GUERNSEY,DUSSELDORF,2463,2463,0,2118,2118,0,16.28895184
17/03/2016 11:32,2015,1,WESTERN EUROPE-EU,GERMANY,2,GUERNSEY,FRANKFURT MAIN,0,0,0,518,518,0,0
17/03/2016 11:32,2015,1,WESTERN EUROPE-EU,GERMANY,2,GUERNSEY,STUTTGART,1894,1894,0,200,200,0,847
17/03/2016 11:32,2015,1,WESTERN EUROPE-EU,GERMANY,2,HUMBERSIDE,BREMEN,0,0,0,36,0,36,0
17/03/2016 11:32,2015,1,WESTERN EUROPE-EU,GERMANY,2,HUMBERSIDE,FRIEDRICHSHAFEN,136,0,136,0,0,0,0
17/03/2016 11:32,2015,1,WESTERN EUROPE-EU,GERMANY,2,HUMBERSIDE,MUNSTER-OSNABRUCK,0,0,0,99,0,99,0
17/03/2016 11:32,2015,1,WESTERN EUROPE-EU,GERMANY,2,HUMBERSIDE,STUTTGART,0,0,0,78,0,78,0
17/03/2016 11:32,2015,1,WESTERN EUROPE-EU,GERMANY,2,ISLE OF MAN,BREMEN,280,0,280,0,0,0,0
17/03/2016 11:32,2015,1,WESTERN EUROPE-EU,GERMANY,2,ISLE OF MAN,FRIEDRICHSHAFEN,70,0,70,0,0,0,0
17/03/2016 11:32,2015,1,WESTERN EUROPE-EU,GERMANY,2,JERSEY,BERLIN (SCHONEFELD),0,0,0,21,0,21,0
17/03/2016 11:32,2015,1,WESTERN EUROPE-EU,GERMANY,2,JERSEY,BREMEN,288,0,288,292,0,292,-1.369863014
17/03/2016 11:32,2015,1,WESTERN EUROPE-EU,GERMANY,2,JERSEY,DORTMUND,0,0,0,197,0,197,0
17/03/2016 11:32,2015,1,WESTERN EUROPE-EU,GERMANY,2,JERSEY,DRESDEN,286,0,286,0,0,0,0
17/03/2016 11:32,2015,1,WESTERN EUROPE-EU,GERMANY,2,JERSEY,DUSSELDORF,6751,6751,0,7203,7203,0,-6.275163126
17/03/2016 11:32,2015,1,WESTERN EUROPE-EU,GERMANY,2,JERSEY,ERFURT,392,0,392,0,0,0,0
17/03/2016 11:32,2015,1,WESTERN EUROPE-EU,GERMANY,2,JERSEY,FRANKFURT MAIN,51,0,51,1488,1488,0,-96.57258065
17/03/2016 11:32,2015,1,WESTERN EUROPE-EU,GERMANY,2,JERSEY,FRIEDRICHSHAFEN,472,0,472,579,0,579,-18.48013817
17/03/2016 11:32,2015,1,WESTERN EUROPE-EU,GERMANY,2,JERSEY,HAHN,0,0,0,171,0,171,0
17/03/2016 11:32,2015,1,WESTERN EUROPE-EU,GERMANY,2,JERSEY,HANOVER,2537,2537,0,2514,2514,0,0.914876691
17/03/2016 11:32,2015,1,WESTERN EUROPE-EU,GERMANY,2,JERSEY,KARLSRUHE/BADEN BADEN,148,0,148,0,0,0,0
17/03/2016 11:32,2015,1,WESTERN EUROPE-EU,GERMANY,2,JERSEY,KASSEL,0,0,0,270,0,270,0
17/03/2016 11:32,2015,1,WESTERN EUROPE-EU,GERMANY,2,JERSEY,KOBLENZ,2684,868,1816,1762,1100,662,52.32690125
17/03/2016 11:32,2015,1,WESTERN EUROPE-EU,GERMANY,2,JERSEY,MUNICH,2551,2551,0,2783,2783,0,-8.336327704
17/03/2016 11:32,2015,1,WESTERN EUROPE-EU,GERMANY,2,JERSEY,PADERBORN,404,0,404,0,0,0,0
17/03/2016 11:32,2015,1,WESTERN EUROPE-EU,GERMANY,2,JERSEY,STUTTGART,2602,2380,222,1689,1387,302,54.05565423
17/03/2016 11:32,2015,1,WESTERN EUROPE-EU,GERMANY,2,LEEDS BRADFORD,BERLIN (SCHONEFELD),285,0,285,429,429,0,-33.56643357
17/03/2016 11:32,2015,1,WESTERN EUROPE-EU,GERMANY,2,LEEDS BRADFORD,COLOGNE BONN,261,261,0,0,0,0,0
17/03/2016 11:32,2015,1,WESTERN EUROPE-EU,GERMANY,2,LEEDS BRADFORD,DUSSELDORF,50447,50289,158,51710,51710,0,-2.442467608
17/03/2016 11:32,2015,1,WESTERN EUROPE-EU,GERMANY,2,LEEDS BRADFORD,FRIEDRICHSHAFEN,424,0,424,0,0,0,0
17/03/2016 11:32,2015,1,WESTERN EUROPE-EU,GERMANY,2,LEEDS BRADFORD,MUNICH,0,0,0,664,415,249,0
17/03/2016 11:32,2015,1,WESTERN EUROPE-EU,GERMANY,2,LEEDS BRADFORD,MUNSTER-OSNABRUCK,117,117,0,0,0,0,0
17/03/2016 11:32,2015,1,WESTERN EUROPE-EU,GERMANY,2,LIVERPOOL (JOHN LENNON),BERLIN (SCHONEFELD),75544,75544,0,76067,76067,0,-0.687551764
17/03/2016 11:32,2015,1,WESTERN EUROPE-EU,GERMANY,2,LIVERPOOL (JOHN LENNON),BRAUNSCHWEIG,0,0,0,435,0,435,0
17/03/2016 11:32,2015,1,WESTERN EUROPE-EU,GERMANY,2,LIVERPOOL (JOHN LENNON),DORTMUND,0,0,0,133,0,133,0
17/03/2016 11:32,2015,1,WESTERN EUROPE-EU,GERMANY,2,LIVERPOOL (JOHN LENNON),HANOVER,0,0,0,373,0,373,0
17/03/2016 11:32,2015,1,WESTERN EUROPE-EU,GERMANY,2,LIVERPOOL (JOHN LENNON),PADERBORN,0,0,0,110,0,110,0
17/03/2016 11:32,2015,1,WESTERN EUROPE-EU,GERMANY,2,LYDD,BREMEN,196,0,196,0,0,0,0
17/03/2016 11:32,2015,1,WESTERN EUROPE-EU,GERMANY,2,LYDD,HAMBURG,73,0,73,0,0,0,0
17/03/2016 11:32,2015,1,WESTERN EUROPE-EU,GERMANY,2,MANCHESTER,BERLIN (SCHONEFELD),96317,96317,0,87792,87792,0,9.710451977
17/03/2016 11:32,2015,1,WESTERN EUROPE-EU,GERMANY,2,MANCHESTER,BERLIN (TEGEL),0,0,0,346,0,346,0
17/03/2016 11:32,2015,1,WESTERN EUROPE-EU,GERMANY,2,MANCHESTER,BRAUNSCHWEIG,601,0,601,0,0,0,0
17/03/2016 11:32,2015,1,WESTERN EUROPE-EU,GERMANY,2,MANCHESTER,BREMEN,15366,15366,0,42113,42046,67,-63.51245459
17/03/2016 11:32,2015,1,WESTERN EUROPE-EU,GERMANY,2,MANCHESTER,COLOGNE BONN,55570,55084,486,50406,50406,0,10.24481213
17/03/2016 11:32,2015,1,WESTERN EUROPE-EU,GERMANY,2,MANCHESTER,DUSSELDORF,182794,181385,1409,170683,170683,0,7.09560999
17/03/2016 11:32,2015,1,WESTERN EUROPE-EU,GERMANY,2,MANCHESTER,FRANKFURT MAIN,390202,390017,185,375183,375183,0,4.003113147
17/03/2016 11:32,2015,1,WESTERN EUROPE-EU,GERMANY,2,MANCHESTER,FRIEDRICHSHAFEN,1978,1978,0,3755,3379,376,-47.32356858
17/03/2016 11:32,2015,1,WESTERN EUROPE-EU,GERMANY,2,MANCHESTER,HAMBURG,136140,136140,0,139981,139888,93,-2.743943821
17/03/2016 11:32,2015,1,WESTERN EUROPE-EU,GERMANY,2,MANCHESTER,HANOVER,46763,44856,1907,43817,43355,462,6.723417852
17/03/2016 11:32,2015,1,WESTERN EUROPE-EU,GERMANY,2,MANCHESTER,MAGDEBURG COCHSTEDT,86,0,86,0,0,0,0
17/03/2016 11:32,2015,1,WESTERN EUROPE-EU,GERMANY,2,MANCHESTER,MUNICH,324630,323083,1547,324492,318616,5876,0.042528013
17/03/2016 11:32,2015,1,WESTERN EUROPE-EU,GERMANY,2,MANCHESTER,NUREMBERG,0,0,0,3,0,3,0
17/03/2016 11:32,2015,1,WESTERN EUROPE-EU,GERMANY,2,MANCHESTER,STUTTGART,76452,76452,0,0,0,0,0
17/03/2016 11:32,2015,1,WESTERN EUROPE-EU,GERMANY,2,NEWCASTLE,BERLIN (SCHONEFELD),267,0,267,0,0,0,0
17/03/2016 11:32,2015,1,WESTERN EUROPE-EU,GERMANY,2,NEWCASTLE,COLOGNE BONN,0,0,0,92,0,92,0
17/03/2016 11:32,2015,1,WESTERN EUROPE-EU,GERMANY,2,NEWCASTLE,DUSSELDORF,39232,39155,77,35869,35827,42,9.375784103
17/03/2016 11:32,2015,1,WESTERN EUROPE-EU,GERMANY,2,NEWCASTLE,HANOVER,72,0,72,0,0,0,0
17/03/2016 11:32,2015,1,WESTERN EUROPE-EU,GERMANY,2,NEWCASTLE,MUNICH,0,0,0,484,0,484,0
17/03/2016 11:32,2015,1,WESTERN EUROPE-EU,GERMANY,2,NEWCASTLE,MUNSTER-OSNABRUCK,0,0,0,46,0,46,0
17/03/2016 11:32,2015,1,WESTERN EUROPE-EU,GERMANY,2,NEWQUAY,DUSSELDORF,2643,2643,0,3599,3599,0,-26.56293415
17/03/2016 11:32,2015,1,WESTERN EUROPE-EU,GERMANY,2,NORWICH,BREMEN,31,0,31,0,0,0,0
17/03/2016 11:32,2015,1,WESTERN EUROPE-EU,GERMANY,2,NORWICH,FRIEDRICHSHAFEN,280,0,280,0,0,0,0
17/03/2016 11:32,2015,1,WESTERN EUROPE-EU,GERMANY,2,PRESTWICK,COLOGNE BONN,0,0,0,124,0,124,0
17/03/2016 11:32,2015,1,WESTERN EUROPE-EU,GERMANY,2,SOUTHAMPTON,COLOGNE BONN,0,0,0,118,0,118,0
17/03/2016 11:32,2015,1,WESTERN EUROPE-EU,GERMANY,2,SOUTHAMPTON,DUSSELDORF,3973,3973,0,0,0,0,0
17/03/2016 11:32,2015,1,WESTERN EUROPE-EU,GERMANY,2,SOUTHAMPTON,FRIEDRICHSHAFEN,138,0,138,0,0,0,0
17/03/2016 11:32,2015,1,WESTERN EUROPE-EU,GERMANY,2,SOUTHAMPTON,HAMBURG,3704,3660,44,32,0,32,11475
17/03/2016 11:32,2015,1,WESTERN EUROPE-EU,GERMANY,2,SOUTHAMPTON,HANOVER,0,0,0,905,905,0,0
17/03/2016 11:32,2015,1,WESTERN EUROPE-EU,GERMANY,2,SOUTHAMPTON,NIEDERRHEIN,362,0,362,0,0,0,0
17/03/2016 11:32,2015,1,WESTERN EUROPE-EU,GIBRALTAR,1,GATWICK,GIBRALTAR,133882,133882,0,133007,133007,0,0.657860113
17/03/2016 11:32,2015,1,WESTERN EUROPE-EU,GIBRALTAR,1,HEATHROW,GIBRALTAR,118688,118688,0,110830,110830,0,7.090138049
17/03/2016 11:32,2015,1,WESTERN EUROPE-EU,GIBRALTAR,1,LUTON,GIBRALTAR,60821,60821,0,68688,68688,0,-11.45323783
17/03/2016 11:32,2015,1,WESTERN EUROPE-EU,GIBRALTAR,2,BIRMINGHAM,GIBRALTAR,38088,38088,0,40329,40329,0,-5.556795358
17/03/2016 11:32,2015,1,WESTERN EUROPE-EU,GIBRALTAR,2,BRISTOL,GIBRALTAR,28721,28721,0,0,0,0,0
17/03/2016 11:32,2015,1,WESTERN EUROPE-EU,GIBRALTAR,2,JERSEY,GIBRALTAR,355,0,355,0,0,0,0
17/03/2016 11:32,2015,1,WESTERN EUROPE-EU,GIBRALTAR,2,MANCHESTER,GIBRALTAR,59538,59538,0,61380,61380,0,-3.000977517
17/03/2016 11:32,2015,1,WESTERN EUROPE-EU,GREECE,1,GATWICK,ATHENS,186693,186693,0,137193,136197,996,36.08055805
17/03/2016 11:32,2015,1,WESTERN EUROPE-EU,GREECE,1,GATWICK,CHANIA,73421,49741,23680,72160,40814,31346,1.747505543
17/03/2016 11:32,2015,1,WESTERN EUROPE-EU,GREECE,1,GATWICK,CORFU,227753,125924,101829,224226,115862,108364,1.572966561
17/03/2016 11:32,2015,1,WESTERN EUROPE-EU,GREECE,1,GATWICK,HERAKLION,286863,186455,100408,233122,140927,92195,23.05273634
17/03/2016 11:32,2015,1,WESTERN EUROPE-EU,GREECE,1,GATWICK,KALAMATA,38093,31141,6952,32248,19750,12498,18.12515505
17/03/2016 11:32,2015,1,WESTERN EUROPE-EU,GREECE,1,GATWICK,KAVALA,13544,0,13544,17137,0,17137,-20.96633016
17/03/2016 11:32,2015,1,WESTERN EUROPE-EU,GREECE,1,GATWICK,KEFALLINIA,114962,50202,64760,107494,32339,75155,6.947364504
17/03/2016 11:32,2015,1,WESTERN EUROPE-EU,GREECE,1,GATWICK,KOS,104173,26934,77239,122210,34163,88047,-14.75902136
17/03/2016 11:32,2015,1,WESTERN EUROPE-EU,GREECE,1,GATWICK,LEMNOS,162,0,162,10128,0,10128,-98.40047393
17/03/2016 11:32,2015,1,WESTERN EUROPE-EU,GREECE,1,GATWICK,MIKONOS,75402,67696,7706,58009,50581,7428,29.98327846
17/03/2016 11:32,2015,1,WESTERN EUROPE-EU,GREECE,1,GATWICK,MYTILINI,9972,0,9972,10246,0,10246,-2.674214328
17/03/2016 11:32,2015,1,WESTERN EUROPE-EU,GREECE,1,GATWICK,PATRAS,0,0,0,5455,0,5455,0
17/03/2016 11:32,2015,1,WESTERN EUROPE-EU,GREECE,1,GATWICK,PREVEZA,79610,31021,48589,77296,0,77296,2.993686607
17/03/2016 11:32,2015,1,WESTERN EUROPE-EU,GREECE,1,GATWICK,RHODES,165510,75633,89877,147052,46946,100106,12.55202241
17/03/2016 11:32,2015,1,WESTERN EUROPE-EU,GREECE,1,GATWICK,SALONIKA,137430,127335,10095,120837,110714,10123,13.73172124
17/03/2016 11:32,2015,1,WESTERN EUROPE-EU,GREECE,1,GATWICK,SAMOS,11248,0,11248,11874,0,11874,-5.272022907
17/03/2016 11:32,2015,1,WESTERN EUROPE-EU,GREECE,1,GATWICK,SKIATHOS,47191,0,47191,46791,0,46791,0.854865252
17/03/2016 11:32,2015,1,WESTERN EUROPE-EU,GREECE,1,GATWICK,THIRA (SANTORINI),101313,81922,19391,86218,65456,20762,17.50794498
17/03/2016 11:32,2015,1,WESTERN EUROPE-EU,GREECE,1,GATWICK,VOLOS,4973,0,4973,3657,0,3657,35.98578069
17/03/2016 11:32,2015,1,WESTERN EUROPE-EU,GREECE,1,GATWICK,ZAKINTHOS,159235,52736,106499,150756,42238,108518,5.624320093
17/03/2016 11:32,2015,1,WESTERN EUROPE-EU,GREECE,1,HEATHROW,ATHENS,699094,697046,2048,716571,716571,0,-2.438976738
17/03/2016 11:32,2015,1,WESTERN EUROPE-EU,GREECE,1,HEATHROW,CORFU,25663,21399,4264,0,0,0,0
17/03/2016 11:32,2015,1,WESTERN EUROPE-EU,GREECE,1,HEATHROW,KALAMATA,10401,0,10401,9381,0,9381,10.87304125
17/03/2016 11:32,2015,1,WESTERN EUROPE-EU,GREECE,1,HEATHROW,KOS,20708,11142,9566,10272,0,10272,101.5965732
17/03/2016 11:32,2015,1,WESTERN EUROPE-EU,GREECE,1,HEATHROW,LEMNOS,14644,0,14644,5936,0,5936,146.6981132
17/03/2016 11:32,2015,1,WESTERN EUROPE-EU,GREECE,1,HEATHROW,MIKONOS,10213,10213,0,9794,9794,0,4.278129467
17/03/2016 11:32,2015,1,WESTERN EUROPE-EU,GREECE,1,HEATHROW,PREVEZA,6216,0,6216,6053,0,6053,2.692879564
17/03/2016 11:32,2015,1,WESTERN EUROPE-EU,GREECE,1,HEATHROW,RHODES,11633,0,11633,11298,0,11298,2.965126571
17/03/2016 11:32,2015,1,WESTERN EUROPE-EU,GREECE,1,HEATHROW,THIRA (SANTORINI),15511,15511,0,10345,10345,0,49.93716771
17/03/2016 11:32,2015,1,WESTERN EUROPE-EU,GREECE,1,LONDON CITY,MIKONOS,5440,5440,0,0,0,0,0
17/03/2016 11:32,2015,1,WESTERN EUROPE-EU,GREECE,1,LONDON CITY,THIRA (SANTORINI),2513,2513,0,0,0,0,0
17/03/2016 11:32,2015,1,WESTERN EUROPE-EU,GREECE,1,LUTON,ATHENS,678,2,676,0,0,0,0
17/03/2016 11:32,2015,1,WESTERN EUROPE-EU,GREECE,1,LUTON,CORFU,51248,40037,11211,60515,49410,11105,-15.31355862
17/03/2016 11:32,2015,1,WESTERN EUROPE-EU,GREECE,1,LUTON,HERAKLION,30213,20739,9474,28629,19096,9533,5.532851305
17/03/2016 11:32,2015,1,WESTERN EUROPE-EU,GREECE,1,LUTON,KEFALLINIA,7478,0,7478,7111,0,7111,5.161018141
17/03/2016 11:32,2015,1,WESTERN EUROPE-EU,GREECE,1,LUTON,MIKONOS,12662,12644,18,12914,12914,0,-1.951370606
17/03/2016 11:32,2015,1,WESTERN EUROPE-EU,GREECE,1,LUTON,PATRAS,318,0,318,0,0,0,0
17/03/2016 11:32,2015,1,WESTERN EUROPE-EU,GREECE,1,LUTON,RHODES,16601,0,16601,15453,0,15453,7.428978192
17/03/2016 11:32,2015,1,WESTERN EUROPE-EU,GREECE,1,LUTON,SKIATHOS,8219,0,8219,6077,0,6077,35.24765509
17/03/2016 11:32,2015,1,WESTERN EUROPE-EU,GREECE,1,LUTON,ZAKINTHOS,17478,10047,7431,12512,0,12512,39.6898977
17/03/2016 11:32,2015,1,WESTERN EUROPE-EU,GREECE,1,STANSTED,ATHENS,247544,247544,0,131404,131404,0,88.38391525
17/03/2016 11:32,2015,1,WESTERN EUROPE-EU,GREECE,1,STANSTED,CHANIA,24724,24724,0,30361,30153,208,-18.56658213
17/03/2016 11:32,2015,1,WESTERN EUROPE-EU,GREECE,1,STANSTED,CORFU,40476,23468,17008,42448,25438,17010,-4.645684131
17/03/2016 11:32,2015,1,WESTERN EUROPE-EU,GREECE,1,STANSTED,HERAKLION,15956,0,15956,21892,0,21892,-27.11492783
17/03/2016 11:32,2015,1,WESTERN EUROPE-EU,GREECE,1,STANSTED,KALAMATA,0,0,0,870,0,870,0
17/03/2016 11:32,2015,1,WESTERN EUROPE-EU,GREECE,1,STANSTED,KEFALLINIA,26424,11443,14981,36038,20624,15414,-26.67739608
17/03/2016 11:32,2015,1,WESTERN EUROPE-EU,GREECE,1,STANSTED,KOS,38028,21784,16244,36209,20733,15476,5.023612914
17/03/2016 11:32,2015,1,WESTERN EUROPE-EU,GREECE,1,STANSTED,PREVEZA,1882,0,1882,0,0,0,0
17/03/2016 11:32,2015,1,WESTERN EUROPE-EU,GREECE,1,STANSTED,RHODES,59726,34546,25180,56138,30426,25712,6.39139264
17/03/2016 11:32,2015,1,WESTERN EUROPE-EU,GREECE,1,STANSTED,SALONIKA,117625,117212,413,106012,105569,443,10.95442025
17/03/2016 11:32,2015,1,WESTERN EUROPE-EU,GREECE,1,STANSTED,SKIATHOS,6082,0,6082,6188,0,6188,-1.712992889
17/03/2016 11:32,2015,1,WESTERN EUROPE-EU,GREECE,1,STANSTED,THIRA (SANTORINI),0,0,0,154,0,154,0
17/03/2016 11:32,2015,1,WESTERN EUROPE-EU,GREECE,1,STANSTED,ZAKINTHOS,20945,4,20941,20876,0,20876,0.330523089
17/03/2016 11:32,2015,1,WESTERN EUROPE-EU,GREECE,2,ABERDEEN,CORFU,7427,0,7427,7444,0,7444,-0.228371843
17/03/2016 11:32,2015,1,WESTERN EUROPE-EU,GREECE,2,BELFAST CITY (GEORGE BEST),ATHENS,0,0,0,60,0,60,0
17/03/2016 11:32,2015,1,WESTERN EUROPE-EU,GREECE,2,BELFAST INTERNATIONAL,ATHENS,154,0,154,0,0,0,0
17/03/2016 11:32,2015,1,WESTERN EUROPE-EU,GREECE,2,BELFAST INTERNATIONAL,CORFU,12135,0,12135,7323,0,7323,65.71077427
17/03/2016 11:32,2015,1,WESTERN EUROPE-EU,GREECE,2,BELFAST INTERNATIONAL,HERAKLION,13697,0,13697,13027,0,13027,5.143164197
17/03/2016 11:32,2015,1,WESTERN EUROPE-EU,GREECE,2,BELFAST INTERNATIONAL,RHODES,4841,0,4841,5192,0,5192,-6.760400616
17/03/2016 11:32,2015,1,WESTERN EUROPE-EU,GREECE,2,BELFAST INTERNATIONAL,ZAKINTHOS,4672,4672,0,0,0,0,0
17/03/2016 11:32,2015,1,WESTERN EUROPE-EU,GREECE,2,BIRMINGHAM,ATHENS,13324,13173,151,8670,8670,0,53.67935409
17/03/2016 11:32,2015,1,WESTERN EUROPE-EU,GREECE,2,BIRMINGHAM,CHANIA,9336,0,9336,0,0,0,0
17/03/2016 11:32,2015,1,WESTERN EUROPE-EU,GREECE,2,BIRMINGHAM,CORFU,47552,0,47552,51203,0,51203,-7.130441576
17/03/2016 11:32,2015,1,WESTERN EUROPE-EU,GREECE,2,BIRMINGHAM,HERAKLION,48375,13933,34442,59576,16721,42855,-18.80119511
17/03/2016 11:32,2015,1,WESTERN EUROPE-EU,GREECE,2,BIRMINGHAM,KALAMATA,5851,1119,4732,444,0,444,1217.792793
17/03/2016 11:32,2015,1,WESTERN EUROPE-EU,GREECE,2,BIRMINGHAM,KAVALA,8843,0,8843,8798,0,8798,0.511479882
17/03/2016 11:32,2015,1,WESTERN EUROPE-EU,GREECE,2,BIRMINGHAM,KEFALLINIA,30704,0,30704,17443,0,17443,76.02476638
17/03/2016 11:32,2015,1,WESTERN EUROPE-EU,GREECE,2,BIRMINGHAM,KOS,33952,0,33952,29059,0,29059,16.83815685
17/03/2016 11:32,2015,1,WESTERN EUROPE-EU,GREECE,2,BIRMINGHAM,MYTILINI,8692,0,8692,0,0,0,0
17/03/2016 11:32,2015,1,WESTERN EUROPE-EU,GREECE,2,BIRMINGHAM,PREVEZA,6845,6845,0,6124,0,6124,11.77335075
17/03/2016 11:32,2015,1,WESTERN EUROPE-EU,GREECE,2,BIRMINGHAM,RHODES,52476,0,52476,59262,0,59262,-11.4508454
17/03/2016 11:32,2015,1,WESTERN EUROPE-EU,GREECE,2,BIRMINGHAM,SKIATHOS,8874,0,8874,12738,0,12738,-30.33443241
17/03/2016 11:32,2015,1,WESTERN EUROPE-EU,GREECE,2,BIRMINGHAM,THIRA (SANTORINI),13145,0,13145,12439,0,12439,5.675697403
17/03/2016 11:32,2015,1,WESTERN EUROPE-EU,GREECE,2,BIRMINGHAM,ZAKINTHOS,54050,0,54050,47830,0,47830,13.00439055
17/03/2016 11:32,2015,1,WESTERN EUROPE-EU,GREECE,2,BOURNEMOUTH,CHANIA,0,0,0,8704,8704,0,0
17/03/2016 11:32,2015,1,WESTERN EUROPE-EU,GREECE,2,BOURNEMOUTH,CORFU,7559,0,7559,7516,0,7516,0.572112826
17/03/2016 11:32,2015,1,WESTERN EUROPE-EU,GREECE,2,BOURNEMOUTH,RHODES,9526,0,9526,19070,8198,10872,-50.04719455
17/03/2016 11:32,2015,1,WESTERN EUROPE-EU,GREECE,2,BRISTOL,CHANIA,22208,22208,0,22010,22010,0,0.899591095
17/03/2016 11:32,2015,1,WESTERN EUROPE-EU,GREECE,2,BRISTOL,CORFU,46214,25501,20713,36585,16546,20039,26.31952986
17/03/2016 11:32,2015,1,WESTERN EUROPE-EU,GREECE,2,BRISTOL,HERAKLION,42938,17412,25526,37266,17262,20004,15.22030806
17/03/2016 11:32,2015,1,WESTERN EUROPE-EU,GREECE,2,BRISTOL,KAVALA,0,0,0,2156,0,2156,0
17/03/2016 11:32,2015,1,WESTERN EUROPE-EU,GREECE,2,BRISTOL,KEFALLINIA,8949,0,8949,9328,0,9328,-4.063036021
17/03/2016 11:32,2015,1,WESTERN EUROPE-EU,GREECE,2,BRISTOL,KOS,19773,0,19773,19927,0,19927,-0.772820796
17/03/2016 11:32,2015,1,WESTERN EUROPE-EU,GREECE,2,BRISTOL,RHODES,18685,0,18685,14466,0,14466,29.16493848
17/03/2016 11:32,2015,1,WESTERN EUROPE-EU,GREECE,2,BRISTOL,SALONIKA,6256,0,6256,0,0,0,0
17/03/2016 11:32,2015,1,WESTERN EUROPE-EU,GREECE,2,BRISTOL,SKIATHOS,7471,0,7471,2842,0,2842,162.8782548
17/03/2016 11:32,2015,1,WESTERN EUROPE-EU,GREECE,2,BRISTOL,THIRA (SANTORINI),6945,0,6945,0,0,0,0
17/03/2016 11:32,2015,1,WESTERN EUROPE-EU,GREECE,2,BRISTOL,ZAKINTHOS,51940,7357,44583,42244,0,42244,22.95237193
17/03/2016 11:32,2015,1,WESTERN EUROPE-EU,GREECE,2,CARDIFF WALES,CORFU,9552,0,9552,9770,0,9770,-2.231320368
17/03/2016 11:32,2015,1,WESTERN EUROPE-EU,GREECE,2,CARDIFF WALES,HERAKLION,9122,0,9122,16205,0,16205,-43.70873187
17/03/2016 11:32,2015,1,WESTERN EUROPE-EU,GREECE,2,CARDIFF WALES,KEFALLINIA,7649,0,7649,7737,0,7737,-1.137391754
17/03/2016 11:32,2015,1,WESTERN EUROPE-EU,GREECE,2,CARDIFF WALES,KOS,8182,0,8182,8168,0,8168,0.171400588
17/03/2016 11:32,2015,1,WESTERN EUROPE-EU,GREECE,2,CARDIFF WALES,RHODES,16121,0,16121,16168,0,16168,-0.290697674
17/03/2016 11:32,2015,1,WESTERN EUROPE-EU,GREECE,2,CARDIFF WALES,ZAKINTHOS,21315,0,21315,21419,0,21419,-0.485550212
17/03/2016 11:32,2015,1,WESTERN EUROPE-EU,GREECE,2,DONCASTER SHEFFIELD,ANDRAVIDA,45,0,45,0,0,0,0
17/03/2016 11:32,2015,1,WESTERN EUROPE-EU,GREECE,2,DONCASTER SHEFFIELD,CORFU,17298,0,17298,16579,0,16579,4.336811629
17/03/2016 11:32,2015,1,WESTERN EUROPE-EU,GREECE,2,DONCASTER SHEFFIELD,RHODES,9097,0,9097,8420,0,8420,8.040380048
17/03/2016 11:32,2015,1,WESTERN EUROPE-EU,GREECE,2,DONCASTER SHEFFIELD,ZAKINTHOS,7695,0,7695,0,0,0,0
17/03/2016 11:32,2015,1,WESTERN EUROPE-EU,GREECE,2,EAST MIDLANDS INTERNATIONAL,CHANIA,16384,16384,0,12348,12348,0,32.68545513
17/03/2016 11:32,2015,1,WESTERN EUROPE-EU,GREECE,2,EAST MIDLANDS INTERNATIONAL,CORFU,49732,17010,32722,56863,25106,31757,-12.54066792
17/03/2016 11:32,2015,1,WESTERN EUROPE-EU,GREECE,2,EAST MIDLANDS INTERNATIONAL,HERAKLION,33036,17178,15858,39516,16454,23062,-16.39842089
17/03/2016 11:32,2015,1,WESTERN EUROPE-EU,GREECE,2,EAST MIDLANDS INTERNATIONAL,KOS,15025,5944,9081,15627,6686,8941,-3.852306905
17/03/2016 11:32,2015,1,WESTERN EUROPE-EU,GREECE,2,EAST MIDLANDS INTERNATIONAL,RHODES,56006,29009,26997,55355,29107,26248,1.176045524
17/03/2016 11:32,2015,1,WESTERN EUROPE-EU,GREECE,2,EAST MIDLANDS INTERNATIONAL,SALONIKA,7988,0,7988,7247,0,7247,10.22492066
17/03/2016 11:32,2015,1,WESTERN EUROPE-EU,GREECE,2,EAST MIDLANDS INTERNATIONAL,SKIATHOS,8137,0,8137,8235,0,8235,-1.190042502
17/03/2016 11:32,2015,1,WESTERN EUROPE-EU,GREECE,2,EAST MIDLANDS INTERNATIONAL,ZAKINTHOS,38726,5996,32730,38012,5647,32365,1.878354204
17/03/2016 11:32,2015,1,WESTERN EUROPE-EU,GREECE,2,EDINBURGH,ATHENS,35040,35040,0,34172,33999,173,2.540091303
17/03/2016 11:32,2015,1,WESTERN EUROPE-EU,GREECE,2,EDINBURGH,CORFU,21323,11731,9592,18879,9446,9433,12.94560093
17/03/2016 11:32,2015,1,WESTERN EUROPE-EU,GREECE,2,EDINBURGH,HERAKLION,18524,18524,0,18016,18016,0,2.819715808
17/03/2016 11:32,2015,1,WESTERN EUROPE-EU,GREECE,2,EXETER,CORFU,9625,0,9625,9492,0,9492,1.401179941
17/03/2016 11:32,2015,1,WESTERN EUROPE-EU,GREECE,2,EXETER,HERAKLION,5568,0,5568,5301,0,5301,5.036785512
17/03/2016 11:32,2015,1,WESTERN EUROPE-EU,GREECE,2,EXETER,SALONIKA,7655,0,7655,0,0,0,0
17/03/2016 11:32,2015,1,WESTERN EUROPE-EU,GREECE,2,GLASGOW,CHANIA,6881,6881,0,0,0,0,0
17/03/2016 11:32,2015,1,WESTERN EUROPE-EU,GREECE,2,GLASGOW,CORFU,33537,6046,27491,33785,5161,28624,-0.734053574
17/03/2016 11:32,2015,1,WESTERN EUROPE-EU,GREECE,2,GLASGOW,HERAKLION,50395,21742,28653,51349,22289,29060,-1.857874545
17/03/2016 11:32,2015,1,WESTERN EUROPE-EU,GREECE,2,GLASGOW,KOS,27070,19075,7995,33093,17600,15493,-18.20022361
17/03/2016 11:32,2015,1,WESTERN EUROPE-EU,GREECE,2,GLASGOW,RHODES,26613,8524,18089,27418,8099,19319,-2.936027427
17/03/2016 11:32,2015,1,WESTERN EUROPE-EU,GREECE,2,GLASGOW,ZAKINTHOS,26149,5920,20229,31311,5616,25695,-16.4862189
17/03/2016 11:32,2015,1,WESTERN EUROPE-EU,GREECE,2,JERSEY,KAVALA,110,0,110,0,0,0,0
17/03/2016 11:32,2015,1,WESTERN EUROPE-EU,GREECE,2,LEEDS BRADFORD,CHANIA,20959,20959,0,19279,19279,0,8.714144925
17/03/2016 11:32,2015,1,WESTERN EUROPE-EU,GREECE,2,LEEDS BRADFORD,CORFU,28941,15673,13268,27748,15262,12486,4.299408966
17/03/2016 11:32,2015,1,WESTERN EUROPE-EU,GREECE,2,LEEDS BRADFORD,HERAKLION,39111,30213,8898,40941,40941,0,-4.469846853
17/03/2016 11:32,2015,1,WESTERN EUROPE-EU,GREECE,2,LEEDS BRADFORD,KEFALLINIA,4609,4609,0,0,0,0,0
17/03/2016 11:32,2015,1,WESTERN EUROPE-EU,GREECE,2,LEEDS BRADFORD,KOS,5800,5800,0,16331,16331,0,-64.48472231
17/03/2016 11:32,2015,1,WESTERN EUROPE-EU,GREECE,2,LEEDS BRADFORD,RHODES,20092,10460,9632,19477,9921,9556,3.157570468
17/03/2016 11:32,2015,1,WESTERN EUROPE-EU,GREECE,2,LEEDS BRADFORD,ZAKINTHOS,7858,7858,0,9515,9515,0,-17.41460851
17/03/2016 11:32,2015,1,WESTERN EUROPE-EU,GREECE,2,LIVERPOOL (JOHN LENNON),ATHENS,44,0,44,0,0,0,0
17/03/2016 11:32,2015,1,WESTERN EUROPE-EU,GREECE,2,LIVERPOOL (JOHN LENNON),KOS,3266,3266,0,8399,8399,0,-61.11441838
17/03/2016 11:32,2015,1,WESTERN EUROPE-EU,GREECE,2,LIVERPOOL (JOHN LENNON),RHODES,21617,21617,0,32652,32652,0,-33.79578586
17/03/2016 11:32,2015,1,WESTERN EUROPE-EU,GREECE,2,LIVERPOOL (JOHN LENNON),ZAKINTHOS,6947,6947,0,0,0,0,0
17/03/2016 11:32,2015,1,WESTERN EUROPE-EU,GREECE,2,MANCHESTER,ATHENS,82860,81849,1011,85277,81310,3967,-2.834292951
17/03/2016 11:32,2015,1,WESTERN EUROPE-EU,GREECE,2,MANCHESTER,CHANIA,35483,21403,14080,21032,0,21032,68.70958539
17/03/2016 11:32,2015,1,WESTERN EUROPE-EU,GREECE,2,MANCHESTER,CORFU,155247,72170,83077,138007,61447,76560,12.49211996
17/03/2016 11:32,2015,1,WESTERN EUROPE-EU,GREECE,2,MANCHESTER,HERAKLION,161238,69677,91561,148547,57958,90589,8.543423967
17/03/2016 11:32,2015,1,WESTERN EUROPE-EU,GREECE,2,MANCHESTER,KALAMATA,12420,2097,10323,13274,0,13274,-6.433629652
17/03/2016 11:32,2015,1,WESTERN EUROPE-EU,GREECE,2,MANCHESTER,KAVALA,7646,0,7646,7644,0,7644,0.026164312
17/03/2016 11:32,2015,1,WESTERN EUROPE-EU,GREECE,2,MANCHESTER,KEFALLINIA,84315,20675,63640,68606,0,68606,22.89741422
17/03/2016 11:32,2015,1,WESTERN EUROPE-EU,GREECE,2,MANCHESTER,KOS,105846,26760,79086,91610,23315,68295,15.53978823
17/03/2016 11:32,2015,1,WESTERN EUROPE-EU,GREECE,2,MANCHESTER,MIKONOS,11814,11814,0,12780,12780,0,-7.558685446
17/03/2016 11:32,2015,1,WESTERN EUROPE-EU,GREECE,2,MANCHESTER,MYTILINI,9470,0,9470,18268,0,18268,-48.1607182
17/03/2016 11:32,2015,1,WESTERN EUROPE-EU,GREECE,2,MANCHESTER,PREVEZA,42215,8910,33305,41487,0,41487,1.754766553
17/03/2016 11:32,2015,1,WESTERN EUROPE-EU,GREECE,2,MANCHESTER,RHODES,136462,32959,103503,116567,21428,95139,17.06743761
17/03/2016 11:32,2015,1,WESTERN EUROPE-EU,GREECE,2,MANCHESTER,SALONIKA,35190,28597,6593,34864,28802,6062,0.935061955
17/03/2016 11:32,2015,1,WESTERN EUROPE-EU,GREECE,2,MANCHESTER,SKIATHOS,48019,0,48019,46873,0,46873,2.444904316
17/03/2016 11:32,2015,1,WESTERN EUROPE-EU,GREECE,2,MANCHESTER,THIRA (SANTORINI),49712,22891,26821,33986,15331,18655,46.27199435
17/03/2016 11:32,2015,1,WESTERN EUROPE-EU,GREECE,2,MANCHESTER,VOLOS,2679,0,2679,3498,0,3498,-23.41337907
17/03/2016 11:32,2015,1,WESTERN EUROPE-EU,GREECE,2,MANCHESTER,ZAKINTHOS,116308,27607,88701,108616,21006,87610,7.081829565
17/03/2016 11:32,2015,1,WESTERN EUROPE-EU,GREECE,2,NEWCASTLE,ATHENS,162,0,162,0,0,0,0
17/03/2016 11:32,2015,1,WESTERN EUROPE-EU,GREECE,2,NEWCASTLE,CORFU,47123,13330,33793,40927,7996,32931,15.13915019
17/03/2016 11:32,2015,1,WESTERN EUROPE-EU,GREECE,2,NEWCASTLE,HERAKLION,23180,8953,14227,27213,10778,16435,-14.82012274
17/03/2016 11:32,2015,1,WESTERN EUROPE-EU,GREECE,2,NEWCASTLE,KAVALA,2003,0,2003,2083,0,2083,-3.840614498
17/03/2016 11:32,2015,1,WESTERN EUROPE-EU,GREECE,2,NEWCASTLE,KEFALLINIA,13269,0,13269,12686,0,12686,4.595617216
17/03/2016 11:32,2015,1,WESTERN EUROPE-EU,GREECE,2,NEWCASTLE,KOS,16697,0,16697,17146,0,17146,-2.618686574
17/03/2016 11:32,2015,1,WESTERN EUROPE-EU,GREECE,2,NEWCASTLE,RHODES,40248,15582,24666,36866,10418,26448,9.173764444
17/03/2016 11:32,2015,1,WESTERN EUROPE-EU,GREECE,2,NEWCASTLE,SKIATHOS,5195,0,5195,5066,0,5066,2.546387683
17/03/2016 11:32,2015,1,WESTERN EUROPE-EU,GREECE,2,NEWCASTLE,THIRA (SANTORINI),7214,0,7214,0,0,0,0
17/03/2016 11:32,2015,1,WESTERN EUROPE-EU,GREECE,2,NEWCASTLE,ZAKINTHOS,34936,4733,30203,30228,0,30228,15.57496361
17/03/2016 11:32,2015,1,WESTERN EUROPE-EU,GREECE,2,NORWICH,CORFU,7438,0,7438,7075,0,7075,5.130742049
17/03/2016 11:32,2015,1,WESTERN EUROPE-EU,GREECE,2,PRESTWICK,CHANIA,0,0,0,6703,6703,0,0
17/03/2016 11:32,2015,1,WESTERN EUROPE-EU,GREECE,2,PRESTWICK,CORFU,5659,5659,0,8104,8104,0,-30.17028628
17/03/2016 11:32,2015,1,WESTERN EUROPE-EU,IRISH REPUBLIC,1,GATWICK,CORK,118177,118177,0,119448,119343,105,-1.064061349
17/03/2016 11:32,2015,1,WESTERN EUROPE-EU,IRISH REPUBLIC,1,GATWICK,DUBLIN,1083542,1083399,143,990236,990004,232,9.422602289
17/03/2016 11:32,2015,1,WESTERN EUROPE-EU,IRISH REPUBLIC,1,GATWICK,IRELAND WEST(KNOCK),74658,74658,0,71307,71307,0,4.699398376
17/03/2016 11:32,2015,1,WESTERN EUROPE-EU,IRISH REPUBLIC,1,GATWICK,SHANNON,110125,110125,0,103114,103114,0,6.79927071
17/03/2016 11:32,2015,1,WESTERN EUROPE-EU,IRISH REPUBLIC,1,HEATHROW,CORK,384831,384831,0,397867,397867,0,-3.276471786
17/03/2016 11:32,2015,1,WESTERN EUROPE-EU,IRISH REPUBLIC,1,HEATHROW,DUBLIN,1682855,1682855,0,1650675,1650675,0,1.949505505
17/03/2016 11:32,2015,1,WESTERN EUROPE-EU,IRISH REPUBLIC,1,HEATHROW,SHANNON,234066,234066,0,232814,232322,492,0.537768347
17/03/2016 11:32,2015,1,WESTERN EUROPE-EU,IRISH REPUBLIC,1,LONDON CITY,CORK,16961,16961,0,0,0,0,0
17/03/2016 11:32,2015,1,WESTERN EUROPE-EU,IRISH REPUBLIC,1,LONDON CITY,DUBLIN,451474,451474,0,231423,231377,46,95.08605454
17/03/2016 11:32,2015,1,WESTERN EUROPE-EU,IRISH REPUBLIC,1,LUTON,CORK,0,0,0,20,0,20,0
17/03/2016 11:32,2015,1,WESTERN EUROPE-EU,IRISH REPUBLIC,1,LUTON,DUBLIN,337349,336668,681,325722,325404,318,3.569608439
17/03/2016 11:32,2015,1,WESTERN EUROPE-EU,IRISH REPUBLIC,1,LUTON,IRELAND WEST(KNOCK),126117,126117,0,123008,123008,0,2.527477888
17/03/2016 11:32,2015,1,WESTERN EUROPE-EU,IRISH REPUBLIC,1,LUTON,KERRY COUNTY,108083,107839,244,102317,102317,0,5.635427153
17/03/2016 11:32,2015,1,WESTERN EUROPE-EU,IRISH REPUBLIC,1,LUTON,SHANNON,0,0,0,158,0,158,0
17/03/2016 11:32,2015,1,WESTERN EUROPE-EU,IRISH REPUBLIC,1,LUTON,WATERFORD,23123,23090,33,0,0,0,0
17/03/2016 11:32,2015,1,WESTERN EUROPE-EU,IRISH REPUBLIC,1,SOUTHEND,DUBLIN,4450,4450,0,61599,61599,0,-92.77585675
17/03/2016 11:32,2015,1,WESTERN EUROPE-EU,IRISH REPUBLIC,1,STANSTED,CORK,320140,320140,0,256672,256672,0,24.72727839
17/03/2016 11:32,2015,1,WESTERN EUROPE-EU,IRISH REPUBLIC,1,STANSTED,DUBLIN,879764,879574,190,808672,808559,113,8.791203356
17/03/2016 11:32,2015,1,WESTERN EUROPE-EU,IRISH REPUBLIC,1,STANSTED,IRELAND WEST(KNOCK),157012,157012,0,143188,143188,0,9.654440316
17/03/2016 11:32,2015,1,WESTERN EUROPE-EU,IRISH REPUBLIC,1,STANSTED,KERRY COUNTY,72487,72487,0,69556,69449,107,4.213870838
17/03/2016 11:32,2015,1,WESTERN EUROPE-EU,IRISH REPUBLIC,1,STANSTED,SHANNON,231941,231941,0,201337,201337,0,15.20038542
17/03/2016 11:32,2015,1,WESTERN EUROPE-EU,IRISH REPUBLIC,2,ABERDEEN,DONEGAL,359,0,359,1122,0,1122,-68.00356506
17/03/2016 11:32,2015,1,WESTERN EUROPE-EU,IRISH REPUBLIC,2,ABERDEEN,DUBLIN,40467,40364,103,47266,47146,120,-14.38454703
17/03/2016 11:32,2015,1,WESTERN EUROPE-EU,IRISH REPUBLIC,2,BELFAST INTERNATIONAL,CORK,35,0,35,0,0,0,0
17/03/2016 11:32,2015,1,WESTERN EUROPE-EU,IRISH REPUBLIC,2,BELFAST INTERNATIONAL,DUBLIN,1517,0,1517,612,0,612,147.875817
17/03/2016 11:32,2015,1,WESTERN EUROPE-EU,IRISH REPUBLIC,2,BELFAST INTERNATIONAL,IRELAND WEST(KNOCK),0,0,0,24,0,24,0
17/03/2016 11:32,2015,1,WESTERN EUROPE-EU,IRISH REPUBLIC,2,BELFAST INTERNATIONAL,SHANNON,271,0,271,30,0,30,803.3333333
17/03/2016 11:32,2015,1,WESTERN EUROPE-EU,IRISH REPUBLIC,2,BIGGIN HILL,DUBLIN,0,0,0,56,0,56,0
17/03/2016 11:32,2015,1,WESTERN EUROPE-EU,IRISH REPUBLIC,2,BIRMINGHAM,CORK,76961,76961,0,73156,73156,0,5.201213844
17/03/2016 11:32,2015,1,WESTERN EUROPE-EU,IRISH REPUBLIC,2,BIRMINGHAM,DUBLIN,780743,780486,257,661611,661603,8,18.00635116
17/03/2016 11:32,2015,1,WESTERN EUROPE-EU,IRISH REPUBLIC,2,BIRMINGHAM,IRELAND WEST(KNOCK),5182,5134,48,28714,28714,0,-81.95305426
17/03/2016 11:32,2015,1,WESTERN EUROPE-EU,IRISH REPUBLIC,2,BIRMINGHAM,SHANNON,18952,18865,87,41150,41150,0,-53.94410693
17/03/2016 11:32,2015,1,WESTERN EUROPE-EU,IRISH REPUBLIC,2,BIRMINGHAM,WATERFORD,11151,11151,0,21429,21429,0,-47.96304074
17/03/2016 11:32,2015,1,WESTERN EUROPE-EU,IRISH REPUBLIC,2,BLACKPOOL,DUBLIN,0,0,0,14624,14624,0,0
17/03/2016 11:32,2015,1,WESTERN EUROPE-EU,IRISH REPUBLIC,2,BOURNEMOUTH,DUBLIN,13954,13954,0,12073,12073,0,15.58022033
17/03/2016 11:32,2015,1,WESTERN EUROPE-EU,IRISH REPUBLIC,2,BRISTOL,CORK,41433,41415,18,41776,41776,0,-0.821045576
17/03/2016 11:32,2015,1,WESTERN EUROPE-EU,IRISH REPUBLIC,2,BRISTOL,DUBLIN,378261,375696,2565,331655,331655,0,14.05255461
17/03/2016 11:32,2015,1,WESTERN EUROPE-EU,IRISH REPUBLIC,2,BRISTOL,IRELAND WEST(KNOCK),27980,27980,0,21606,21606,0,29.50106452
17/03/2016 11:32,2015,1,WESTERN EUROPE-EU,IRISH REPUBLIC,2,BRISTOL,SHANNON,312,312,0,16449,16096,353,-98.10322816
17/03/2016 11:32,2015,1,WESTERN EUROPE-EU,IRISH REPUBLIC,2,CAMBRIDGE,DUBLIN,0,0,0,8559,8559,0,0
17/03/2016 11:32,2015,1,WESTERN EUROPE-EU,IRISH REPUBLIC,2,CAMPBELTOWN,DUBLIN,36,0,36,0,0,0,0
17/03/2016 11:32,2015,1,WESTERN EUROPE-EU,IRISH REPUBLIC,2,CARDIFF WALES,CORK,5486,5207,279,38,0,38,14336.84211
17/03/2016 11:32,2015,1,WESTERN EUROPE-EU,IRISH REPUBLIC,2,CARDIFF WALES,DUBLIN,120518,107820,12698,70684,68583,2101,70.50251825
17/03/2016 11:32,2015,1,WESTERN EUROPE-EU,IRISH REPUBLIC,2,CARDIFF WALES,SHANNON,2347,1374,973,454,0,454,416.9603524
17/03/2016 11:32,2015,1,WESTERN EUROPE-EU,IRISH REPUBLIC,2,CITY OF DERRY (EGLINTON),DUBLIN,28,28,0,0,0,0,0
17/03/2016 11:32,2015,1,WESTERN EUROPE-EU,IRISH REPUBLIC,2,CITY OF DERRY (EGLINTON),SHANNON,37,0,37,0,0,0,0
17/03/2016 11:32,2015,1,WESTERN EUROPE-EU,IRISH REPUBLIC,2,DONCASTER SHEFFIELD,DUBLIN,10669,10669,0,95,0,95,11130.52632
17/03/2016 11:32,2015,1,WESTERN EUROPE-EU,IRISH REPUBLIC,2,DONCASTER SHEFFIELD,SHANNON,0,0,0,12,0,12,0
17/03/2016 11:32,2015,1,WESTERN EUROPE-EU,IRISH REPUBLIC,2,DUNDEE,DUBLIN,232,0,232,0,0,0,0
17/03/2016 11:32,2015,1,WESTERN EUROPE-EU,IRISH REPUBLIC,2,DURHAM TEES VALLEY,DUBLIN,7,0,7,0,0,0,0
17/03/2016 11:32,2015,1,WESTERN EUROPE-EU,IRISH REPUBLIC,2,EAST MIDLANDS INTERNATIONAL,CORK,0,0,0,28406,28406,0,0
17/03/2016 11:32,2015,1,WESTERN EUROPE-EU,IRISH REPUBLIC,2,EAST MIDLANDS INTERNATIONAL,DUBLIN,175610,175610,0,115728,115728,0,51.74374395
17/03/2016 11:32,2015,1,WESTERN EUROPE-EU,IRISH REPUBLIC,2,EAST MIDLANDS INTERNATIONAL,IRELAND WEST(KNOCK),70881,70881,0,55837,55837,0,26.94270824
17/03/2016 11:32,2015,1,WESTERN EUROPE-EU,IRISH REPUBLIC,2,EDINBURGH,CORK,40034,39968,66,38467,38428,39,4.073621546
17/03/2016 11:32,2015,1,WESTERN EUROPE-EU,IRISH REPUBLIC,2,EDINBURGH,DUBLIN,540651,539258,1393,478388,478116,272,13.0151676
17/03/2016 11:32,2015,1,WESTERN EUROPE-EU,IRISH REPUBLIC,2,EDINBURGH,SHANNON,1107,1025,82,31392,31392,0,-96.47362385
17/03/2016 11:32,2015,1,WESTERN EUROPE-EU,IRISH REPUBLIC,2,EXETER,DUBLIN,30875,30875,0,39378,39378,0,-21.59327543
17/03/2016 11:32,2015,1,WESTERN EUROPE-EU,IRISH REPUBLIC,2,GLASGOW,CORK,21457,21457,0,22806,22726,80,-5.915110059
17/03/2016 11:32,2015,1,WESTERN EUROPE-EU,IRISH REPUBLIC,2,GLASGOW,DONEGAL,9401,9401,0,9491,9491,0,-0.948266779
17/03/2016 11:32,2015,1,WESTERN EUROPE-EU,IRISH REPUBLIC,2,GLASGOW,DUBLIN,448820,448530,290,212005,210902,1103,111.7025542
17/03/2016 11:32,2015,1,WESTERN EUROPE-EU,IRISH REPUBLIC,2,GLASGOW,SHANNON,0,0,0,240,240,0,0
17/03/2016 11:32,2015,1,WESTERN EUROPE-EU,IRISH REPUBLIC,2,INVERNESS,DUBLIN,24469,24469,0,3601,3601,0,579.5056929
17/03/2016 11:32,2015,1,WESTERN EUROPE-EU,IRISH REPUBLIC,2,ISLE OF MAN,DUBLIN,36578,36578,0,34755,34755,0,5.245288448
17/03/2016 11:32,2015,1,WESTERN EUROPE-EU,IRISH REPUBLIC,2,JERSEY,CORK,2428,2428,0,3288,3288,0,-26.15571776
17/03/2016 11:32,2015,1,WESTERN EUROPE-EU,IRISH REPUBLIC,2,JERSEY,DUBLIN,14369,14369,0,13709,13638,71,4.814355533
17/03/2016 11:32,2015,1,WESTERN EUROPE-EU,IRISH REPUBLIC,2,LEEDS BRADFORD,DUBLIN,284308,284308,0,199590,199590,0,42.44601433
17/03/2016 11:32,2015,1,WESTERN EUROPE-EU,IRISH REPUBLIC,2,LEEDS BRADFORD,SHANNON,53,0,53,88,0,88,-39.77272727
17/03/2016 11:32,2015,1,WESTERN EUROPE-EU,IRISH REPUBLIC,2,LIVERPOOL (JOHN LENNON),CORK,77811,77811,0,79296,79296,0,-1.872730024
17/03/2016 11:32,2015,1,WESTERN EUROPE-EU,IRISH REPUBLIC,2,LIVERPOOL (JOHN LENNON),DUBLIN,335605,335605,0,276788,276650,138,21.24983742
17/03/2016 11:32,2015,1,WESTERN EUROPE-EU,IRISH REPUBLIC,2,LIVERPOOL (JOHN LENNON),IRELAND WEST(KNOCK),82429,82429,0,86359,86359,0,-4.55077062
17/03/2016 11:32,2015,1,WESTERN EUROPE-EU,IRISH REPUBLIC,2,LIVERPOOL (JOHN LENNON),SHANNON,12,0,12,27442,27428,14,-99.95627141
17/03/2016 11:32,2015,1,WESTERN EUROPE-EU,IRISH REPUBLIC,2,MANCHESTER,CORK,80479,80479,0,85516,85516,0,-5.890125824
17/03/2016 11:32,2015,1,WESTERN EUROPE-EU,IRISH REPUBLIC,2,MANCHESTER,DUBLIN,858657,856774,1883,755594,753684,1910,13.63999714
17/03/2016 11:32,2015,1,WESTERN EUROPE-EU,IRISH REPUBLIC,2,MANCHESTER,IRELAND WEST(KNOCK),26233,26233,0,27361,27361,0,-4.122656336
17/03/2016 11:32,2015,1,WESTERN EUROPE-EU,IRISH REPUBLIC,2,MANCHESTER,SHANNON,104224,104224,0,65884,65884,0,58.19318803
17/03/2016 11:32,2015,1,WESTERN EUROPE-EU,IRISH REPUBLIC,2,MANCHESTER,WATERFORD,0,0,0,11604,11604,0,0
17/03/2016 11:32,2015,1,WESTERN EUROPE-EU,IRISH REPUBLIC,2,NEWCASTLE,CORK,12891,12891,0,18312,18312,0,-29.60353866
17/03/2016 11:32,2015,1,WESTERN EUROPE-EU,IRISH REPUBLIC,2,NEWCASTLE,DUBLIN,198492,198425,67,180340,180340,0,10.06543196
17/03/2016 11:32,2015,1,WESTERN EUROPE-EU,IRISH REPUBLIC,2,NEWQUAY,DUBLIN,8291,8291,0,0,0,0,0
17/03/2016 11:32,2015,1,WESTERN EUROPE-EU,IRISH REPUBLIC,2,PRESTWICK,DUBLIN,0,0,0,99174,99174,0,0
17/03/2016 11:32,2015,1,WESTERN EUROPE-EU,IRISH REPUBLIC,2,PRESTWICK,IRELAND WEST(KNOCK),0,0,0,10424,10424,0,0
17/03/2016 11:32,2015,1,WESTERN EUROPE-EU,IRISH REPUBLIC,2,SOUTHAMPTON,DUBLIN,132217,132217,0,137798,137798,0,-4.050131352
17/03/2016 11:32,2015,1,WESTERN EUROPE-EU,IRISH REPUBLIC,2,SUMBURGH,DUBLIN,4358,0,4358,3838,0,3838,13.54872329
17/03/2016 11:32,2015,1,WESTERN EUROPE-EU,ITALY,1,GATWICK,ALGHERO (FERTILIA),9283,0,9283,8793,0,8793,5.57261458
17/03/2016 11:32,2015,1,WESTERN EUROPE-EU,ITALY,1,GATWICK,BARI (PALESE),79979,79979,0,66443,66443,0,20.37234923
17/03/2016 11:32,2015,1,WESTERN EUROPE-EU,ITALY,1,GATWICK,BERGAMO,0,0,0,152,0,152,0
17/03/2016 11:32,2015,1,WESTERN EUROPE-EU,ITALY,1,GATWICK,BOLOGNA,90775,90089,686,92875,92762,113,-2.261103634
17/03/2016 11:32,2015,1,WESTERN EUROPE-EU,ITALY,1,GATWICK,BRESCIA/MONTICHIARI,0,0,0,483,0,483,0
17/03/2016 11:32,2015,1,WESTERN EUROPE-EU,ITALY,1,GATWICK,BRINDISI,14449,14449,0,0,0,0,0
17/03/2016 11:32,2015,1,WESTERN EUROPE-EU,ITALY,1,GATWICK,CAGLIARI (ELMAS),20355,20355,0,16378,16378,0,24.28257418
17/03/2016 11:32,2015,1,WESTERN EUROPE-EU,ITALY,1,GATWICK,CATANIA (FONTANAROSSA),179054,168270,10784,179584,168870,10714,-0.295126515
17/03/2016 11:32,2015,1,WESTERN EUROPE-EU,ITALY,1,GATWICK,FLORENCE,88196,88094,102,61378,61328,50,43.69317997
17/03/2016 11:32,2015,1,WESTERN EUROPE-EU,ITALY,1,GATWICK,GENOA,93027,87020,6007,94361,80541,13820,-1.413719651
17/03/2016 11:32,2015,1,WESTERN EUROPE-EU,ITALY,1,GATWICK,MILAN (LINATE),146681,146681,0,107852,107852,0,36.00211401
17/03/2016 11:32,2015,1,WESTERN EUROPE-EU,ITALY,1,GATWICK,MILAN (MALPENSA),528232,528232,0,505694,505694,0,4.456845444
17/03/2016 11:32,2015,1,WESTERN EUROPE-EU,ITALY,1,GATWICK,NAPLES,416099,376433,39666,408573,369669,38904,1.842020887
17/03/2016 11:32,2015,1,WESTERN EUROPE-EU,ITALY,1,GATWICK,OLBIA,78789,78789,0,75264,75264,0,4.683514031
17/03/2016 11:32,2015,1,WESTERN EUROPE-EU,ITALY,1,GATWICK,PALERMO,59502,59502,0,81243,81243,0,-26.76045936
17/03/2016 11:32,2015,1,WESTERN EUROPE-EU,ITALY,1,GATWICK,PISA,213521,213242,279,252541,252541,0,-15.45095648
17/03/2016 11:32,2015,1,WESTERN EUROPE-EU,ITALY,1,GATWICK,ROME (CIAMPINO),11757,11757,0,0,0,0,0
17/03/2016 11:32,2015,1,WESTERN EUROPE-EU,ITALY,1,GATWICK,ROME (FIUMICINO),726151,725700,451,657886,653361,4525,10.3764178
17/03/2016 11:32,2015,1,WESTERN EUROPE-EU,ITALY,1,GATWICK,TURIN,148961,121317,27644,142688,122134,20554,4.396305225
17/03/2016 11:32,2015,1,WESTERN EUROPE-EU,ITALY,1,GATWICK,VENICE,657709,644180,13529,594661,574811,19850,10.60234318
17/03/2016 11:32,2015,1,WESTERN EUROPE-EU,ITALY,1,GATWICK,VERONA VILLAFRANCA,282084,262505,19579,293702,272174,21528,-3.95571021
17/03/2016 11:32,2015,1,WESTERN EUROPE-EU,ITALY,1,HEATHROW,BOLOGNA,243953,243953,0,229774,229774,0,6.170846136
17/03/2016 11:32,2015,1,WESTERN EUROPE-EU,ITALY,1,HEATHROW,CAGLIARI (ELMAS),12934,0,12934,13124,0,13124,-1.447729351
17/03/2016 11:32,2015,1,WESTERN EUROPE-EU,ITALY,1,HEATHROW,FLORENCE,0,0,0,18966,18966,0,0
17/03/2016 11:32,2015,1,WESTERN EUROPE-EU,ITALY,1,HEATHROW,MILAN (LINATE),672882,672882,0,692364,692364,0,-2.813837808
17/03/2016 11:32,2015,1,WESTERN EUROPE-EU,ITALY,1,HEATHROW,MILAN (MALPENSA),236022,236022,0,180053,180053,0,31.08473616
17/03/2016 11:32,2015,1,WESTERN EUROPE-EU,ITALY,1,HEATHROW,OLBIA,14999,9912,5087,4941,0,4941,203.562032
17/03/2016 11:32,2015,1,WESTERN EUROPE-EU,ITALY,1,HEATHROW,PISA,104601,104601,0,95512,95512,0,9.516081749
17/03/2016 11:32,2015,1,WESTERN EUROPE-EU,ITALY,1,HEATHROW,ROME (FIUMICINO),972111,968068,4043,960736,960366,370,1.183988109
17/03/2016 11:32,2015,1,WESTERN EUROPE-EU,ITALY,1,HEATHROW,VENICE,121326,119268,2058,108238,108238,0,12.09187162
17/03/2016 11:32,2015,1,WESTERN EUROPE-EU,ITALY,1,LONDON CITY,FLORENCE,95725,95725,0,72548,72548,0,31.94712466
17/03/2016 11:32,2015,1,WESTERN EUROPE-EU,ITALY,1,LONDON CITY,MILAN (LINATE),164168,164168,0,144519,144519,0,13.59613615
17/03/2016 11:32,2015,1,WESTERN EUROPE-EU,ITALY,1,LONDON CITY,ROME (CIAMPINO),85,85,0,0,0,0,0
17/03/2016 11:32,2015,1,WESTERN EUROPE-EU,ITALY,1,LONDON CITY,ROME (FIUMICINO),45779,45779,0,68351,68351,0,-33.0236573
17/03/2016 11:32,2015,1,WESTERN EUROPE-EU,ITALY,1,LONDON CITY,VENICE,15607,15607,0,17819,17819,0,-12.4137157
17/03/2016 11:32,2015,1,WESTERN EUROPE-EU,ITALY,1,LUTON,ALGHERO (FERTILIA),0,0,0,20600,20600,0,0
17/03/2016 11:32,2015,1,WESTERN EUROPE-EU,ITALY,1,LUTON,BOLOGNA,0,0,0,57,0,57,0
17/03/2016 11:32,2015,1,WESTERN EUROPE-EU,ITALY,1,LUTON,CATANIA (FONTANAROSSA),41747,41711,36,33559,33559,0,24.39881999
17/03/2016 11:32,2015,1,WESTERN EUROPE-EU,ITALY,1,LUTON,CUNEO,71,0,71,0,0,0,0
17/03/2016 11:32,2015,1,WESTERN EUROPE-EU,ITALY,1,LUTON,FLORENCE,0,0,0,12,0,12,0
17/03/2016 11:32,2015,1,WESTERN EUROPE-EU,ITALY,1,LUTON,GROSETTO,0,0,0,20,0,20,0
17/03/2016 11:32,2015,1,WESTERN EUROPE-EU,ITALY,1,LUTON,MILAN (MALPENSA),135219,134653,566,115247,115002,245,17.32973526
17/03/2016 11:32,2015,1,WESTERN EUROPE-EU,ITALY,1,LUTON,NAPLES,81108,72508,8600,24026,24026,0,237.5842837
17/03/2016 11:32,2015,1,WESTERN EUROPE-EU,ITALY,1,LUTON,OLBIA,12975,12805,170,11961,11953,8,8.477552044
17/03/2016 11:32,2015,1,WESTERN EUROPE-EU,ITALY,1,LUTON,PARMA,49,0,49,0,0,0,0
17/03/2016 11:32,2015,1,WESTERN EUROPE-EU,ITALY,1,LUTON,PISA,52240,52066,174,44966,44966,0,16.17666681
17/03/2016 11:32,2015,1,WESTERN EUROPE-EU,ITALY,1,LUTON,RIMINI,353,0,353,0,0,0,0
17/03/2016 11:32,2015,1,WESTERN EUROPE-EU,ITALY,1,LUTON,ROME (CIAMPINO),10063,9995,68,0,0,0,0
17/03/2016 11:32,2015,1,WESTERN EUROPE-EU,ITALY,1,LUTON,ROME (FIUMICINO),100941,100837,104,47808,44666,3142,111.1383032
17/03/2016 11:32,2015,1,WESTERN EUROPE-EU,ITALY,1,LUTON,TREVISO,0,0,0,293,0,293,0
17/03/2016 11:32,2015,1,WESTERN EUROPE-EU,ITALY,1,LUTON,TRIESTE (RONCHI DEI LEGIONARI),0,0,0,138,0,138,0
17/03/2016 11:32,2015,1,WESTERN EUROPE-EU,ITALY,1,LUTON,TURIN,285,0,285,0,0,0,0
17/03/2016 11:32,2015,1,WESTERN EUROPE-EU,ITALY,1,LUTON,VENICE,58904,58904,0,49624,49560,64,18.70062873
17/03/2016 11:32,2015,1,WESTERN EUROPE-EU,ITALY,1,LUTON,VERONA VILLAFRANCA,0,0,0,78,0,78,0
17/03/2016 11:32,2015,1,WESTERN EUROPE-EU,ITALY,1,SOUTHEND,ROME (CIAMPINO),188,0,188,0,0,0,0
17/03/2016 11:32,2015,1,WESTERN EUROPE-EU,ITALY,1,SOUTHEND,VENICE,54318,54318,0,53633,53633,0,1.27719874
17/03/2016 11:32,2015,1,WESTERN EUROPE-EU,ITALY,1,STANSTED,ALGHERO (FERTILIA),82963,82963,0,69728,69728,0,18.9808972
17/03/2016 11:32,2015,1,WESTERN EUROPE-EU,ITALY,1,STANSTED,ANCONA,124623,124623,0,120494,120494,0,3.426726642
17/03/2016 11:32,2015,1,WESTERN EUROPE-EU,ITALY,1,STANSTED,BARI (PALESE),122615,122615,0,85571,85571,0,43.29036706
17/03/2016 11:32,2015,1,WESTERN EUROPE-EU,ITALY,1,STANSTED,BERGAMO,495005,495005,0,437169,437169,0,13.22966633
17/03/2016 11:32,2015,1,WESTERN EUROPE-EU,ITALY,1,STANSTED,BOLOGNA,180909,180642,267,151058,151058,0,19.76128375
17/03/2016 11:32,2015,1,WESTERN EUROPE-EU,ITALY,1,STANSTED,BRINDISI,76145,76145,0,66680,66680,0,14.19466107
17/03/2016 11:32,2015,1,WESTERN EUROPE-EU,ITALY,1,STANSTED,CAGLIARI (ELMAS),79302,79302,0,76099,76099,0,4.20899092
17/03/2016 11:32,2015,1,WESTERN EUROPE-EU,ITALY,1,STANSTED,COMISO,34368,34368,0,32346,32346,0,6.25115934
17/03/2016 11:32,2015,1,WESTERN EUROPE-EU,ITALY,1,STANSTED,FLORENCE,0,0,0,33,0,33,0
17/03/2016 11:32,2015,1,WESTERN EUROPE-EU,ITALY,1,STANSTED,GENOA,84317,84317,0,80801,80461,340,4.351431294
17/03/2016 11:32,2015,1,WESTERN EUROPE-EU,ITALY,1,STANSTED,LAMETIA-TERME,54676,54676,0,54243,54243,0,0.798259683
17/03/2016 11:32,2015,1,WESTERN EUROPE-EU,ITALY,1,STANSTED,MILAN (LINATE),0,0,0,141,0,141,0
17/03/2016 11:32,2015,1,WESTERN EUROPE-EU,ITALY,1,STANSTED,MILAN (MALPENSA),16829,16829,0,25814,25814,0,-34.80669404
17/03/2016 11:32,2015,1,WESTERN EUROPE-EU,ITALY,1,STANSTED,NAPLES,163142,162852,290,167119,167119,0,-2.379741382
17/03/2016 11:32,2015,1,WESTERN EUROPE-EU,ITALY,1,STANSTED,OLBIA,3013,2308,705,0,0,0,0
17/03/2016 11:32,2015,1,WESTERN EUROPE-EU,ITALY,1,STANSTED,PALERMO,107412,107412,0,102005,102005,0,5.300720553
17/03/2016 11:32,2015,1,WESTERN EUROPE-EU,ITALY,1,STANSTED,PARMA,50491,50491,0,48298,48298,0,4.540560686
17/03/2016 11:32,2015,1,WESTERN EUROPE-EU,ITALY,1,STANSTED,PERUGIA,92396,92396,0,84879,84879,0,8.856136382
17/03/2016 11:32,2015,1,WESTERN EUROPE-EU,ITALY,1,STANSTED,PESCARA,101336,101336,0,98613,98613,0,2.76129922
17/03/2016 11:32,2015,1,WESTERN EUROPE-EU,ITALY,1,STANSTED,PISA,333111,332962,149,342953,342953,0,-2.86978099
17/03/2016 11:32,2015,1,WESTERN EUROPE-EU,ITALY,1,STANSTED,ROME (CIAMPINO),515514,515514,0,475690,475690,0,8.371838803
17/03/2016 11:32,2015,1,WESTERN EUROPE-EU,ITALY,1,STANSTED,ROME (FIUMICINO),1234,0,1234,0,0,0,0
17/03/2016 11:32,2015,1,WESTERN EUROPE-EU,ITALY,1,STANSTED,TREVISO,266219,266219,0,217417,217417,0,22.44626685
17/03/2016 11:32,2015,1,WESTERN EUROPE-EU,ITALY,1,STANSTED,TRIESTE (RONCHI DEI LEGIONARI),106900,106900,0,100909,100909,0,5.937032376
17/03/2016 11:32,2015,1,WESTERN EUROPE-EU,ITALY,1,STANSTED,TURIN,132979,127621,5358,139850,135385,4465,-4.913121201
17/03/2016 11:32,2015,1,WESTERN EUROPE-EU,ITALY,1,STANSTED,VENICE,0,0,0,57,0,57,0
17/03/2016 11:32,2015,1,WESTERN EUROPE-EU,ITALY,1,STANSTED,VERONA VILLAFRANCA,7376,7376,0,45,0,45,16291.11111
17/03/2016 11:32,2015,1,WESTERN EUROPE-EU,ITALY,2,ABERDEEN,BOLOGNA,0,0,0,66,0,66,0
17/03/2016 11:32,2015,1,WESTERN EUROPE-EU,ITALY,2,ABERDEEN,CATANIA (FONTANAROSSA),0,0,0,290,0,290,0
17/03/2016 11:32,2015,1,WESTERN EUROPE-EU,ITALY,2,ABERDEEN,NAPLES,360,0,360,589,0,589,-38.87945671
17/03/2016 11:32,2015,1,WESTERN EUROPE-EU,ITALY,2,ABERDEEN,VERONA VILLAFRANCA,348,0,348,887,0,887,-60.76662909
17/03/2016 11:32,2015,1,WESTERN EUROPE-EU,ITALY,2,BELFAST CITY (GEORGE BEST),VERONA VILLAFRANCA,9530,0,9530,10319,0,10319,-7.646089737
17/03/2016 11:32,2015,1,WESTERN EUROPE-EU,ITALY,2,BELFAST INTERNATIONAL,GENOA,0,0,0,248,0,248,0
17/03/2016 11:32,2015,1,WESTERN EUROPE-EU,ITALY,2,BELFAST INTERNATIONAL,MILAN (MALPENSA),0,0,0,46,0,46,0
17/03/2016 11:32,2015,1,WESTERN EUROPE-EU,ITALY,2,BELFAST INTERNATIONAL,PARMA,0,0,0,80,0,80,0
17/03/2016 11:32,2015,1,WESTERN EUROPE-EU,ITALY,2,BELFAST INTERNATIONAL,PISA,4666,4666,0,4968,4968,0,-6.078904992
17/03/2016 11:32,2015,1,WESTERN EUROPE-EU,ITALY,2,BELFAST INTERNATIONAL,ROME (CIAMPINO),0,0,0,149,149,0,0
17/03/2016 11:32,2015,1,WESTERN EUROPE-EU,ITALY,2,BELFAST INTERNATIONAL,ROME (FIUMICINO),14981,14938,43,46,0,46,32467.3913
17/03/2016 11:32,2015,1,WESTERN EUROPE-EU,ITALY,2,BELFAST INTERNATIONAL,TREVISO,80,0,80,69,0,69,15.94202899
17/03/2016 11:32,2015,1,WESTERN EUROPE-EU,ITALY,2,BELFAST INTERNATIONAL,VENICE,252,0,252,0,0,0,0
17/03/2016 11:32,2015,1,WESTERN EUROPE-EU,ITALY,2,BELFAST INTERNATIONAL,VERONA VILLAFRANCA,4768,4768,0,5645,5226,419,-15.53587245
17/03/2016 11:32,2015,1,WESTERN EUROPE-EU,ITALY,2,BIGGIN HILL,OLBIA,0,0,0,6,0,6,0
17/03/2016 11:32,2015,1,WESTERN EUROPE-EU,ITALY,2,BIRMINGHAM,BERGAMO,179,0,179,10760,10760,0,-98.33643123
17/03/2016 11:32,2015,1,WESTERN EUROPE-EU,ITALY,2,BIRMINGHAM,BOLOGNA,214,0,214,348,0,348,-38.50574713
17/03/2016 11:32,2015,1,WESTERN EUROPE-EU,ITALY,2,BIRMINGHAM,CAGLIARI (ELMAS),1155,0,1155,0,0,0,0
17/03/2016 11:32,2015,1,WESTERN EUROPE-EU,ITALY,2,BIRMINGHAM,CATANIA (FONTANAROSSA),6608,0,6608,6563,0,6563,0.685662045
17/03/2016 11:32,2015,1,WESTERN EUROPE-EU,ITALY,2,BIRMINGHAM,FLORENCE,5792,5792,0,32402,32402,0,-82.12456021
17/03/2016 11:32,2015,1,WESTERN EUROPE-EU,ITALY,2,BIRMINGHAM,GENOA,6219,0,6219,5771,0,5771,7.762952695
17/03/2016 11:32,2015,1,WESTERN EUROPE-EU,ITALY,2,BIRMINGHAM,MILAN (MALPENSA),85953,85953,0,71907,71707,200,19.53356419
17/03/2016 11:32,2015,1,WESTERN EUROPE-EU,ITALY,2,BIRMINGHAM,NAPLES,21346,0,21346,21161,0,21161,0.874249799
17/03/2016 11:32,2015,1,WESTERN EUROPE-EU,ITALY,2,BIRMINGHAM,PARMA,0,0,0,83,0,83,0
17/03/2016 11:32,2015,1,WESTERN EUROPE-EU,ITALY,2,BIRMINGHAM,RIMINI,150,0,150,0,0,0,0
17/03/2016 11:32,2015,1,WESTERN EUROPE-EU,ITALY,2,BIRMINGHAM,ROME (FIUMICINO),67075,65501,1574,78577,75682,2895,-14.63787113
17/03/2016 11:32,2015,1,WESTERN EUROPE-EU,ITALY,2,BIRMINGHAM,TREVISO,117,0,117,0,0,0,0
17/03/2016 11:32,2015,1,WESTERN EUROPE-EU,ITALY,2,BIRMINGHAM,TRIESTE (RONCHI DEI LEGIONARI),0,0,0,9275,9275,0,0
17/03/2016 11:32,2015,1,WESTERN EUROPE-EU,ITALY,2,BIRMINGHAM,TURIN,13229,4558,8671,9583,557,9026,38.04654075
17/03/2016 11:32,2015,1,WESTERN EUROPE-EU,ITALY,2,BIRMINGHAM,VENICE,48875,42618,6257,38334,32968,5366,27.49778265
17/03/2016 11:32,2015,1,WESTERN EUROPE-EU,ITALY,2,BIRMINGHAM,VERONA VILLAFRANCA,14274,0,14274,13044,0,13044,9.429622815
17/03/2016 11:32,2015,1,WESTERN EUROPE-EU,ITALY,2,BLACKPOOL,MILAN (MALPENSA),0,0,0,1,0,1,0
17/03/2016 11:32,2015,1,WESTERN EUROPE-EU,ITALY,2,BOURNEMOUTH,CATANIA (FONTANAROSSA),0,0,0,292,0,292,0
17/03/2016 11:32,2015,1,WESTERN EUROPE-EU,ITALY,2,BOURNEMOUTH,GENOA,931,0,931,588,0,588,58.33333333
17/03/2016 11:32,2015,1,WESTERN EUROPE-EU,ITALY,2,BOURNEMOUTH,MILAN (MALPENSA),63,0,63,0,0,0,0
17/03/2016 11:32,2015,1,WESTERN EUROPE-EU,ITALY,2,BOURNEMOUTH,NAPLES,495,0,495,870,0,870,-43.10344828
17/03/2016 11:32,2015,1,WESTERN EUROPE-EU,ITALY,2,BOURNEMOUTH,PISA,0,0,0,15696,15696,0,0
17/03/2016 11:32,2015,1,WESTERN EUROPE-EU,ITALY,2,BOURNEMOUTH,ROME (CIAMPINO),288,0,288,0,0,0,0
17/03/2016 11:32,2015,1,WESTERN EUROPE-EU,ITALY,2,BOURNEMOUTH,ROME (FIUMICINO),0,0,0,865,0,865,0
17/03/2016 11:32,2015,1,WESTERN EUROPE-EU,ITALY,2,BOURNEMOUTH,TURIN,3522,0,3522,3753,0,3753,-6.155075939
17/03/2016 11:32,2015,1,WESTERN EUROPE-EU,ITALY,2,BOURNEMOUTH,VERONA VILLAFRANCA,159,0,159,969,0,969,-83.59133127
17/03/2016 11:32,2015,1,WESTERN EUROPE-EU,ITALY,2,BRISTOL,BERGAMO,33052,33052,0,26987,26987,0,22.47378367
17/03/2016 11:32,2015,1,WESTERN EUROPE-EU,ITALY,2,BRISTOL,BOLOGNA,19682,19682,0,18099,18099,0,8.746339577
17/03/2016 11:32,2015,1,WESTERN EUROPE-EU,ITALY,2,BRISTOL,CATANIA (FONTANAROSSA),12211,12211,0,0,0,0,0
17/03/2016 11:32,2015,1,WESTERN EUROPE-EU,ITALY,2,BRISTOL,MILAN (MALPENSA),7698,7698,0,16354,13943,2411,-52.92894705
17/03/2016 11:32,2015,1,WESTERN EUROPE-EU,ITALY,2,BRISTOL,NAPLES,34924,13819,21105,34048,14258,19790,2.572838346
17/03/2016 11:32,2015,1,WESTERN EUROPE-EU,ITALY,2,BRISTOL,OLBIA,11504,11504,0,9629,9629,0,19.47242704
17/03/2016 11:32,2015,1,WESTERN EUROPE-EU,ITALY,2,BRISTOL,PISA,43186,42702,484,46664,46664,0,-7.453283045
17/03/2016 11:32,2015,1,WESTERN EUROPE-EU,ITALY,2,BRISTOL,ROME (CIAMPINO),17970,17886,84,0,0,0,0
17/03/2016 11:32,2015,1,WESTERN EUROPE-EU,ITALY,2,BRISTOL,ROME (FIUMICINO),88193,88193,0,107364,107364,0,-17.85607839
17/03/2016 11:32,2015,1,WESTERN EUROPE-EU,ITALY,2,BRISTOL,TREVISO,22974,22974,0,20538,20538,0,11.8609407
17/03/2016 11:32,2015,1,WESTERN EUROPE-EU,ITALY,2,BRISTOL,TURIN,4514,0,4514,4755,0,4755,-5.068349106
17/03/2016 11:32,2015,1,WESTERN EUROPE-EU,ITALY,2,BRISTOL,VERONA VILLAFRANCA,8376,0,8376,10131,0,10131,-17.32306781
17/03/2016 11:32,2015,1,WESTERN EUROPE-EU,ITALY,2,CAMBRIDGE,ANCONA,71,0,71,0,0,0,0
17/03/2016 11:32,2015,1,WESTERN EUROPE-EU,ITALY,2,CAMBRIDGE,MILAN (MALPENSA),0,0,0,339,339,0,0
17/03/2016 11:32,2015,1,WESTERN EUROPE-EU,ITALY,2,CAMBRIDGE,VERONA VILLAFRANCA,842,0,842,1053,0,1053,-20.0379867
17/03/2016 11:32,2015,1,WESTERN EUROPE-EU,ITALY,2,CARDIFF WALES,BOLOGNA,0,0,0,84,0,84,0
17/03/2016 11:32,2015,1,WESTERN EUROPE-EU,ITALY,2,CARDIFF WALES,BRESCIA/MONTICHIARI,79,0,79,0,0,0,0
17/03/2016 11:32,2015,1,WESTERN EUROPE-EU,ITALY,2,CARDIFF WALES,FLORENCE,0,0,0,51,0,51,0
17/03/2016 11:32,2015,1,WESTERN EUROPE-EU,ITALY,2,CARDIFF WALES,GENOA,310,0,310,1010,0,1010,-69.30693069
17/03/2016 11:32,2015,1,WESTERN EUROPE-EU,ITALY,2,CARDIFF WALES,MILAN (MALPENSA),7502,7502,0,0,0,0,0
17/03/2016 11:32,2015,1,WESTERN EUROPE-EU,ITALY,2,CARDIFF WALES,NAPLES,644,0,644,1030,0,1030,-37.47572816
17/03/2016 11:32,2015,1,WESTERN EUROPE-EU,ITALY,2,CARDIFF WALES,PARMA,313,0,313,248,0,248,26.20967742
17/03/2016 11:32,2015,1,WESTERN EUROPE-EU,ITALY,2,CARDIFF WALES,ROME (FIUMICINO),3196,0,3196,165,0,165,1836.969697
17/03/2016 11:32,2015,1,WESTERN EUROPE-EU,ITALY,2,CARDIFF WALES,TREVISO,205,0,205,74,0,74,177.027027
17/03/2016 11:32,2015,1,WESTERN EUROPE-EU,ITALY,2,CARDIFF WALES,VENICE,1107,0,1107,0,0,0,0
17/03/2016 11:32,2015,1,WESTERN EUROPE-EU,ITALY,2,CARDIFF WALES,VERONA VILLAFRANCA,360,0,360,580,0,580,-37.93103448
17/03/2016 11:32,2015,1,WESTERN EUROPE-EU,ITALY,2,DONCASTER SHEFFIELD,TURIN,3266,0,3266,3372,0,3372,-3.143534994
17/03/2016 11:32,2015,1,WESTERN EUROPE-EU,ITALY,2,DONCASTER SHEFFIELD,VERONA VILLAFRANCA,348,0,348,0,0,0,0
17/03/2016 11:32,2015,1,WESTERN EUROPE-EU,ITALY,2,DURHAM TEES VALLEY,NAPLES,320,0,320,0,0,0,0
17/03/2016 11:32,2015,1,WESTERN EUROPE-EU,ITALY,2,DURHAM TEES VALLEY,TURIN,72,0,72,0,0,0,0
17/03/2016 11:32,2015,1,WESTERN EUROPE-EU,ITALY,2,DURHAM TEES VALLEY,VERONA VILLAFRANCA,704,0,704,582,0,582,20.96219931
17/03/2016 11:32,2015,1,WESTERN EUROPE-EU,ITALY,2,EAST MIDLANDS INTERNATIONAL,BERGAMO,52079,52079,0,42329,42329,0,23.03385386
17/03/2016 11:32,2015,1,WESTERN EUROPE-EU,ITALY,2,EAST MIDLANDS INTERNATIONAL,BRESCIA/MONTICHIARI,0,0,0,242,0,242,0
17/03/2016 11:32,2015,1,WESTERN EUROPE-EU,ITALY,2,EAST MIDLANDS INTERNATIONAL,GENOA,550,0,550,520,0,520,5.769230769
17/03/2016 11:32,2015,1,WESTERN EUROPE-EU,ITALY,2,EAST MIDLANDS INTERNATIONAL,MILAN (MALPENSA),590,0,590,2999,2999,0,-80.32677559
17/03/2016 11:32,2015,1,WESTERN EUROPE-EU,ITALY,2,EAST MIDLANDS INTERNATIONAL,NAPLES,16937,0,16937,17165,0,17165,-1.328284299
17/03/2016 11:32,2015,1,WESTERN EUROPE-EU,ITALY,2,EAST MIDLANDS INTERNATIONAL,PISA,26087,26087,0,22653,22653,0,15.15914007
17/03/2016 11:32,2015,1,WESTERN EUROPE-EU,ITALY,2,EAST MIDLANDS INTERNATIONAL,ROME (CIAMPINO),32282,32282,0,40670,40670,0,-20.62453897
17/03/2016 11:32,2015,1,WESTERN EUROPE-EU,ITALY,2,EAST MIDLANDS INTERNATIONAL,TREVISO,55556,55556,0,47328,47328,0,17.38505747
17/03/2016 11:32,2015,1,WESTERN EUROPE-EU,ITALY,2,EAST MIDLANDS INTERNATIONAL,VENICE,706,0,706,0,0,0,0
17/03/2016 11:32,2015,1,WESTERN EUROPE-EU,ITALY,2,EDINBURGH,BOLOGNA,21285,21285,0,16470,16470,0,29.23497268
17/03/2016 11:32,2015,1,WESTERN EUROPE-EU,ITALY,2,EDINBURGH,GENOA,547,0,547,0,0,0,0
17/03/2016 11:32,2015,1,WESTERN EUROPE-EU,ITALY,2,EDINBURGH,MILAN (MALPENSA),113892,113611,281,112101,110757,1344,1.59766639
17/03/2016 11:32,2015,1,WESTERN EUROPE-EU,ITALY,2,EDINBURGH,NAPLES,20951,20951,0,16102,16102,0,30.11427152
17/03/2016 11:32,2015,1,WESTERN EUROPE-EU,ITALY,2,EDINBURGH,PISA,34290,34290,0,30912,30912,0,10.92779503
17/03/2016 11:32,2015,1,WESTERN EUROPE-EU,ITALY,2,EDINBURGH,ROME (CIAMPINO),68014,68014,0,59168,59168,0,14.950649
17/03/2016 11:32,2015,1,WESTERN EUROPE-EU,ITALY,2,EDINBURGH,ROME (FIUMICINO),1566,0,1566,2682,0,2682,-41.61073826
17/03/2016 11:32,2015,1,WESTERN EUROPE-EU,ITALY,2,EDINBURGH,TURIN,0,0,0,423,0,423,0
17/03/2016 11:32,2015,1,WESTERN EUROPE-EU,ITALY,2,EDINBURGH,VENICE,30606,29556,1050,30023,30023,0,1.941844586
17/03/2016 11:32,2015,1,WESTERN EUROPE-EU,ITALY,2,EDINBURGH,VERONA VILLAFRANCA,9983,9983,0,7933,5164,2769,25.84142191
17/03/2016 11:32,2015,1,WESTERN EUROPE-EU,ITALY,2,EXETER,CATANIA (FONTANAROSSA),0,0,0,288,0,288,0
17/03/2016 11:32,2015,1,WESTERN EUROPE-EU,ITALY,2,EXETER,NAPLES,356,0,356,570,0,570,-37.54385965
17/03/2016 11:32,2015,1,WESTERN EUROPE-EU,ITALY,2,EXETER,VERONA VILLAFRANCA,712,0,712,1166,0,1166,-38.93653516
17/03/2016 11:32,2015,1,WESTERN EUROPE-EU,ITALY,2,GLASGOW,BERGAMO,1074,0,1074,0,0,0,0
17/03/2016 11:32,2015,1,WESTERN EUROPE-EU,ITALY,2,GLASGOW,BOLOGNA,88,0,88,0,0,0,0
17/03/2016 11:32,2015,1,WESTERN EUROPE-EU,ITALY,2,GLASGOW,GENOA,1409,0,1409,536,0,536,162.8731343
17/03/2016 11:32,2015,1,WESTERN EUROPE-EU,ITALY,2,GLASGOW,MILAN (MALPENSA),4733,1889,2844,0,0,0,0
17/03/2016 11:32,2015,1,WESTERN EUROPE-EU,ITALY,2,GLASGOW,NAPLES,12601,0,12601,12612,0,12612,-0.087218522
17/03/2016 11:32,2015,1,WESTERN EUROPE-EU,ITALY,2,GLASGOW,PARMA,91,0,91,0,0,0,0
17/03/2016 11:32,2015,1,WESTERN EUROPE-EU,ITALY,2,GLASGOW,ROME (FIUMICINO),19313,19313,0,20965,20563,402,-7.879799666
17/03/2016 11:32,2015,1,WESTERN EUROPE-EU,ITALY,2,GLASGOW,TRIESTE (RONCHI DEI LEGIONARI),0,0,0,98,0,98,0
17/03/2016 11:32,2015,1,WESTERN EUROPE-EU,ITALY,2,GLASGOW,TURIN,6204,0,6204,5958,0,5958,4.128902316
17/03/2016 11:32,2015,1,WESTERN EUROPE-EU,ITALY,2,GLASGOW,VENICE,3622,0,3622,7323,0,7323,-50.53939642
17/03/2016 11:32,2015,1,WESTERN EUROPE-EU,ITALY,2,GLASGOW,VERONA VILLAFRANCA,13535,0,13535,15238,0,15238,-11.17600735
17/03/2016 11:32,2015,1,WESTERN EUROPE-EU,ITALY,2,HUMBERSIDE,NAPLES,711,0,711,560,0,560,26.96428571
17/03/2016 11:32,2015,1,WESTERN EUROPE-EU,ITALY,2,HUMBERSIDE,ROME (FIUMICINO),88,0,88,0,0,0,0
17/03/2016 11:32,2015,1,WESTERN EUROPE-EU,ITALY,2,HUMBERSIDE,TURIN,8,0,8,0,0,0,0
17/03/2016 11:32,2015,1,WESTERN EUROPE-EU,ITALY,2,HUMBERSIDE,VENICE,330,0,330,194,0,194,70.10309278
17/03/2016 11:32,2015,1,WESTERN EUROPE-EU,ITALY,2,HUMBERSIDE,VERONA VILLAFRANCA,352,0,352,873,0,873,-59.6792669
17/03/2016 11:32,2015,1,WESTERN EUROPE-EU,ITALY,2,INVERNESS,NAPLES,0,0,0,294,0,294,0
17/03/2016 11:32,2015,1,WESTERN EUROPE-EU,ITALY,2,INVERNESS,VERONA VILLAFRANCA,357,0,357,583,0,583,-38.76500858
17/03/2016 11:32,2015,1,WESTERN EUROPE-EU,ITALY,2,ISLE OF MAN,MILAN (MALPENSA),0,0,0,250,0,250,0
17/03/2016 11:32,2015,1,WESTERN EUROPE-EU,ITALY,2,ISLE OF MAN,NAPLES,342,0,342,0,0,0,0
17/03/2016 11:32,2015,1,WESTERN EUROPE-EU,ITALY,2,JERSEY,CATANIA (FONTANAROSSA),0,0,0,282,0,282,0
17/03/2016 11:32,2015,1,WESTERN EUROPE-EU,ITALY,2,JERSEY,NAPLES,334,0,334,0,0,0,0
17/03/2016 11:32,2015,1,WESTERN EUROPE-EU,ITALY,2,JERSEY,VERONA VILLAFRANCA,357,0,357,0,0,0,0
17/03/2016 11:32,2015,1,WESTERN EUROPE-EU,ITALY,2,LEEDS BRADFORD,BERGAMO,0,0,0,17401,17401,0,0
17/03/2016 11:32,2015,1,WESTERN EUROPE-EU,ITALY,2,LEEDS BRADFORD,MILAN (MALPENSA),0,0,0,1530,1530,0,0
17/03/2016 11:32,2015,1,WESTERN EUROPE-EU,ITALY,2,LEEDS BRADFORD,NAPLES,15688,15688,0,0,0,0,0
17/03/2016 11:32,2015,1,WESTERN EUROPE-EU,ITALY,2,LEEDS BRADFORD,OLBIA,0,0,0,4691,4691,0,0
17/03/2016 11:32,2015,1,WESTERN EUROPE-EU,ITALY,2,LEEDS BRADFORD,PISA,13517,13517,0,27888,27888,0,-51.5311245
17/03/2016 11:32,2015,1,WESTERN EUROPE-EU,ITALY,2,LEEDS BRADFORD,ROME (CIAMPINO),421,421,0,0,0,0,0
17/03/2016 11:32,2015,1,WESTERN EUROPE-EU,ITALY,2,LEEDS BRADFORD,ROME (FIUMICINO),28606,28057,549,38181,37360,821,-25.07791834
17/03/2016 11:32,2015,1,WESTERN EUROPE-EU,ITALY,2,LEEDS BRADFORD,TREVISO,22666,22666,0,17562,17562,0,29.06274912
17/03/2016 11:32,2015,1,WESTERN EUROPE-EU,ITALY,2,LEEDS BRADFORD,VENICE,16629,16629,0,15995,15995,0,3.963738668
17/03/2016 11:32,2015,1,WESTERN EUROPE-EU,ITALY,2,LEEDS BRADFORD,VERONA VILLAFRANCA,5383,5383,0,4831,4831,0,11.42620575
17/03/2016 11:32,2015,1,WESTERN EUROPE-EU,ITALY,2,LIVERPOOL (JOHN LENNON),NAPLES,32662,32662,0,33274,33274,0,-1.839273908
17/03/2016 11:32,2015,1,WESTERN EUROPE-EU,ITALY,2,LIVERPOOL (JOHN LENNON),PISA,21828,21828,0,18582,18582,0,17.46851792
17/03/2016 11:32,2015,1,WESTERN EUROPE-EU,ITALY,2,LIVERPOOL (JOHN LENNON),VERONA VILLAFRANCA,314,0,314,0,0,0,0
17/03/2016 11:32,2015,1,WESTERN EUROPE-EU,ITALY,2,LYDD,NAPLES,0,0,0,237,0,237,0
17/03/2016 11:32,2015,1,WESTERN EUROPE-EU,ITALY,2,LYDD,VERONA VILLAFRANCA,0,0,0,426,0,426,0
17/03/2016 11:32,2015,1,WESTERN EUROPE-EU,ITALY,2,MANCHESTER,ALGHERO (FERTILIA),7702,0,7702,0,0,0,0
17/03/2016 11:32,2015,1,WESTERN EUROPE-EU,ITALY,2,MANCHESTER,BERGAMO,147172,146882,290,118225,118225,0,24.48466906
17/03/2016 11:32,2015,1,WESTERN EUROPE-EU,ITALY,2,MANCHESTER,BOLOGNA,32826,32826,0,30909,30891,18,6.202077065
17/03/2016 11:32,2015,1,WESTERN EUROPE-EU,ITALY,2,MANCHESTER,CATANIA (FONTANAROSSA),38581,27477,11104,28782,17712,11070,34.04558405
17/03/2016 11:32,2015,1,WESTERN EUROPE-EU,ITALY,2,MANCHESTER,GENOA,18853,0,18853,23475,0,23475,-19.68903088
17/03/2016 11:32,2015,1,WESTERN EUROPE-EU,ITALY,2,MANCHESTER,MILAN (MALPENSA),62763,62763,0,59164,59164,0,6.083091069
17/03/2016 11:32,2015,1,WESTERN EUROPE-EU,ITALY,2,MANCHESTER,NAPLES,80052,28822,51230,63294,15815,47479,26.47644326
17/03/2016 11:32,2015,1,WESTERN EUROPE-EU,ITALY,2,MANCHESTER,PISA,55839,55691,148,42090,42090,0,32.66571632
17/03/2016 11:32,2015,1,WESTERN EUROPE-EU,ITALY,2,MANCHESTER,ROME (CIAMPINO),124938,124938,0,110004,110004,0,13.57586997
17/03/2016 11:32,2015,1,WESTERN EUROPE-EU,ITALY,2,MANCHESTER,ROME (FIUMICINO),86162,83163,2999,92558,88961,3597,-6.910261674
17/03/2016 11:32,2015,1,WESTERN EUROPE-EU,ITALY,2,MANCHESTER,TRAPANI,0,0,0,17949,17949,0,0
17/03/2016 11:32,2015,1,WESTERN EUROPE-EU,ITALY,2,MANCHESTER,TURIN,24125,4620,19505,19652,440,19212,22.76104213
17/03/2016 11:32,2015,1,WESTERN EUROPE-EU,ITALY,2,MANCHESTER,VENICE,176656,150464,26192,162469,131955,30514,8.73212736
17/03/2016 11:32,2015,1,WESTERN EUROPE-EU,ITALY,2,MANCHESTER,VERONA VILLAFRANCA,60161,30875,29286,64461,34077,30384,-6.670700113
17/03/2016 11:32,2015,1,WESTERN EUROPE-EU,ITALY,2,NEWCASTLE,GENOA,548,0,548,870,0,870,-37.01149425
17/03/2016 11:32,2015,1,WESTERN EUROPE-EU,ITALY,2,NEWCASTLE,MILAN (MALPENSA),6,0,6,0,0,0,0
17/03/2016 11:32,2015,1,WESTERN EUROPE-EU,ITALY,2,NEWCASTLE,NAPLES,9537,0,9537,9424,0,9424,1.199066214
17/03/2016 11:32,2015,1,WESTERN EUROPE-EU,ITALY,2,NEWCASTLE,PISA,9581,9581,0,10574,10574,0,-9.390958956
17/03/2016 11:32,2015,1,WESTERN EUROPE-EU,ITALY,2,NEWCASTLE,ROME (FIUMICINO),16832,16832,0,16973,16973,0,-0.830731161
17/03/2016 11:32,2015,1,WESTERN EUROPE-EU,ITALY,2,NEWCASTLE,TURIN,3313,0,3313,3430,0,3430,-3.411078717
17/03/2016 11:32,2015,1,WESTERN EUROPE-EU,ITALY,2,NEWCASTLE,VENICE,790,0,790,15591,15591,0,-94.93297415
17/03/2016 11:32,2015,1,WESTERN EUROPE-EU,ITALY,2,NEWCASTLE,VERONA VILLAFRANCA,11952,0,11952,12974,0,12974,-7.877293048
17/03/2016 11:32,2015,1,WESTERN EUROPE-EU,ITALY,2,NEWQUAY,CAGLIARI (ELMAS),0,0,0,248,0,248,0
17/03/2016 11:32,2015,1,WESTERN EUROPE-EU,ITALY,2,NEWQUAY,NAPLES,0,0,0,250,0,250,0
17/03/2016 11:32,2015,1,WESTERN EUROPE-EU,ITALY,2,NEWQUAY,VERONA VILLAFRANCA,350,0,350,586,0,586,-40.27303754
17/03/2016 11:32,2015,1,WESTERN EUROPE-EU,ITALY,2,NORWICH,CATANIA (FONTANAROSSA),0,0,0,294,0,294,0
17/03/2016 11:32,2015,1,WESTERN EUROPE-EU,ITALY,2,NORWICH,NAPLES,708,0,708,879,0,879,-19.45392491
17/03/2016 11:32,2015,1,WESTERN EUROPE-EU,ITALY,2,NORWICH,TURIN,0,0,0,42,0,42,0
17/03/2016 11:32,2015,1,WESTERN EUROPE-EU,ITALY,2,NORWICH,VERONA VILLAFRANCA,354,0,354,1435,0,1435,-75.33101045
17/03/2016 11:32,2015,1,WESTERN EUROPE-EU,ITALY,2,PRESTWICK,PISA,12004,12004,0,14685,14685,0,-18.25672455
17/03/2016 11:32,2015,1,WESTERN EUROPE-EU,ITALY,2,PRESTWICK,ROME (CIAMPINO),22135,22135,0,20299,20299,0,9.044780531
17/03/2016 11:32,2015,1,WESTERN EUROPE-EU,ITALY,2,SOUTHAMPTON,MILAN (MALPENSA),3982,3982,0,0,0,0,0
17/03/2016 11:32,2015,1,WESTERN EUROPE-EU,ITALY,2,SOUTHAMPTON,TRIESTE (RONCHI DEI LEGIONARI),149,0,149,0,0,0,0
17/03/2016 11:32,2015,1,WESTERN EUROPE-EU,ITALY,2,SOUTHAMPTON,VERONA VILLAFRANCA,6491,6491,0,6738,6738,0,-3.665776195
17/03/2016 11:32,2015,1,WESTERN EUROPE-EU,LUXEMBOURG,1,GATWICK,LUXEMBOURG,61460,61460,0,70482,70482,0,-12.80043132
17/03/2016 11:32,2015,1,WESTERN EUROPE-EU,LUXEMBOURG,1,HEATHROW,LUXEMBOURG,145659,145659,0,132671,132671,0,9.789629987
17/03/2016 11:32,2015,1,WESTERN EUROPE-EU,LUXEMBOURG,1,LONDON CITY,LUXEMBOURG,186941,186913,28,179014,179014,0,4.428145285
17/03/2016 11:32,2015,1,WESTERN EUROPE-EU,LUXEMBOURG,1,LUTON,LUXEMBOURG,0,0,0,33,0,33,0
17/03/2016 11:32,2015,1,WESTERN EUROPE-EU,LUXEMBOURG,1,STANSTED,LUXEMBOURG,1134,1134,0,289,0,289,292.3875433
17/03/2016 11:32,2015,1,WESTERN EUROPE-EU,LUXEMBOURG,2,CARDIFF WALES,LUXEMBOURG,0,0,0,38,0,38,0
17/03/2016 11:32,2015,1,WESTERN EUROPE-EU,LUXEMBOURG,2,GLASGOW,LUXEMBOURG,0,0,0,94,0,94,0
17/03/2016 11:32,2015,1,WESTERN EUROPE-EU,LUXEMBOURG,2,JERSEY,LUXEMBOURG,229,0,229,152,152,0,50.65789474
17/03/2016 11:32,2015,1,WESTERN EUROPE-EU,LUXEMBOURG,2,PRESTWICK,LUXEMBOURG,1,1,0,0,0,0,0
17/03/2016 11:32,2015,1,WESTERN EUROPE-EU,MALTA,1,GATWICK,MALTA,341116,317514,23602,334234,304785,29449,2.059036483
17/03/2016 11:32,2015,1,WESTERN EUROPE-EU,MALTA,1,HEATHROW,MALTA,189409,189409,0,186935,186935,0,1.323454677
17/03/2016 11:32,2015,1,WESTERN EUROPE-EU,MALTA,1,LUTON,MALTA,116114,116100,14,106338,106319,19,9.193326939
17/03/2016 11:32,2015,1,WESTERN EUROPE-EU,MALTA,1,STANSTED,MALTA,68195,67906,289,61809,61809,0,10.3318287
17/03/2016 11:32,2015,1,WESTERN EUROPE-EU,MALTA,2,BELFAST INTERNATIONAL,MALTA,22963,22963,0,27624,27624,0,-16.87300898
17/03/2016 11:32,2015,1,WESTERN EUROPE-EU,MALTA,2,BIRMINGHAM,MALTA,50954,36923,14031,48697,40280,8417,4.63478243
17/03/2016 11:32,2015,1,WESTERN EUROPE-EU,MALTA,2,BOURNEMOUTH,MALTA,21561,21561,0,18206,18206,0,18.42799077
17/03/2016 11:32,2015,1,WESTERN EUROPE-EU,MALTA,2,BRISTOL,MALTA,57395,49563,7832,57338,48628,8710,0.099410513
17/03/2016 11:32,2015,1,WESTERN EUROPE-EU,MALTA,2,CARDIFF WALES,MALTA,7143,0,7143,7247,0,7247,-1.435076583
17/03/2016 11:32,2015,1,WESTERN EUROPE-EU,MALTA,2,EAST MIDLANDS INTERNATIONAL,MALTA,37476,37476,0,31954,31954,0,17.28109157
17/03/2016 11:32,2015,1,WESTERN EUROPE-EU,MALTA,2,EDINBURGH,MALTA,50108,50108,0,49179,49179,0,1.88901767
17/03/2016 11:32,2015,1,WESTERN EUROPE-EU,MALTA,2,EXETER,MALTA,7011,0,7011,6882,0,6882,1.8744551
17/03/2016 11:32,2015,1,WESTERN EUROPE-EU,MALTA,2,GLASGOW,MALTA,13990,7404,6586,7994,15,7979,75.00625469
17/03/2016 11:32,2015,1,WESTERN EUROPE-EU,MALTA,2,ISLE OF MAN,MALTA,279,0,279,281,0,281,-0.711743772
17/03/2016 11:32,2015,1,WESTERN EUROPE-EU,MALTA,2,LEEDS BRADFORD,MALTA,43880,43880,0,37064,37064,0,18.38981222
17/03/2016 11:32,2015,1,WESTERN EUROPE-EU,MALTA,2,LIVERPOOL (JOHN LENNON),MALTA,37051,37051,0,35578,35578,0,4.140198999
17/03/2016 11:32,2015,1,WESTERN EUROPE-EU,MALTA,2,MANCHESTER,MALTA,166309,141239,25070,160721,132049,28672,3.476832523
17/03/2016 11:32,2015,1,WESTERN EUROPE-EU,MALTA,2,NEWCASTLE,MALTA,41936,36230,5706,36961,30553,6408,13.46013365
17/03/2016 11:32,2015,1,WESTERN EUROPE-EU,MALTA,2,NORWICH,MALTA,5815,0,5815,6008,0,6008,-3.212383489
17/03/2016 11:32,2015,1,WESTERN EUROPE-EU,MALTA,2,PRESTWICK,MALTA,10697,10697,0,9970,9970,0,7.291875627
17/03/2016 11:32,2015,1,WESTERN EUROPE-EU,NETHERLANDS,1,GATWICK,AMSTERDAM,977713,976835,878,848996,848760,236,15.16108439
17/03/2016 11:32,2015,1,WESTERN EUROPE-EU,NETHERLANDS,1,HEATHROW,AMSTERDAM,1587605,1587605,0,1486995,1486995,0,6.765994506
17/03/2016 11:32,2015,1,WESTERN EUROPE-EU,NETHERLANDS,1,HEATHROW,EINDHOVEN,2,0,2,0,0,0,0
17/03/2016 11:32,2015,1,WESTERN EUROPE-EU,NETHERLANDS,1,HEATHROW,ROTTERDAM,22285,22285,0,113919,113919,0,-80.43785497
17/03/2016 11:32,2015,1,WESTERN EUROPE-EU,NETHERLANDS,1,LONDON CITY,AMSTERDAM,488104,488104,0,416824,416824,0,17.10074276
17/03/2016 11:32,2015,1,WESTERN EUROPE-EU,NETHERLANDS,1,LONDON CITY,ROTTERDAM,208725,208725,0,158981,158981,0,31.28927356
17/03/2016 11:32,2015,1,WESTERN EUROPE-EU,NETHERLANDS,1,LUTON,AMSTERDAM,418006,417643,363,378991,378298,693,10.29443971
17/03/2016 11:32,2015,1,WESTERN EUROPE-EU,NETHERLANDS,1,LUTON,MAASTRICHT,121,0,121,98,0,98,23.46938776
17/03/2016 11:32,2015,1,WESTERN EUROPE-EU,NETHERLANDS,1,LUTON,ROTTERDAM,10,0,10,0,0,0,0
17/03/2016 11:32,2015,1,WESTERN EUROPE-EU,NETHERLANDS,1,SOUTHEND,AMSTERDAM,214462,214462,0,200306,200306,0,7.067187204
17/03/2016 11:32,2015,1,WESTERN EUROPE-EU,NETHERLANDS,1,SOUTHEND,GRONINGEN,21505,21505,0,12766,12766,0,68.45527182
17/03/2016 11:32,2015,1,WESTERN EUROPE-EU,NETHERLANDS,1,SOUTHEND,MAASTRICHT,205,205,0,4399,4399,0,-95.33984997
17/03/2016 11:32,2015,1,WESTERN EUROPE-EU,NETHERLANDS,1,STANSTED,AMSTERDAM,300571,299953,618,279382,279028,354,7.5842395
17/03/2016 11:32,2015,1,WESTERN EUROPE-EU,NETHERLANDS,1,STANSTED,EINDHOVEN,242424,242424,0,251570,251570,0,-3.635568629
17/03/2016 11:32,2015,1,WESTERN EUROPE-EU,NETHERLANDS,1,STANSTED,MAASTRICHT,0,0,0,7762,7762,0,0
17/03/2016 11:32,2015,1,WESTERN EUROPE-EU,NETHERLANDS,2,ABERDEEN,AMSTERDAM,306004,305921,83,307131,307024,107,-0.366944398
17/03/2016 11:32,2015,1,WESTERN EUROPE-EU,NETHERLANDS,2,ABERDEEN,GRONINGEN,0,0,0,374,0,374,0
17/03/2016 11:32,2015,1,WESTERN EUROPE-EU,NETHERLANDS,2,ABERDEEN,MAASTRICHT,60,0,60,0,0,0,0
17/03/2016 11:32,2015,1,WESTERN EUROPE-EU,NETHERLANDS,2,ABERDEEN,ROTTERDAM,357,0,357,0,0,0,0
17/03/2016 11:32,2015,1,WESTERN EUROPE-EU,NETHERLANDS,2,BELFAST CITY (GEORGE BEST),AMSTERDAM,26084,26084,0,0,0,0,0
17/03/2016 11:32,2015,1,WESTERN EUROPE-EU,NETHERLANDS,2,BELFAST CITY (GEORGE BEST),MAASTRICHT,64,0,64,73,0,73,-12.32876712
17/03/2016 11:32,2015,1,WESTERN EUROPE-EU,NETHERLANDS,2,BELFAST INTERNATIONAL,AMSTERDAM,101894,101833,61,97381,97381,0,4.634374262
17/03/2016 11:32,2015,1,WESTERN EUROPE-EU,NETHERLANDS,2,BELFAST INTERNATIONAL,ROTTERDAM,0,0,0,41,0,41,0
17/03/2016 11:32,2015,1,WESTERN EUROPE-EU,NETHERLANDS,2,BIGGIN HILL,ROTTERDAM,128,0,128,144,0,144,-11.11111111
17/03/2016 11:32,2015,1,WESTERN EUROPE-EU,NETHERLANDS,2,BIRMINGHAM,AMSTERDAM,563915,563915,0,507396,507232,164,11.13903145
17/03/2016 11:32,2015,1,WESTERN EUROPE-EU,NETHERLANDS,2,BIRMINGHAM,GRONINGEN,0,0,0,79,0,79,0
17/03/2016 11:32,2015,1,WESTERN EUROPE-EU,NETHERLANDS,2,BIRMINGHAM,MAASTRICHT,65,0,65,75,0,75,-13.33333333
17/03/2016 11:32,2015,1,WESTERN EUROPE-EU,NETHERLANDS,2,BIRMINGHAM,ROTTERDAM,278,0,278,346,0,346,-19.65317919
17/03/2016 11:32,2015,1,WESTERN EUROPE-EU,NETHERLANDS,2,BOURNEMOUTH,AMSTERDAM,13081,12894,187,0,0,0,0
17/03/2016 11:32,2015,1,WESTERN EUROPE-EU,NETHERLANDS,2,BRISTOL,AMSTERDAM,384482,384482,0,350097,350086,11,9.821563738
17/03/2016 11:32,2015,1,WESTERN EUROPE-EU,NETHERLANDS,2,CAMBRIDGE,AMSTERDAM,508,0,508,7757,7604,153,-93.45107645
17/03/2016 11:32,2015,1,WESTERN EUROPE-EU,NETHERLANDS,2,CAMBRIDGE,GRONINGEN,2591,2182,409,0,0,0,0
17/03/2016 11:32,2015,1,WESTERN EUROPE-EU,NETHERLANDS,2,CARDIFF WALES,AMSTERDAM,129186,129026,160,122802,122748,54,5.1986124
17/03/2016 11:32,2015,1,WESTERN EUROPE-EU,NETHERLANDS,2,DURHAM TEES VALLEY,AMSTERDAM,105636,105636,0,102127,101883,244,3.435918024
17/03/2016 11:32,2015,1,WESTERN EUROPE-EU,NETHERLANDS,2,DURHAM TEES VALLEY,MAASTRICHT,454,0,454,1117,0,1117,-59.35541629
17/03/2016 11:32,2015,1,WESTERN EUROPE-EU,NETHERLANDS,2,EAST MIDLANDS INTERNATIONAL,AMSTERDAM,45275,45275,0,43091,42916,175,5.068343738
17/03/2016 11:32,2015,1,WESTERN EUROPE-EU,NETHERLANDS,2,EAST MIDLANDS INTERNATIONAL,MAASTRICHT,0,0,0,66,0,66,0
17/03/2016 11:32,2015,1,WESTERN EUROPE-EU,NETHERLANDS,2,EDINBURGH,AMSTERDAM,621195,621195,0,601535,600902,633,3.268305252
17/03/2016 11:32,2015,1,WESTERN EUROPE-EU,NETHERLANDS,2,EDINBURGH,ROTTERDAM,162,0,162,0,0,0,0
17/03/2016 11:32,2015,1,WESTERN EUROPE-EU,NETHERLANDS,2,EXETER,AMSTERDAM,43621,43621,0,44491,44491,0,-1.955451664
17/03/2016 11:32,2015,1,WESTERN EUROPE-EU,NETHERLANDS,2,GLASGOW,AMSTERDAM,425444,424424,1020,414270,414032,238,2.697274724
17/03/2016 11:32,2015,1,WESTERN EUROPE-EU,NETHERLANDS,2,GLASGOW,GRONINGEN,0,0,0,158,0,158,0
17/03/2016 11:32,2015,1,WESTERN EUROPE-EU,NETHERLANDS,2,GLASGOW,MAASTRICHT,65,0,65,0,0,0,0
17/03/2016 11:32,2015,1,WESTERN EUROPE-EU,NETHERLANDS,2,GUERNSEY,AMSTERDAM,0,0,0,1369,1369,0,0
17/03/2016 11:32,2015,1,WESTERN EUROPE-EU,NETHERLANDS,2,GUERNSEY,ROTTERDAM,575,0,575,0,0,0,0
17/03/2016 11:32,2015,1,WESTERN EUROPE-EU,NETHERLANDS,2,HUMBERSIDE,AMSTERDAM,121893,121893,0,118143,118143,0,3.174119499
17/03/2016 11:32,2015,1,WESTERN EUROPE-EU,NETHERLANDS,2,INVERNESS,AMSTERDAM,33179,33179,0,36414,36414,0,-8.883945735
17/03/2016 11:32,2015,1,WESTERN EUROPE-EU,NETHERLANDS,2,JERSEY,AMSTERDAM,73,73,0,6094,6094,0,-98.80210043
17/03/2016 11:32,2015,1,WESTERN EUROPE-EU,NETHERLANDS,2,JERSEY,ROTTERDAM,1834,1766,68,86,86,0,2032.55814
17/03/2016 11:32,2015,1,WESTERN EUROPE-EU,NETHERLANDS,2,LEEDS BRADFORD,AMSTERDAM,250568,250568,0,241378,241378,0,3.807306383
17/03/2016 11:32,2015,1,WESTERN EUROPE-EU,NETHERLANDS,2,LEEDS BRADFORD,ROTTERDAM,0,0,0,98,0,98,0
17/03/2016 11:32,2015,1,WESTERN EUROPE-EU,NETHERLANDS,2,LIVERPOOL (JOHN LENNON),AMSTERDAM,227383,227383,0,204163,203987,176,11.37326548
17/03/2016 11:32,2015,1,WESTERN EUROPE-EU,NETHERLANDS,2,MANCHESTER,AMSTERDAM,853427,852741,686,728198,728198,0,17.19710848
17/03/2016 11:32,2015,1,WESTERN EUROPE-EU,NETHERLANDS,2,MANCHESTER,EINDHOVEN,64430,63673,757,10126,10126,0,536.2828363
17/03/2016 11:32,2015,1,WESTERN EUROPE-EU,NETHERLANDS,2,MANCHESTER,ROTTERDAM,100,0,100,0,0,0,0
17/03/2016 11:32,2015,1,WESTERN EUROPE-EU,NETHERLANDS,2,MANSTON (KENT INT),AMSTERDAM,0,0,0,12344,12344,0,0
17/03/2016 11:32,2015,1,WESTERN EUROPE-EU,NETHERLANDS,2,NEWCASTLE,AMSTERDAM,380012,379759,253,366540,366540,0,3.67545152
17/03/2016 11:32,2015,1,WESTERN EUROPE-EU,NETHERLANDS,2,NEWCASTLE,EINDHOVEN,163,0,163,0,0,0,0
17/03/2016 11:32,2015,1,WESTERN EUROPE-EU,NETHERLANDS,2,NEWCASTLE,MAASTRICHT,0,0,0,63,0,63,0
17/03/2016 11:32,2015,1,WESTERN EUROPE-EU,NETHERLANDS,2,NORWICH,AMSTERDAM,142409,142224,185,137380,137365,15,3.660649294
17/03/2016 11:32,2015,1,WESTERN EUROPE-EU,NETHERLANDS,2,PRESTWICK,AMSTERDAM,95,0,95,0,0,0,0
17/03/2016 11:32,2015,1,WESTERN EUROPE-EU,NETHERLANDS,2,SOUTHAMPTON,AMSTERDAM,127764,127684,80,125210,125210,0,2.039773181
17/03/2016 11:32,2015,1,WESTERN EUROPE-EU,NETHERLANDS,2,SOUTHAMPTON,MAASTRICHT,37,0,37,85,0,85,-56.47058824
17/03/2016 11:32,2015,1,WESTERN EUROPE-EU,PORTUGAL(EXCLUDING MADEIRA),1,GATWICK,AZORES PONTA DELGADA,5855,5855,0,6868,6868,0,-14.74956319
17/03/2016 11:32,2015,1,WESTERN EUROPE-EU,PORTUGAL(EXCLUDING MADEIRA),1,GATWICK,FARO,749514,722096,27418,711212,682847,28365,5.385454689
17/03/2016 11:32,2015,1,WESTERN EUROPE-EU,PORTUGAL(EXCLUDING MADEIRA),1,GATWICK,LISBON,302884,302884,0,277709,276989,720,9.065244555
17/03/2016 11:32,2015,1,WESTERN EUROPE-EU,PORTUGAL(EXCLUDING MADEIRA),1,GATWICK,OPORTO (PORTUGAL),239742,239634,108,228171,227958,213,5.071196603
17/03/2016 11:32,2015,1,WESTERN EUROPE-EU,PORTUGAL(EXCLUDING MADEIRA),1,HEATHROW,AZORES SANTA MARIA,146,0,146,0,0,0,0
17/03/2016 11:32,2015,1,WESTERN EUROPE-EU,PORTUGAL(EXCLUDING MADEIRA),1,HEATHROW,FARO,17019,17019,0,16062,16062,0,5.958162122
17/03/2016 11:32,2015,1,WESTERN EUROPE-EU,PORTUGAL(EXCLUDING MADEIRA),1,HEATHROW,LISBON,768043,768043,0,749677,749677,0,2.449855071
17/03/2016 11:32,2015,1,WESTERN EUROPE-EU,PORTUGAL(EXCLUDING MADEIRA),1,HEATHROW,OPORTO (PORTUGAL),14343,14343,0,13860,13860,0,3.484848485
17/03/2016 11:32,2015,1,WESTERN EUROPE-EU,PORTUGAL(EXCLUDING MADEIRA),1,LONDON CITY,FARO,4815,4815,0,4414,4414,0,9.084730403
17/03/2016 11:32,2015,1,WESTERN EUROPE-EU,PORTUGAL(EXCLUDING MADEIRA),1,LUTON,FARO,220089,199788,20301,186059,165983,20076,18.28989729
17/03/2016 11:32,2015,1,WESTERN EUROPE-EU,PORTUGAL(EXCLUDING MADEIRA),1,LUTON,LISBON,163959,163516,443,148477,147832,645,10.42720421
17/03/2016 11:32,2015,1,WESTERN EUROPE-EU,PORTUGAL(EXCLUDING MADEIRA),1,LUTON,OPORTO (PORTUGAL),30405,29878,527,0,0,0,0
17/03/2016 11:32,2015,1,WESTERN EUROPE-EU,PORTUGAL(EXCLUDING MADEIRA),1,SOUTHEND,FARO,93956,93956,0,90757,90757,0,3.524796985
17/03/2016 11:32,2015,1,WESTERN EUROPE-EU,PORTUGAL(EXCLUDING MADEIRA),1,STANSTED,AZORES PONTA DELGADA,12275,12275,0,0,0,0,0
17/03/2016 11:32,2015,1,WESTERN EUROPE-EU,PORTUGAL(EXCLUDING MADEIRA),1,STANSTED,FARO,183016,171794,11222,180829,170208,10621,1.209429903
17/03/2016 11:32,2015,1,WESTERN EUROPE-EU,PORTUGAL(EXCLUDING MADEIRA),1,STANSTED,LISBON,369514,369133,381,260451,259468,983,41.87467124
17/03/2016 11:32,2015,1,WESTERN EUROPE-EU,PORTUGAL(EXCLUDING MADEIRA),1,STANSTED,OPORTO (PORTUGAL),265238,265141,97,253177,253177,0,4.763860856
17/03/2016 11:32,2015,1,WESTERN EUROPE-EU,PORTUGAL(EXCLUDING MADEIRA),2,ABERDEEN,FARO,6953,0,6953,0,0,0,0
17/03/2016 11:32,2015,1,WESTERN EUROPE-EU,PORTUGAL(EXCLUDING MADEIRA),2,BELFAST CITY (GEORGE BEST),FARO,59053,59053,0,57443,57443,0,2.802778406
17/03/2016 11:32,2015,1,WESTERN EUROPE-EU,PORTUGAL(EXCLUDING MADEIRA),2,BELFAST INTERNATIONAL,FARO,113758,113758,0,115963,115963,0,-1.901468572
17/03/2016 11:32,2015,1,WESTERN EUROPE-EU,PORTUGAL(EXCLUDING MADEIRA),2,BELFAST INTERNATIONAL,LISBON,418,0,418,0,0,0,0
17/03/2016 11:32,2015,1,WESTERN EUROPE-EU,PORTUGAL(EXCLUDING MADEIRA),2,BIRMINGHAM,FARO,208693,180244,28449,203982,173697,30285,2.309517506
17/03/2016 11:32,2015,1,WESTERN EUROPE-EU,PORTUGAL(EXCLUDING MADEIRA),2,BIRMINGHAM,LISBON,830,0,830,0,0,0,0
17/03/2016 11:32,2015,1,WESTERN EUROPE-EU,PORTUGAL(EXCLUDING MADEIRA),2,BIRMINGHAM,OPORTO (PORTUGAL),3984,3972,12,17948,17894,54,-77.80254067
17/03/2016 11:32,2015,1,WESTERN EUROPE-EU,PORTUGAL(EXCLUDING MADEIRA),2,BLACKPOOL,FARO,0,0,0,27161,27161,0,0
17/03/2016 11:32,2015,1,WESTERN EUROPE-EU,PORTUGAL(EXCLUDING MADEIRA),2,BOURNEMOUTH,FARO,33533,33533,0,33075,33075,0,1.38473167
17/03/2016 11:32,2015,1,WESTERN EUROPE-EU,PORTUGAL(EXCLUDING MADEIRA),2,BOURNEMOUTH,OPORTO (PORTUGAL),0,0,0,293,0,293,0
17/03/2016 11:32,2015,1,WESTERN EUROPE-EU,PORTUGAL(EXCLUDING MADEIRA),2,BRISTOL,FARO,272715,269113,3602,269899,269899,0,1.043353254
17/03/2016 11:32,2015,1,WESTERN EUROPE-EU,PORTUGAL(EXCLUDING MADEIRA),2,BRISTOL,LISBON,62376,62376,0,51008,51008,0,22.28670013
17/03/2016 11:32,2015,1,WESTERN EUROPE-EU,PORTUGAL(EXCLUDING MADEIRA),2,BRISTOL,OPORTO (PORTUGAL),30013,30013,0,0,0,0,0
17/03/2016 11:32,2015,1,WESTERN EUROPE-EU,PORTUGAL(EXCLUDING MADEIRA),2,CARDIFF WALES,FARO,22235,13215,9020,8307,0,8307,167.665824
17/03/2016 11:32,2015,1,WESTERN EUROPE-EU,PORTUGAL(EXCLUDING MADEIRA),2,CITY OF DERRY (EGLINTON),FARO,2902,2902,0,23807,23807,0,-87.81030789
17/03/2016 11:32,2015,1,WESTERN EUROPE-EU,PORTUGAL(EXCLUDING MADEIRA),2,DONCASTER SHEFFIELD,FARO,17884,0,17884,17774,0,17774,0.618881512
17/03/2016 11:32,2015,1,WESTERN EUROPE-EU,PORTUGAL(EXCLUDING MADEIRA),2,EAST MIDLANDS INTERNATIONAL,FARO,235491,226282,9209,253471,243905,9566,-7.093513656
17/03/2016 11:32,2015,1,WESTERN EUROPE-EU,PORTUGAL(EXCLUDING MADEIRA),2,EDINBURGH,FARO,99255,99255,0,103782,100834,2948,-4.362028097
17/03/2016 11:32,2015,1,WESTERN EUROPE-EU,PORTUGAL(EXCLUDING MADEIRA),2,EDINBURGH,LISBON,47566,47342,224,40801,40801,0,16.58047597
17/03/2016 11:32,2015,1,WESTERN EUROPE-EU,PORTUGAL(EXCLUDING MADEIRA),2,EXETER,FARO,27678,18612,9066,24825,15729,9096,11.49244713
17/03/2016 11:32,2015,1,WESTERN EUROPE-EU,PORTUGAL(EXCLUDING MADEIRA),2,EXETER,LISBON,10,0,10,0,0,0,0
17/03/2016 11:32,2015,1,WESTERN EUROPE-EU,PORTUGAL(EXCLUDING MADEIRA),2,EXETER,OPORTO (PORTUGAL),0,0,0,581,0,581,0
17/03/2016 11:32,2015,1,WESTERN EUROPE-EU,PORTUGAL(EXCLUDING MADEIRA),2,GLASGOW,FARO,96754,85474,11280,101179,86463,14716,-4.373437176
17/03/2016 11:32,2015,1,WESTERN EUROPE-EU,PORTUGAL(EXCLUDING MADEIRA),2,GLASGOW,LISBON,0,0,0,168,0,168,0
17/03/2016 11:32,2015,1,WESTERN EUROPE-EU,PORTUGAL(EXCLUDING MADEIRA),2,HUMBERSIDE,OPORTO (PORTUGAL),0,0,0,592,0,592,0
17/03/2016 11:32,2015,1,WESTERN EUROPE-EU,PORTUGAL(EXCLUDING MADEIRA),2,JERSEY,FARO,603,0,603,539,0,539,11.87384045
17/03/2016 11:32,2015,1,WESTERN EUROPE-EU,PORTUGAL(EXCLUDING MADEIRA),2,JERSEY,LISBON,0,0,0,290,0,290,0
17/03/2016 11:32,2015,1,WESTERN EUROPE-EU,PORTUGAL(EXCLUDING MADEIRA),2,LEEDS BRADFORD,FARO,188599,188599,0,168737,168737,0,11.77098088
17/03/2016 11:32,2015,1,WESTERN EUROPE-EU,PORTUGAL(EXCLUDING MADEIRA),2,LIVERPOOL (JOHN LENNON),FARO,169490,169490,0,163114,163114,0,3.908922594
17/03/2016 11:32,2015,1,WESTERN EUROPE-EU,PORTUGAL(EXCLUDING MADEIRA),2,LIVERPOOL (JOHN LENNON),LISBON,48843,48843,0,47019,47006,13,3.879282843
17/03/2016 11:32,2015,1,WESTERN EUROPE-EU,PORTUGAL(EXCLUDING MADEIRA),2,LIVERPOOL (JOHN LENNON),OPORTO (PORTUGAL),23337,23337,0,16973,16915,58,37.49484475
17/03/2016 11:32,2015,1,WESTERN EUROPE-EU,PORTUGAL(EXCLUDING MADEIRA),2,MANCHESTER,FARO,424396,377117,47279,394500,365242,29258,7.578200253
17/03/2016 11:32,2015,1,WESTERN EUROPE-EU,PORTUGAL(EXCLUDING MADEIRA),2,MANCHESTER,LISBON,187342,186364,978,146076,145932,144,28.24967825
17/03/2016 11:32,2015,1,WESTERN EUROPE-EU,PORTUGAL(EXCLUDING MADEIRA),2,MANCHESTER,OPORTO (PORTUGAL),26330,26330,0,0,0,0,0
17/03/2016 11:32,2015,1,WESTERN EUROPE-EU,PORTUGAL(EXCLUDING MADEIRA),2,NEWCASTLE,FARO,110283,100985,9298,120939,111416,9523,-8.811053506
17/03/2016 11:32,2015,1,WESTERN EUROPE-EU,PORTUGAL(EXCLUDING MADEIRA),2,NEWCASTLE,OPORTO (PORTUGAL),0,0,0,288,0,288,0
17/03/2016 11:32,2015,1,WESTERN EUROPE-EU,PORTUGAL(EXCLUDING MADEIRA),2,NORWICH,OPORTO (PORTUGAL),0,0,0,427,0,427,0
17/03/2016 11:32,2015,1,WESTERN EUROPE-EU,PORTUGAL(EXCLUDING MADEIRA),2,PRESTWICK,FARO,55961,55961,0,48917,48917,0,14.39990187
17/03/2016 11:32,2015,1,WESTERN EUROPE-EU,PORTUGAL(EXCLUDING MADEIRA),2,SOUTHAMPTON,FARO,27192,27192,0,24428,24428,0,11.31488456
17/03/2016 11:32,2015,1,WESTERN EUROPE-EU,PORTUGAL(MADEIRA),1,GATWICK,FUNCHAL,223670,202210,21460,213719,194407,19312,4.656113869
17/03/2016 11:32,2015,1,WESTERN EUROPE-EU,PORTUGAL(MADEIRA),1,GATWICK,PORTO SANTO,9241,0,9241,10238,0,10238,-9.738230123
17/03/2016 11:32,2015,1,WESTERN EUROPE-EU,PORTUGAL(MADEIRA),1,HEATHROW,FUNCHAL,9675,9675,0,19257,19257,0,-49.75852937
17/03/2016 11:32,2015,1,WESTERN EUROPE-EU,PORTUGAL(MADEIRA),1,LUTON,FUNCHAL,8931,0,8931,8751,0,8751,2.056907782
17/03/2016 11:32,2015,1,WESTERN EUROPE-EU,PORTUGAL(MADEIRA),1,STANSTED,FUNCHAL,0,0,0,3,0,3,0
17/03/2016 11:32,2015,1,WESTERN EUROPE-EU,PORTUGAL(MADEIRA),2,BIRMINGHAM,FUNCHAL,50339,31251,19088,49749,33472,16277,1.185953487
17/03/2016 11:32,2015,1,WESTERN EUROPE-EU,PORTUGAL(MADEIRA),2,BIRMINGHAM,PORTO SANTO,6388,0,6388,0,0,0,0
17/03/2016 11:32,2015,1,WESTERN EUROPE-EU,PORTUGAL(MADEIRA),2,BRISTOL,FUNCHAL,36106,36106,0,32840,32840,0,9.945188794
17/03/2016 11:32,2015,1,WESTERN EUROPE-EU,PORTUGAL(MADEIRA),2,EAST MIDLANDS INTERNATIONAL,FUNCHAL,28281,10321,17960,22802,5842,16960,24.02859398
17/03/2016 11:32,2015,1,WESTERN EUROPE-EU,PORTUGAL(MADEIRA),2,EDINBURGH,FUNCHAL,29576,29576,0,0,0,0,0
17/03/2016 11:32,2015,1,WESTERN EUROPE-EU,PORTUGAL(MADEIRA),2,GLASGOW,FUNCHAL,23816,14119,9697,29295,7486,21809,-18.70285032
17/03/2016 11:32,2015,1,WESTERN EUROPE-EU,PORTUGAL(MADEIRA),2,JERSEY,FUNCHAL,10922,2082,8840,10211,890,9321,6.963079032
17/03/2016 11:32,2015,1,WESTERN EUROPE-EU,PORTUGAL(MADEIRA),2,LEEDS BRADFORD,FUNCHAL,15405,15405,0,16958,16958,0,-9.157919566
17/03/2016 11:32,2015,1,WESTERN EUROPE-EU,PORTUGAL(MADEIRA),2,MANCHESTER,FUNCHAL,71965,53036,18929,55562,28306,27256,29.52197545
17/03/2016 11:32,2015,1,WESTERN EUROPE-EU,PORTUGAL(MADEIRA),2,MANCHESTER,PORTO SANTO,8750,0,8750,9877,0,9877,-11.41034727
17/03/2016 11:32,2015,1,WESTERN EUROPE-EU,PORTUGAL(MADEIRA),2,NEWCASTLE,FUNCHAL,15433,6345,9088,13371,4369,9002,15.42143445
17/03/2016 11:32,2015,1,WESTERN EUROPE-EU,SLOVENIA,1,GATWICK,LJUBLJANA,7547,7547,0,5557,5557,0,35.81068922
17/03/2016 11:32,2015,1,WESTERN EUROPE-EU,SLOVENIA,1,GATWICK,MARIBOR,0,0,0,385,0,385,0
17/03/2016 11:32,2015,1,WESTERN EUROPE-EU,SLOVENIA,1,LUTON,LJUBLJANA,52729,52212,517,43020,42555,465,22.56857276
17/03/2016 11:32,2015,1,WESTERN EUROPE-EU,SLOVENIA,1,LUTON,MARIBOR,100,0,100,272,0,272,-63.23529412
17/03/2016 11:32,2015,1,WESTERN EUROPE-EU,SLOVENIA,1,SOUTHEND,MARIBOR,7087,7087,0,0,0,0,0
17/03/2016 11:32,2015,1,WESTERN EUROPE-EU,SLOVENIA,1,STANSTED,LJUBLJANA,89441,89441,0,86061,86061,0,3.927446811
17/03/2016 11:32,2015,1,WESTERN EUROPE-EU,SLOVENIA,2,DONCASTER SHEFFIELD,MARIBOR,0,0,0,89,0,89,0
17/03/2016 11:32,2015,1,WESTERN EUROPE-EU,SLOVENIA,2,DURHAM TEES VALLEY,LJUBLJANA,0,0,0,82,0,82,0
17/03/2016 11:32,2015,1,WESTERN EUROPE-EU,SLOVENIA,2,GLASGOW,MARIBOR,0,0,0,345,0,345,0
17/03/2016 11:32,2015,1,WESTERN EUROPE-EU,SLOVENIA,2,MANCHESTER,LJUBLJANA,6783,6783,0,4072,4072,0,66.57662083
17/03/2016 11:32,2015,1,WESTERN EUROPE-EU,SPAIN,1,GATWICK,A CORUNA,173,173,0,0,0,0,0
17/03/2016 11:32,2015,1,WESTERN EUROPE-EU,SPAIN,1,GATWICK,ALICANTE,760840,728413,32427,768373,736955,31418,-0.980383225
17/03/2016 11:32,2015,1,WESTERN EUROPE-EU,SPAIN,1,GATWICK,ALMERIA,91544,83148,8396,86910,80088,6822,5.331952595
17/03/2016 11:32,2015,1,WESTERN EUROPE-EU,SPAIN,1,GATWICK,BARCELONA,1338598,1338206,392,1268729,1268144,585,5.507007407
17/03/2016 11:32,2015,1,WESTERN EUROPE-EU,SPAIN,1,GATWICK,BILBAO,52925,52177,748,2988,2184,804,1671.251673
17/03/2016 11:32,2015,1,WESTERN EUROPE-EU,SPAIN,1,GATWICK,BURGOS,328,0,328,0,0,0,0
17/03/2016 11:32,2015,1,WESTERN EUROPE-EU,SPAIN,1,GATWICK,GIRONA,20767,0,20767,17407,0,17407,19.30257942
17/03/2016 11:32,2015,1,WESTERN EUROPE-EU,SPAIN,1,GATWICK,IBIZA,298099,216852,81247,266705,184782,81923,11.77105791
17/03/2016 11:32,2015,1,WESTERN EUROPE-EU,SPAIN,1,GATWICK,JEREZ,9192,0,9192,9427,0,9427,-2.492839716
17/03/2016 11:32,2015,1,WESTERN EUROPE-EU,SPAIN,1,GATWICK,LIEIDA,6885,0,6885,6881,0,6881,0.058131086
17/03/2016 11:32,2015,1,WESTERN EUROPE-EU,SPAIN,1,GATWICK,MADRID,906550,906270,280,718235,717052,1183,26.21913441
17/03/2016 11:32,2015,1,WESTERN EUROPE-EU,SPAIN,1,GATWICK,MAHON,243513,150196,93317,215849,115517,100332,12.816367
17/03/2016 11:32,2015,1,WESTERN EUROPE-EU,SPAIN,1,GATWICK,MALAGA,1041356,996226,45130,1055257,1007257,48000,-1.317309433
17/03/2016 11:32,2015,1,WESTERN EUROPE-EU,SPAIN,1,GATWICK,MURCIA SAN JAVIER,131892,131892,0,133304,133304,0,-1.059233031
17/03/2016 11:32,2015,1,WESTERN EUROPE-EU,SPAIN,1,GATWICK,PALMA DE MALLORCA,710848,517719,193129,691024,501412,189612,2.868786033
17/03/2016 11:32,2015,1,WESTERN EUROPE-EU,SPAIN,1,GATWICK,PAMPLONA,140,0,140,413,0,413,-66.10169492
17/03/2016 11:32,2015,1,WESTERN EUROPE-EU,SPAIN,1,GATWICK,REUS,36848,0,36848,33802,0,33802,9.011301106
17/03/2016 11:32,2015,1,WESTERN EUROPE-EU,SPAIN,1,GATWICK,SANTIAGO DE COMPOSTELA (SPAIN),37141,37141,0,40876,40876,0,-9.137391134
17/03/2016 11:32,2015,1,WESTERN EUROPE-EU,SPAIN,1,GATWICK,SEVILLE,188202,187967,235,114451,114451,0,64.4389302
17/03/2016 11:32,2015,1,WESTERN EUROPE-EU,SPAIN,1,GATWICK,VALENCIA,239090,238956,134,211141,211141,0,13.2371259
17/03/2016 11:32,2015,1,WESTERN EUROPE-EU,SPAIN,1,GATWICK,VALLADOLID,363,0,363,342,0,342,6.140350877
17/03/2016 11:32,2015,1,WESTERN EUROPE-EU,SPAIN,1,HEATHROW,A CORUNA,106154,106154,0,98293,98293,0,7.997517626
17/03/2016 11:32,2015,1,WESTERN EUROPE-EU,SPAIN,1,HEATHROW,ALICANTE,0,0,0,7492,7492,0,0
17/03/2016 11:32,2015,1,WESTERN EUROPE-EU,SPAIN,1,HEATHROW,BARCELONA,673519,673218,301,610463,610463,0,10.32920914
17/03/2016 11:32,2015,1,WESTERN EUROPE-EU,SPAIN,1,HEATHROW,BILBAO,157657,157657,0,110284,110284,0,42.95546045
17/03/2016 11:32,2015,1,WESTERN EUROPE-EU,SPAIN,1,HEATHROW,IBIZA,37479,37479,0,31943,31943,0,17.33087061
17/03/2016 11:32,2015,1,WESTERN EUROPE-EU,SPAIN,1,HEATHROW,MADRID,1321558,1321558,0,1274707,1274695,12,3.675432864
17/03/2016 11:32,2015,1,WESTERN EUROPE-EU,SPAIN,1,HEATHROW,MALAGA,19514,19514,0,17624,17624,0,10.72401271
17/03/2016 11:32,2015,1,WESTERN EUROPE-EU,SPAIN,1,HEATHROW,PALMA DE MALLORCA,123584,123584,0,37818,37714,104,226.7861865
17/03/2016 11:32,2015,1,WESTERN EUROPE-EU,SPAIN,1,LONDON CITY,GRANADA,19550,19550,0,26359,26359,0,-25.83178421
17/03/2016 11:32,2015,1,WESTERN EUROPE-EU,SPAIN,1,LONDON CITY,IBIZA,75593,75593,0,65649,65649,0,15.14722235
17/03/2016 11:32,2015,1,WESTERN EUROPE-EU,SPAIN,1,LONDON CITY,MADRID,83855,83855,0,80242,80242,0,4.502629546
17/03/2016 11:32,2015,1,WESTERN EUROPE-EU,SPAIN,1,LONDON CITY,MAHON,4899,4899,0,9887,9887,0,-50.45008597
17/03/2016 11:32,2015,1,WESTERN EUROPE-EU,SPAIN,1,LONDON CITY,MALAGA,51879,51879,0,45257,45257,0,14.63199063
17/03/2016 11:32,2015,1,WESTERN EUROPE-EU,SPAIN,1,LONDON CITY,PALMA DE MALLORCA,34479,34479,0,35137,35137,0,-1.872669835
17/03/2016 11:32,2015,1,WESTERN EUROPE-EU,SPAIN,1,LUTON,A CORUNA,0,0,0,63,0,63,0
17/03/2016 11:32,2015,1,WESTERN EUROPE-EU,SPAIN,1,LUTON,ALICANTE,212983,212886,97,196905,196905,0,8.165358929
17/03/2016 11:32,2015,1,WESTERN EUROPE-EU,SPAIN,1,LUTON,ALMERIA,48,0,48,0,0,0,0
17/03/2016 11:32,2015,1,WESTERN EUROPE-EU,SPAIN,1,LUTON,BARCELONA,181503,181317,186,181510,181464,46,-0.003856537
17/03/2016 11:32,2015,1,WESTERN EUROPE-EU,SPAIN,1,LUTON,BILBAO,0,0,0,72,0,72,0
17/03/2016 11:32,2015,1,WESTERN EUROPE-EU,SPAIN,1,LUTON,GIRONA,45906,45886,20,69205,69205,0,-33.66664258
17/03/2016 11:32,2015,1,WESTERN EUROPE-EU,SPAIN,1,LUTON,IBIZA,54774,36188,18586,47359,30955,16404,15.65700289
17/03/2016 11:32,2015,1,WESTERN EUROPE-EU,SPAIN,1,LUTON,JEREZ,312,0,312,0,0,0,0
17/03/2016 11:32,2015,1,WESTERN EUROPE-EU,SPAIN,1,LUTON,MADRID,139233,139231,2,139683,137821,1862,-0.322158029
17/03/2016 11:32,2015,1,WESTERN EUROPE-EU,SPAIN,1,LUTON,MAHON,81683,61995,19688,68940,49288,19652,18.48418915
17/03/2016 11:32,2015,1,WESTERN EUROPE-EU,SPAIN,1,LUTON,MALAGA,254198,245094,9104,253652,242263,11389,0.215255547
17/03/2016 11:32,2015,1,WESTERN EUROPE-EU,SPAIN,1,LUTON,MURCIA SAN JAVIER,74147,74147,0,79111,79111,0,-6.274727914
17/03/2016 11:32,2015,1,WESTERN EUROPE-EU,SPAIN,1,LUTON,PALMA DE MALLORCA,246102,197080,49022,244166,191366,52800,0.792903189
17/03/2016 11:32,2015,1,WESTERN EUROPE-EU,SPAIN,1,LUTON,REUS,13159,0,13159,40502,32254,8248,-67.51024641
17/03/2016 11:32,2015,1,WESTERN EUROPE-EU,SPAIN,1,LUTON,SEVILLE,47,0,47,0,0,0,0
17/03/2016 11:32,2015,1,WESTERN EUROPE-EU,SPAIN,1,LUTON,VALENCIA,0,0,0,74,0,74,0
17/03/2016 11:32,2015,1,WESTERN EUROPE-EU,SPAIN,1,LUTON,VIGO,3232,2193,1039,0,0,0,0
17/03/2016 11:32,2015,1,WESTERN EUROPE-EU,SPAIN,1,LUTON,VITORIA,55,0,55,0,0,0,0
17/03/2016 11:32,2015,1,WESTERN EUROPE-EU,SPAIN,1,SOUTHEND,ALICANTE,98759,98759,0,119904,119866,38,-17.63494129
17/03/2016 11:32,2015,1,WESTERN EUROPE-EU,SPAIN,1,SOUTHEND,BARCELONA,59826,59826,0,101071,101071,0,-40.80794689
17/03/2016 11:32,2015,1,WESTERN EUROPE-EU,SPAIN,1,SOUTHEND,IBIZA,19237,19237,0,19901,19901,0,-3.336515753
17/03/2016 11:32,2015,1,WESTERN EUROPE-EU,SPAIN,1,SOUTHEND,MAHON,4762,4762,0,0,0,0,0
17/03/2016 11:32,2015,1,WESTERN EUROPE-EU,SPAIN,1,SOUTHEND,MALAGA,81673,81673,0,84053,84053,0,-2.831546762
17/03/2016 11:32,2015,1,WESTERN EUROPE-EU,SPAIN,1,SOUTHEND,PALMA DE MALLORCA,45058,39722,5336,52670,47790,4880,-14.45224986
17/03/2016 11:32,2015,1,WESTERN EUROPE-EU,SPAIN,1,STANSTED,ALICANTE,224251,224251,0,200980,200435,545,11.57876406
17/03/2016 11:32,2015,1,WESTERN EUROPE-EU,SPAIN,1,STANSTED,ALMERIA,23441,23441,0,29069,29069,0,-19.36083113
17/03/2016 11:32,2015,1,WESTERN EUROPE-EU,SPAIN,1,STANSTED,ASTURIAS,84925,84925,0,83465,83465,0,1.749236207
17/03/2016 11:32,2015,1,WESTERN EUROPE-EU,SPAIN,1,STANSTED,BARCELONA,490068,490068,0,372863,372863,0,31.4337974
17/03/2016 11:32,2015,1,WESTERN EUROPE-EU,SPAIN,1,STANSTED,BILBAO,140191,140191,0,144069,144069,0,-2.691765751
17/03/2016 11:32,2015,1,WESTERN EUROPE-EU,SPAIN,1,STANSTED,CASTELLON DE LA PLANA AIRPORT,15196,15196,0,0,0,0,0
17/03/2016 11:32,2015,1,WESTERN EUROPE-EU,SPAIN,1,STANSTED,GIRONA,56053,56053,0,77440,77440,0,-27.61751033
17/03/2016 11:32,2015,1,WESTERN EUROPE-EU,SPAIN,1,STANSTED,GRANADA,339,0,339,0,0,0,0
17/03/2016 11:32,2015,1,WESTERN EUROPE-EU,SPAIN,1,STANSTED,IBIZA,201501,171659,29842,182421,156286,26135,10.45932212
17/03/2016 11:32,2015,1,WESTERN EUROPE-EU,SPAIN,1,STANSTED,JEREZ,46036,46036,0,41676,41676,0,10.46165659
17/03/2016 11:32,2015,1,WESTERN EUROPE-EU,SPAIN,1,STANSTED,LEON,143,0,143,0,0,0,0
17/03/2016 11:32,2015,1,WESTERN EUROPE-EU,SPAIN,1,STANSTED,MADRID,453641,453528,113,369932,369932,0,22.62821275
17/03/2016 11:32,2015,1,WESTERN EUROPE-EU,SPAIN,1,STANSTED,MAHON,34359,0,34359,36166,0,36166,-4.996405464
17/03/2016 11:32,2015,1,WESTERN EUROPE-EU,SPAIN,1,STANSTED,MALAGA,356908,356908,0,342261,342136,125,4.279482617
17/03/2016 11:32,2015,1,WESTERN EUROPE-EU,SPAIN,1,STANSTED,MURCIA SAN JAVIER,133273,133273,0,125783,125783,0,5.954699761
17/03/2016 11:32,2015,1,WESTERN EUROPE-EU,SPAIN,1,STANSTED,PALMA DE MALLORCA,320455,274141,46314,299840,261250,38590,6.875333511
17/03/2016 11:32,2015,1,WESTERN EUROPE-EU,SPAIN,1,STANSTED,REUS,56437,56031,406,56039,56039,0,0.710219668
17/03/2016 11:32,2015,1,WESTERN EUROPE-EU,SPAIN,1,STANSTED,SANTANDER,99533,99533,0,97674,97489,185,1.903270062
17/03/2016 11:32,2015,1,WESTERN EUROPE-EU,SPAIN,1,STANSTED,SANTIAGO DE COMPOSTELA (SPAIN),74871,74871,0,68492,68492,0,9.313496467
17/03/2016 11:32,2015,1,WESTERN EUROPE-EU,SPAIN,1,STANSTED,SEVILLE,131032,131032,0,121035,121035,0,8.259594332
17/03/2016 11:32,2015,1,WESTERN EUROPE-EU,SPAIN,1,STANSTED,VALENCIA,122515,122494,21,126666,126666,0,-3.277122511
17/03/2016 11:32,2015,1,WESTERN EUROPE-EU,SPAIN,1,STANSTED,ZARAGOZA,85576,85576,0,79928,79928,0,7.066359724
17/03/2016 11:32,2015,1,WESTERN EUROPE-EU,SPAIN,2,ABERDEEN,BILBAO,0,0,0,48,0,48,0
17/03/2016 11:32,2015,1,WESTERN EUROPE-EU,SPAIN,2,ABERDEEN,IBIZA,5519,0,5519,6796,0,6796,-18.79046498
17/03/2016 11:32,2015,1,WESTERN EUROPE-EU,SPAIN,2,ABERDEEN,MAHON,0,0,0,3209,0,3209,0
17/03/2016 11:32,2015,1,WESTERN EUROPE-EU,SPAIN,2,ABERDEEN,MALAGA,4246,0,4246,4209,0,4209,0.879068662
17/03/2016 11:32,2015,1,WESTERN EUROPE-EU,SPAIN,2,ABERDEEN,PALMA DE MALLORCA,28163,0,28163,18295,0,18295,53.93823449
17/03/2016 11:32,2015,1,WESTERN EUROPE-EU,SPAIN,2,ABERDEEN,REUS,3025,0,3025,3671,0,3671,-17.59738491
17/03/2016 11:32,2015,1,WESTERN EUROPE-EU,SPAIN,2,ABERDEEN,VITORIA,0,0,0,255,0,255,0
17/03/2016 11:32,2015,1,WESTERN EUROPE-EU,SPAIN,2,BELFAST CITY (GEORGE BEST),BARCELONA,10456,10456,0,0,0,0,0
17/03/2016 11:32,2015,1,WESTERN EUROPE-EU,SPAIN,2,BELFAST CITY (GEORGE BEST),MALAGA,54456,54300,156,51398,51398,0,5.949647846
17/03/2016 11:32,2015,1,WESTERN EUROPE-EU,SPAIN,2,BELFAST CITY (GEORGE BEST),PALMA DE MALLORCA,11480,11480,0,11064,10937,127,3.759942155
17/03/2016 11:32,2015,1,WESTERN EUROPE-EU,SPAIN,2,BELFAST INTERNATIONAL,ALICANTE,114865,114865,0,113556,113556,0,1.152735214
17/03/2016 11:32,2015,1,WESTERN EUROPE-EU,SPAIN,2,BELFAST INTERNATIONAL,ALMERIA,45,0,45,0,0,0,0
17/03/2016 11:32,2015,1,WESTERN EUROPE-EU,SPAIN,2,BELFAST INTERNATIONAL,BARCELONA,37924,37805,119,42725,42606,119,-11.23698069
17/03/2016 11:32,2015,1,WESTERN EUROPE-EU,SPAIN,2,BELFAST INTERNATIONAL,GIRONA,61,0,61,0,0,0,0
17/03/2016 11:32,2015,1,WESTERN EUROPE-EU,SPAIN,2,BELFAST INTERNATIONAL,IBIZA,30514,15282,15232,30405,15111,15294,0.358493669
17/03/2016 11:32,2015,1,WESTERN EUROPE-EU,SPAIN,2,BELFAST INTERNATIONAL,MADRID,170,0,170,180,0,180,-5.555555556
17/03/2016 11:32,2015,1,WESTERN EUROPE-EU,SPAIN,2,BELFAST INTERNATIONAL,MAHON,11403,4825,6578,19158,4899,14259,-40.47917319
17/03/2016 11:32,2015,1,WESTERN EUROPE-EU,SPAIN,2,BELFAST INTERNATIONAL,MALAGA,117770,110258,7512,116572,109156,7416,1.027691041
17/03/2016 11:32,2015,1,WESTERN EUROPE-EU,SPAIN,2,BELFAST INTERNATIONAL,MURCIA SAN JAVIER,16204,16204,0,17320,17320,0,-6.443418014
17/03/2016 11:32,2015,1,WESTERN EUROPE-EU,SPAIN,2,BELFAST INTERNATIONAL,PALMA DE MALLORCA,137405,98040,39365,140373,102247,38126,-2.114366723
17/03/2016 11:32,2015,1,WESTERN EUROPE-EU,SPAIN,2,BELFAST INTERNATIONAL,REUS,36304,11077,25227,37026,11048,25978,-1.949981094
17/03/2016 11:32,2015,1,WESTERN EUROPE-EU,SPAIN,2,BELFAST INTERNATIONAL,SEVILLE,0,0,0,80,0,80,0
17/03/2016 11:32,2015,1,WESTERN EUROPE-EU,SPAIN,2,BIGGIN HILL,GIRONA,0,0,0,8,0,8,0
17/03/2016 11:32,2015,1,WESTERN EUROPE-EU,SPAIN,2,BIGGIN HILL,MALAGA,0,0,0,7,0,7,0
17/03/2016 11:32,2015,1,WESTERN EUROPE-EU,SPAIN,2,BIRMINGHAM,ALICANTE,301301,269281,32020,301859,280239,21620,-0.184854518
17/03/2016 11:32,2015,1,WESTERN EUROPE-EU,SPAIN,2,BIRMINGHAM,ALMERIA,7924,0,7924,35194,22048,13146,-77.48479855
17/03/2016 11:32,2015,1,WESTERN EUROPE-EU,SPAIN,2,BIRMINGHAM,BARCELONA,193334,193154,180,140404,130359,10045,37.69835617
17/03/2016 11:32,2015,1,WESTERN EUROPE-EU,SPAIN,2,BIRMINGHAM,GIRONA,6487,0,6487,6351,0,6351,2.141395056
17/03/2016 11:32,2015,1,WESTERN EUROPE-EU,SPAIN,2,BIRMINGHAM,GRANADA,813,0,813,0,0,0,0
17/03/2016 11:32,2015,1,WESTERN EUROPE-EU,SPAIN,2,BIRMINGHAM,IBIZA,81163,38078,43085,106520,62316,44204,-23.80491926
17/03/2016 11:32,2015,1,WESTERN EUROPE-EU,SPAIN,2,BIRMINGHAM,JEREZ,0,0,0,79,0,79,0
17/03/2016 11:32,2015,1,WESTERN EUROPE-EU,SPAIN,2,BIRMINGHAM,LIEIDA,2312,0,2312,1185,0,1185,95.10548523
17/03/2016 11:32,2015,1,WESTERN EUROPE-EU,SPAIN,2,BIRMINGHAM,MADRID,28372,28372,0,0,0,0,0
17/03/2016 11:32,2015,1,WESTERN EUROPE-EU,SPAIN,2,BIRMINGHAM,MAHON,79344,32819,46525,69738,29486,40252,13.7744128
17/03/2016 11:32,2015,1,WESTERN EUROPE-EU,SPAIN,2,BIRMINGHAM,MALAGA,290778,281278,9500,242881,228765,14116,19.72035688
17/03/2016 11:32,2015,1,WESTERN EUROPE-EU,SPAIN,2,BIRMINGHAM,MURCIA SAN JAVIER,43290,43290,0,40353,40353,0,7.278269274
17/03/2016 11:32,2015,1,WESTERN EUROPE-EU,SPAIN,2,BIRMINGHAM,PALMA DE MALLORCA,254763,144722,110041,265025,165123,99902,-3.872087539
17/03/2016 11:32,2015,1,WESTERN EUROPE-EU,SPAIN,2,BIRMINGHAM,REUS,23860,0,23860,46171,18053,28118,-48.32254012
17/03/2016 11:32,2015,1,WESTERN EUROPE-EU,SPAIN,2,BIRMINGHAM,SEVILLE,233,0,233,81,0,81,187.654321
17/03/2016 11:32,2015,1,WESTERN EUROPE-EU,SPAIN,2,BIRMINGHAM,VALENCIA,158,0,158,486,0,486,-67.48971193
17/03/2016 11:32,2015,1,WESTERN EUROPE-EU,SPAIN,2,BIRMINGHAM,VITORIA,36,0,36,0,0,0,0
17/03/2016 11:32,2015,1,WESTERN EUROPE-EU,SPAIN,2,BLACKPOOL,ALICANTE,0,0,0,35652,35652,0,0
17/03/2016 11:32,2015,1,WESTERN EUROPE-EU,SPAIN,2,BLACKPOOL,IBIZA,0,0,0,9841,9841,0,0
17/03/2016 11:32,2015,1,WESTERN EUROPE-EU,SPAIN,2,BLACKPOOL,MAHON,0,0,0,4375,4375,0,0
17/03/2016 11:32,2015,1,WESTERN EUROPE-EU,SPAIN,2,BLACKPOOL,MALAGA,0,0,0,21708,21708,0,0
17/03/2016 11:32,2015,1,WESTERN EUROPE-EU,SPAIN,2,BLACKPOOL,MURCIA SAN JAVIER,0,0,0,10112,10112,0,0
17/03/2016 11:32,2015,1,WESTERN EUROPE-EU,SPAIN,2,BLACKPOOL,PALMA DE MALLORCA,0,0,0,27717,27717,0,0
17/03/2016 11:32,2015,1,WESTERN EUROPE-EU,SPAIN,2,BOURNEMOUTH,ALICANTE,59211,59211,0,54833,54833,0,7.984243065
17/03/2016 11:32,2015,1,WESTERN EUROPE-EU,SPAIN,2,BOURNEMOUTH,GIRONA,41544,41544,0,48116,48116,0,-13.65865824
17/03/2016 11:32,2015,1,WESTERN EUROPE-EU,SPAIN,2,BOURNEMOUTH,IBIZA,8933,0,8933,23918,15090,8828,-62.65155949
17/03/2016 11:32,2015,1,WESTERN EUROPE-EU,SPAIN,2,BOURNEMOUTH,MAHON,7848,0,7848,7704,0,7704,1.869158879
17/03/2016 11:32,2015,1,WESTERN EUROPE-EU,SPAIN,2,BOURNEMOUTH,MALAGA,66422,66422,0,51996,51852,144,27.74444188
17/03/2016 11:32,2015,1,WESTERN EUROPE-EU,SPAIN,2,BOURNEMOUTH,MURCIA SAN JAVIER,52066,52066,0,46527,46527,0,11.90491543
17/03/2016 11:32,2015,1,WESTERN EUROPE-EU,SPAIN,2,BOURNEMOUTH,PALMA DE MALLORCA,102678,64143,38535,100086,62369,37717,2.589772795
17/03/2016 11:32,2015,1,WESTERN EUROPE-EU,SPAIN,2,BRISTOL,ALICANTE,271540,257067,14473,271457,256082,15375,0.030575745
17/03/2016 11:32,2015,1,WESTERN EUROPE-EU,SPAIN,2,BRISTOL,BARCELONA,132045,132045,0,127606,127606,0,3.478676551
17/03/2016 11:32,2015,1,WESTERN EUROPE-EU,SPAIN,2,BRISTOL,BILBAO,14421,14421,0,0,0,0,0
17/03/2016 11:32,2015,1,WESTERN EUROPE-EU,SPAIN,2,BRISTOL,CASTELLON DE LA PLANA AIRPORT,4282,4282,0,0,0,0,0
17/03/2016 11:32,2015,1,WESTERN EUROPE-EU,SPAIN,2,BRISTOL,GIRONA,59342,59342,0,79941,79941,0,-25.76775372
17/03/2016 11:32,2015,1,WESTERN EUROPE-EU,SPAIN,2,BRISTOL,IBIZA,67363,32013,35350,69426,32492,36934,-2.971509233
17/03/2016 11:32,2015,1,WESTERN EUROPE-EU,SPAIN,2,BRISTOL,LIEIDA,2140,0,2140,2751,0,2751,-22.21010542
17/03/2016 11:32,2015,1,WESTERN EUROPE-EU,SPAIN,2,BRISTOL,MADRID,81410,81082,328,79124,79124,0,2.88913604
17/03/2016 11:32,2015,1,WESTERN EUROPE-EU,SPAIN,2,BRISTOL,MAHON,56432,15972,40460,40645,11162,29483,38.84118588
17/03/2016 11:32,2015,1,WESTERN EUROPE-EU,SPAIN,2,BRISTOL,MALAGA,299986,281559,18427,280713,270728,9985,6.865731192
17/03/2016 11:32,2015,1,WESTERN EUROPE-EU,SPAIN,2,BRISTOL,MURCIA SAN JAVIER,67877,67877,0,69564,69564,0,-2.425104939
17/03/2016 11:32,2015,1,WESTERN EUROPE-EU,SPAIN,2,BRISTOL,PALMA DE MALLORCA,288943,221004,67939,273371,204227,69144,5.696288194
17/03/2016 11:32,2015,1,WESTERN EUROPE-EU,SPAIN,2,BRISTOL,REUS,11320,0,11320,24233,13397,10836,-53.28684026
17/03/2016 11:32,2015,1,WESTERN EUROPE-EU,SPAIN,2,BRISTOL,SALAMANCA,159,0,159,0,0,0,0
17/03/2016 11:32,2015,1,WESTERN EUROPE-EU,SPAIN,2,BRISTOL,SEVILLE,0,0,0,89,0,89,0
17/03/2016 11:32,2015,1,WESTERN EUROPE-EU,SPAIN,2,BRISTOL,VALENCIA,17194,17194,0,19090,19090,0,-9.931901519
17/03/2016 11:32,2015,1,WESTERN EUROPE-EU,SPAIN,2,BRISTOL,VALLADOLID,503,0,503,1076,0,1076,-53.2527881
17/03/2016 11:32,2015,1,WESTERN EUROPE-EU,SPAIN,2,CARDIFF WALES,A CORUNA,43,0,43,0,0,0,0
17/03/2016 11:32,2015,1,WESTERN EUROPE-EU,SPAIN,2,CARDIFF WALES,ALICANTE,78110,40773,37337,72977,36008,36969,7.033722954
17/03/2016 11:32,2015,1,WESTERN EUROPE-EU,SPAIN,2,CARDIFF WALES,BARCELONA,19813,19813,0,15045,14927,118,31.69159189
17/03/2016 11:32,2015,1,WESTERN EUROPE-EU,SPAIN,2,CARDIFF WALES,IBIZA,31385,0,31385,31870,0,31870,-1.521807342
17/03/2016 11:32,2015,1,WESTERN EUROPE-EU,SPAIN,2,CARDIFF WALES,MADRID,0,0,0,599,0,599,0
17/03/2016 11:32,2015,1,WESTERN EUROPE-EU,SPAIN,2,CARDIFF WALES,MAHON,15039,0,15039,15619,0,15619,-3.713425956
17/03/2016 11:32,2015,1,WESTERN EUROPE-EU,SPAIN,2,CARDIFF WALES,MALAGA,67920,40116,27804,66259,33899,32360,2.506829261
17/03/2016 11:32,2015,1,WESTERN EUROPE-EU,SPAIN,2,CARDIFF WALES,PALMA DE MALLORCA,78579,15730,62849,68377,9773,58604,14.92022171
17/03/2016 11:32,2015,1,WESTERN EUROPE-EU,SPAIN,2,CARDIFF WALES,REUS,21125,0,21125,16313,0,16313,29.49794642
17/03/2016 11:32,2015,1,WESTERN EUROPE-EU,SPAIN,2,CARDIFF WALES,SEVILLE,0,0,0,1094,0,1094,0
17/03/2016 11:32,2015,1,WESTERN EUROPE-EU,SPAIN,2,CARDIFF WALES,VALENCIA,0,0,0,80,0,80,0
17/03/2016 11:32,2015,1,WESTERN EUROPE-EU,SPAIN,2,CITY OF DERRY (EGLINTON),ALICANTE,4152,4152,0,5603,5603,0,-25.89684098
17/03/2016 11:32,2015,1,WESTERN EUROPE-EU,SPAIN,2,CITY OF DERRY (EGLINTON),PALMA DE MALLORCA,0,0,0,5844,0,5844,0
17/03/2016 11:32,2015,1,WESTERN EUROPE-EU,SPAIN,2,DONCASTER SHEFFIELD,ALICANTE,38311,0,38311,38097,0,38097,0.56172402
17/03/2016 11:32,2015,1,WESTERN EUROPE-EU,SPAIN,2,DONCASTER SHEFFIELD,IBIZA,19533,0,19533,14460,0,14460,35.08298755
17/03/2016 11:32,2015,1,WESTERN EUROPE-EU,SPAIN,2,DONCASTER SHEFFIELD,MAHON,15845,0,15845,15099,0,15099,4.940724551
17/03/2016 11:32,2015,1,WESTERN EUROPE-EU,SPAIN,2,DONCASTER SHEFFIELD,MALAGA,38495,0,38495,32411,0,32411,18.77140477
17/03/2016 11:32,2015,1,WESTERN EUROPE-EU,SPAIN,2,DONCASTER SHEFFIELD,PALMA DE MALLORCA,56609,0,56609,62145,0,62145,-8.908198568
17/03/2016 11:32,2015,1,WESTERN EUROPE-EU,SPAIN,2,DONCASTER SHEFFIELD,REUS,9478,0,9478,9282,0,9282,2.111613876
17/03/2016 11:32,2015,1,WESTERN EUROPE-EU,SPAIN,2,DURHAM TEES VALLEY,ALBACETE,199,0,199,0,0,0,0
17/03/2016 11:32,2015,1,WESTERN EUROPE-EU,SPAIN,2,DURHAM TEES VALLEY,MALAGA,35,0,35,0,0,0,0
17/03/2016 11:32,2015,1,WESTERN EUROPE-EU,SPAIN,2,EAST MIDLANDS INTERNATIONAL,ALICANTE,379415,347983,31432,394894,364432,30462,-3.919786069
17/03/2016 11:32,2015,1,WESTERN EUROPE-EU,SPAIN,2,EAST MIDLANDS INTERNATIONAL,ALMERIA,0,0,0,20910,20910,0,0
17/03/2016 11:32,2015,1,WESTERN EUROPE-EU,SPAIN,2,EAST MIDLANDS INTERNATIONAL,BARCELONA,80915,80850,65,70647,70647,0,14.53423358
17/03/2016 11:32,2015,1,WESTERN EUROPE-EU,SPAIN,2,EAST MIDLANDS INTERNATIONAL,GIRONA,0,0,0,16948,16948,0,0
17/03/2016 11:32,2015,1,WESTERN EUROPE-EU,SPAIN,2,EAST MIDLANDS INTERNATIONAL,IBIZA,101118,67847,33271,116727,84730,31997,-13.37222751
17/03/2016 11:32,2015,1,WESTERN EUROPE-EU,SPAIN,2,EAST MIDLANDS INTERNATIONAL,MAHON,79100,42355,36745,73387,35731,37656,7.784757518
17/03/2016 11:32,2015,1,WESTERN EUROPE-EU,SPAIN,2,EAST MIDLANDS INTERNATIONAL,MALAGA,275056,256157,18899,328804,318030,10774,-16.34651647
17/03/2016 11:32,2015,1,WESTERN EUROPE-EU,SPAIN,2,EAST MIDLANDS INTERNATIONAL,MURCIA SAN JAVIER,92507,92507,0,90707,90707,0,1.984411346
17/03/2016 11:32,2015,1,WESTERN EUROPE-EU,SPAIN,2,EAST MIDLANDS INTERNATIONAL,PALMA DE MALLORCA,326998,225694,101304,344996,251649,93347,-5.21687208
17/03/2016 11:32,2015,1,WESTERN EUROPE-EU,SPAIN,2,EAST MIDLANDS INTERNATIONAL,REUS,10699,10699,0,27349,27349,0,-60.87973966
17/03/2016 11:32,2015,1,WESTERN EUROPE-EU,SPAIN,2,EAST MIDLANDS INTERNATIONAL,VALENCIA,32586,32586,0,29615,29615,0,10.03207834
17/03/2016 11:32,2015,1,WESTERN EUROPE-EU,SPAIN,2,EDINBURGH,ALICANTE,150000,150000,0,143891,142936,955,4.245574775
17/03/2016 11:32,2015,1,WESTERN EUROPE-EU,SPAIN,2,EDINBURGH,BARCELONA,121895,119313,2582,80538,80449,89,51.3509151
17/03/2016 11:32,2015,1,WESTERN EUROPE-EU,SPAIN,2,EDINBURGH,BILBAO,0,0,0,15,0,15,0
17/03/2016 11:32,2015,1,WESTERN EUROPE-EU,SPAIN,2,EDINBURGH,IBIZA,25248,13272,11976,27318,15516,11802,-7.57742148
17/03/2016 11:32,2015,1,WESTERN EUROPE-EU,SPAIN,2,EDINBURGH,MADRID,162499,157591,4908,107118,103527,3591,51.70092795
17/03/2016 11:32,2015,1,WESTERN EUROPE-EU,SPAIN,2,EDINBURGH,MAHON,10838,5874,4964,10445,5654,4791,3.762565821
17/03/2016 11:32,2015,1,WESTERN EUROPE-EU,SPAIN,2,EDINBURGH,MALAGA,144401,144401,0,128095,128095,0,12.72961474
17/03/2016 11:32,2015,1,WESTERN EUROPE-EU,SPAIN,2,EDINBURGH,MURCIA SAN JAVIER,17072,17072,0,21832,21832,0,-21.80285819
17/03/2016 11:32,2015,1,WESTERN EUROPE-EU,SPAIN,2,EDINBURGH,PALMA DE MALLORCA,157056,111791,45265,143178,105976,37202,9.692829904
17/03/2016 11:32,2015,1,WESTERN EUROPE-EU,SPAIN,2,EDINBURGH,PAMPLONA,551,0,551,0,0,0,0
17/03/2016 11:32,2015,1,WESTERN EUROPE-EU,SPAIN,2,EDINBURGH,REUS,7819,7819,0,3253,3253,0,140.3627421
17/03/2016 11:32,2015,1,WESTERN EUROPE-EU,SPAIN,2,EDINBURGH,SANTANDER,30013,30013,0,22569,22569,0,32.98329567
17/03/2016 11:32,2015,1,WESTERN EUROPE-EU,SPAIN,2,EXETER,ALICANTE,22147,22147,0,26421,26421,0,-16.17652625
17/03/2016 11:32,2015,1,WESTERN EUROPE-EU,SPAIN,2,EXETER,IBIZA,8805,0,8805,8672,0,8672,1.533671587
17/03/2016 11:32,2015,1,WESTERN EUROPE-EU,SPAIN,2,EXETER,MAHON,16273,0,16273,16506,0,16506,-1.4116079
17/03/2016 11:32,2015,1,WESTERN EUROPE-EU,SPAIN,2,EXETER,MALAGA,22478,22339,139,28230,28230,0,-20.37548707
17/03/2016 11:32,2015,1,WESTERN EUROPE-EU,SPAIN,2,EXETER,PALMA DE MALLORCA,49179,11484,37695,48707,12888,35819,0.969059889
17/03/2016 11:32,2015,1,WESTERN EUROPE-EU,SPAIN,2,EXETER,SANTIAGO DE COMPOSTELA (SPAIN),0,0,0,186,0,186,0
17/03/2016 11:32,2015,1,WESTERN EUROPE-EU,SPAIN,2,EXETER,VITORIA,10,0,10,0,0,0,0
17/03/2016 11:32,2015,1,WESTERN EUROPE-EU,SPAIN,2,GLASGOW,ALICANTE,190522,160332,30190,197450,161555,35895,-3.508736389
17/03/2016 11:32,2015,1,WESTERN EUROPE-EU,SPAIN,2,GLASGOW,BARCELONA,35961,32525,3436,39227,34900,4327,-8.325897978
17/03/2016 11:32,2015,1,WESTERN EUROPE-EU,SPAIN,2,GLASGOW,BILBAO,101,0,101,464,0,464,-78.23275862
17/03/2016 11:32,2015,1,WESTERN EUROPE-EU,SPAIN,2,GLASGOW,GRANADA,90,0,90,0,0,0,0
17/03/2016 11:32,2015,1,WESTERN EUROPE-EU,SPAIN,2,GLASGOW,IBIZA,81065,34813,46252,73940,34804,39136,9.636191507
17/03/2016 11:32,2015,1,WESTERN EUROPE-EU,SPAIN,2,GLASGOW,MADRID,704,0,704,1358,0,1358,-48.15905744
17/03/2016 11:32,2015,1,WESTERN EUROPE-EU,SPAIN,2,GLASGOW,MAHON,33425,12234,21191,27866,14162,13704,19.94904184
17/03/2016 11:32,2015,1,WESTERN EUROPE-EU,SPAIN,2,GLASGOW,MALAGA,165154,141958,23196,168010,148430,19580,-1.699898816
17/03/2016 11:32,2015,1,WESTERN EUROPE-EU,SPAIN,2,GLASGOW,MURCIA SAN JAVIER,11130,11130,0,16240,16240,0,-31.46551724
17/03/2016 11:32,2015,1,WESTERN EUROPE-EU,SPAIN,2,GLASGOW,PALMA DE MALLORCA,214190,91138,123052,216208,102984,113224,-0.933360468
17/03/2016 11:32,2015,1,WESTERN EUROPE-EU,SPAIN,2,GLASGOW,REUS,52416,13232,39184,49307,11030,38277,6.305392743
17/03/2016 11:32,2015,1,WESTERN EUROPE-EU,SPAIN,2,GLASGOW,SANTANDER,67,0,67,0,0,0,0
17/03/2016 11:32,2015,1,WESTERN EUROPE-EU,SPAIN,2,GLASGOW,VALENCIA,840,0,840,567,0,567,48.14814815
17/03/2016 11:32,2015,1,WESTERN EUROPE-EU,SPAIN,2,HUMBERSIDE,ALICANTE,1384,0,1384,1714,0,1714,-19.25320887
17/03/2016 11:32,2015,1,WESTERN EUROPE-EU,SPAIN,2,HUMBERSIDE,BARCELONA,335,0,335,178,0,178,88.20224719
17/03/2016 11:32,2015,1,WESTERN EUROPE-EU,SPAIN,2,HUMBERSIDE,PALMA DE MALLORCA,8262,0,8262,828,0,828,897.826087
17/03/2016 11:32,2015,1,WESTERN EUROPE-EU,SPAIN,2,ISLE OF MAN,ALICANTE,225,0,225,0,0,0,0
17/03/2016 11:32,2015,1,WESTERN EUROPE-EU,SPAIN,2,ISLE OF MAN,MAHON,803,803,0,669,0,669,20.02989537
17/03/2016 11:32,2015,1,WESTERN EUROPE-EU,SPAIN,2,ISLE OF MAN,PALMA DE MALLORCA,2283,0,2283,2245,0,2245,1.692650334
17/03/2016 11:32,2015,1,WESTERN EUROPE-EU,SPAIN,2,JERSEY,BARCELONA,171,0,171,156,0,156,9.615384615
17/03/2016 11:32,2015,1,WESTERN EUROPE-EU,SPAIN,2,JERSEY,MALAGA,699,699,0,585,0,585,19.48717949
17/03/2016 11:32,2015,1,WESTERN EUROPE-EU,SPAIN,2,JERSEY,PALMA DE MALLORCA,3695,981,2714,3479,0,3479,6.208680655
17/03/2016 11:32,2015,1,WESTERN EUROPE-EU,SPAIN,2,LEEDS BRADFORD,ALICANTE,272104,272104,0,214726,214726,0,26.72149623
17/03/2016 11:32,2015,1,WESTERN EUROPE-EU,SPAIN,2,LEEDS BRADFORD,BARCELONA,76461,76461,0,78222,78222,0,-2.251284805
17/03/2016 11:32,2015,1,WESTERN EUROPE-EU,SPAIN,2,LEEDS BRADFORD,GIRONA,0,0,0,26224,26224,0,0
17/03/2016 11:32,2015,1,WESTERN EUROPE-EU,SPAIN,2,LEEDS BRADFORD,IBIZA,75580,66482,9098,80760,71687,9073,-6.414066369
17/03/2016 11:32,2015,1,WESTERN EUROPE-EU,SPAIN,2,LEEDS BRADFORD,MAHON,38468,38468,0,37255,37255,0,3.2559388
17/03/2016 11:32,2015,1,WESTERN EUROPE-EU,SPAIN,2,LEEDS BRADFORD,MALAGA,231108,231108,0,227144,227144,0,1.745148452
17/03/2016 11:32,2015,1,WESTERN EUROPE-EU,SPAIN,2,LEEDS BRADFORD,MURCIA SAN JAVIER,58466,58466,0,62269,62269,0,-6.10737285
17/03/2016 11:32,2015,1,WESTERN EUROPE-EU,SPAIN,2,LEEDS BRADFORD,PALMA DE MALLORCA,226386,194405,31981,227897,200252,27645,-0.66301882
17/03/2016 11:32,2015,1,WESTERN EUROPE-EU,SPAIN,2,LEEDS BRADFORD,REUS,12188,12188,0,10564,10564,0,15.37296479
17/03/2016 11:32,2015,1,WESTERN EUROPE-EU,SPAIN,2,LEEDS BRADFORD,VALENCIA,0,0,0,43,0,43,0
17/03/2016 11:32,2015,1,WESTERN EUROPE-EU,SPAIN,2,LIVERPOOL (JOHN LENNON),ALICANTE,214309,214309,0,199121,199121,0,7.627522963
17/03/2016 11:32,2015,1,WESTERN EUROPE-EU,SPAIN,2,LIVERPOOL (JOHN LENNON),BARCELONA,232096,232096,0,223789,223789,0,3.711978694
17/03/2016 11:32,2015,1,WESTERN EUROPE-EU,SPAIN,2,LIVERPOOL (JOHN LENNON),CASTELLON DE LA PLANA AIRPORT,44,0,44,0,0,0,0
17/03/2016 11:32,2015,1,WESTERN EUROPE-EU,SPAIN,2,LIVERPOOL (JOHN LENNON),IBIZA,25785,25785,0,30398,30398,0,-15.17534048
17/03/2016 11:32,2015,1,WESTERN EUROPE-EU,SPAIN,2,LIVERPOOL (JOHN LENNON),LEON,159,0,159,0,0,0,0
17/03/2016 11:32,2015,1,WESTERN EUROPE-EU,SPAIN,2,LIVERPOOL (JOHN LENNON),MADRID,95772,95716,56,100391,98446,1945,-4.601010051
17/03/2016 11:32,2015,1,WESTERN EUROPE-EU,SPAIN,2,LIVERPOOL (JOHN LENNON),MAHON,9939,9939,0,9629,9629,0,3.219441271
17/03/2016 11:32,2015,1,WESTERN EUROPE-EU,SPAIN,2,LIVERPOOL (JOHN LENNON),MALAGA,194064,194064,0,186742,186742,0,3.92091763
17/03/2016 11:32,2015,1,WESTERN EUROPE-EU,SPAIN,2,LIVERPOOL (JOHN LENNON),PALMA DE MALLORCA,181544,181544,0,178676,178676,0,1.60514003
17/03/2016 11:32,2015,1,WESTERN EUROPE-EU,SPAIN,2,LIVERPOOL (JOHN LENNON),REUS,0,0,0,18940,18940,0,0
17/03/2016 11:32,2015,1,WESTERN EUROPE-EU,SPAIN,2,LIVERPOOL (JOHN LENNON),SALAMANCA,158,0,158,0,0,0,0
17/03/2016 11:32,2015,1,WESTERN EUROPE-EU,SPAIN,2,LIVERPOOL (JOHN LENNON),VALLADOLID,665,0,665,1084,0,1084,-38.65313653
17/03/2016 11:32,2015,1,WESTERN EUROPE-EU,SPAIN,2,MANCHESTER,ALICANTE,630636,563145,67491,597580,524285,73295,5.531644299
17/03/2016 11:32,2015,1,WESTERN EUROPE-EU,SPAIN,2,MANCHESTER,ALMERIA,49464,22659,26805,43900,23342,20558,12.67425968
17/03/2016 11:32,2015,1,WESTERN EUROPE-EU,SPAIN,2,MANCHESTER,BARCELONA,284365,281852,2513,217007,212648,4359,31.03955172
17/03/2016 11:32,2015,1,WESTERN EUROPE-EU,SPAIN,2,MANCHESTER,BILBAO,40349,40206,143,40683,40581,102,-0.820981737
17/03/2016 11:32,2015,1,WESTERN EUROPE-EU,SPAIN,2,MANCHESTER,GIRONA,50905,34005,16900,56571,40368,16203,-10.01573244
17/03/2016 11:32,2015,1,WESTERN EUROPE-EU,SPAIN,2,MANCHESTER,GRANADA,464,0,464,0,0,0,0
17/03/2016 11:32,2015,1,WESTERN EUROPE-EU,SPAIN,2,MANCHESTER,IBIZA,242801,150860,91941,228671,139666,89005,6.179183193
17/03/2016 11:32,2015,1,WESTERN EUROPE-EU,SPAIN,2,MANCHESTER,LIEIDA,6387,0,6387,5172,0,5172,23.49187935
17/03/2016 11:32,2015,1,WESTERN EUROPE-EU,SPAIN,2,MANCHESTER,MADRID,109243,109208,35,76502,75800,702,42.79757392
17/03/2016 11:32,2015,1,WESTERN EUROPE-EU,SPAIN,2,MANCHESTER,MAHON,159046,54554,104492,156118,56632,99486,1.875504426
17/03/2016 11:32,2015,1,WESTERN EUROPE-EU,SPAIN,2,MANCHESTER,MALAGA,556720,487384,69336,545042,472957,72085,2.142587177
17/03/2016 11:32,2015,1,WESTERN EUROPE-EU,SPAIN,2,MANCHESTER,MURCIA SAN JAVIER,108246,108113,133,118488,118488,0,-8.643913308
17/03/2016 11:32,2015,1,WESTERN EUROPE-EU,SPAIN,2,MANCHESTER,PALMA DE MALLORCA,666403,433952,232451,654543,480912,173631,1.811951239
17/03/2016 11:32,2015,1,WESTERN EUROPE-EU,SPAIN,2,MANCHESTER,REUS,68807,18971,49836,91068,41449,49619,-24.44437124
17/03/2016 11:32,2015,1,WESTERN EUROPE-EU,SPAIN,2,MANCHESTER,SEVILLE,1882,0,1882,0,0,0,0
17/03/2016 11:32,2015,1,WESTERN EUROPE-EU,SPAIN,2,MANCHESTER,VALENCIA,22525,22525,0,19665,19539,126,14.54360539
17/03/2016 11:32,2015,1,WESTERN EUROPE-EU,SPAIN,2,MANCHESTER,ZARAGOZA,0,0,0,102,0,102,0
17/03/2016 11:32,2015,1,WESTERN EUROPE-EU,SPAIN,2,NEWCASTLE,ALICANTE,234633,196228,38405,232872,195803,37069,0.75620942
17/03/2016 11:32,2015,1,WESTERN EUROPE-EU,SPAIN,2,NEWCASTLE,BARCELONA,66279,66132,147,66389,66022,367,-0.165690099
17/03/2016 11:32,2015,1,WESTERN EUROPE-EU,SPAIN,2,NEWCASTLE,GIRONA,0,0,0,28803,28803,0,0
17/03/2016 11:32,2015,1,WESTERN EUROPE-EU,SPAIN,2,NEWCASTLE,IBIZA,75704,36767,38937,75932,35609,40323,-0.300268661
17/03/2016 11:32,2015,1,WESTERN EUROPE-EU,SPAIN,2,NEWCASTLE,MAHON,39537,17183,22354,40582,18823,21759,-2.575033266
17/03/2016 11:32,2015,1,WESTERN EUROPE-EU,SPAIN,2,NEWCASTLE,MALAGA,169855,150603,19252,179195,156450,22745,-5.212199001
17/03/2016 11:32,2015,1,WESTERN EUROPE-EU,SPAIN,2,NEWCASTLE,MURCIA SAN JAVIER,28799,28799,0,40956,40956,0,-29.68307452
17/03/2016 11:32,2015,1,WESTERN EUROPE-EU,SPAIN,2,NEWCASTLE,PALMA DE MALLORCA,227063,137074,89989,246429,144934,101495,-7.858652999
17/03/2016 11:32,2015,1,WESTERN EUROPE-EU,SPAIN,2,NEWCASTLE,REUS,40588,10239,30349,38803,15151,23652,4.600159781
17/03/2016 11:32,2015,1,WESTERN EUROPE-EU,SPAIN,2,NORWICH,IBIZA,5348,0,5348,6550,0,6550,-18.35114504
17/03/2016 11:32,2015,1,WESTERN EUROPE-EU,SPAIN,2,NORWICH,MAHON,7402,0,7402,0,0,0,0
17/03/2016 11:32,2015,1,WESTERN EUROPE-EU,SPAIN,2,NORWICH,PALMA DE MALLORCA,29789,0,29789,28584,0,28584,4.215645116
17/03/2016 11:32,2015,1,WESTERN EUROPE-EU,SPAIN,2,OXFORD (KIDLINGTON),MALAGA,35,0,35,0,0,0,0
17/03/2016 11:32,2015,1,WESTERN EUROPE-EU,SPAIN,2,PRESTWICK,ALICANTE,75859,75859,0,74891,74891,0,1.292545166
17/03/2016 11:32,2015,1,WESTERN EUROPE-EU,SPAIN,2,PRESTWICK,BARCELONA,76770,76770,0,86063,86063,0,-10.79790386
17/03/2016 11:32,2015,1,WESTERN EUROPE-EU,SPAIN,2,PRESTWICK,GIRONA,7703,7703,0,5489,5489,0,40.33521589
17/03/2016 11:32,2015,1,WESTERN EUROPE-EU,SPAIN,2,PRESTWICK,IBIZA,22727,22727,0,25677,25677,0,-11.4888811
17/03/2016 11:32,2015,1,WESTERN EUROPE-EU,SPAIN,2,PRESTWICK,MALAGA,72088,72088,0,79828,79828,0,-9.695846069
17/03/2016 11:32,2015,1,WESTERN EUROPE-EU,SPAIN,2,PRESTWICK,MURCIA SAN JAVIER,24222,24222,0,23362,23362,0,3.681191679
17/03/2016 11:32,2015,1,WESTERN EUROPE-EU,SPAIN,2,PRESTWICK,PALMA DE MALLORCA,53941,53941,0,47192,47192,0,14.30115274
17/03/2016 11:32,2015,1,WESTERN EUROPE-EU,SPAIN,2,PRESTWICK,REUS,0,0,0,16410,16410,0,0
17/03/2016 11:32,2015,1,WESTERN EUROPE-EU,SPAIN,2,SOUTHAMPTON,ALICANTE,41001,41001,0,42821,42821,0,-4.250251045
17/03/2016 11:32,2015,1,WESTERN EUROPE-EU,SPAIN,2,SOUTHAMPTON,BARCELONA,0,0,0,119,0,119,0
17/03/2016 11:32,2015,1,WESTERN EUROPE-EU,SPAIN,2,SOUTHAMPTON,LIEIDA,2030,0,2030,1505,0,1505,34.88372093
17/03/2016 11:32,2015,1,WESTERN EUROPE-EU,SPAIN,2,SOUTHAMPTON,MALAGA,42410,42410,0,42352,42352,0,0.136947488
17/03/2016 11:32,2015,1,WESTERN EUROPE-EU,SPAIN,2,SOUTHAMPTON,PALMA DE MALLORCA,23905,22941,964,24864,24774,90,-3.856981982
17/03/2016 11:32,2015,1,WESTERN EUROPE-EU,SPAIN,2,SOUTHAMPTON,REUS,0,0,0,141,0,141,0
17/03/2016 11:32,2015,1,WESTERN EUROPE-EU,SPAIN(CANARY ISLANDS),1,GATWICK,ARRECIFE,421924,344271,77653,397732,313314,84418,6.082487705
17/03/2016 11:32,2015,1,WESTERN EUROPE-EU,SPAIN(CANARY ISLANDS),1,GATWICK,FUERTEVENTURA,235242,188547,46695,196281,148582,47699,19.84960337
17/03/2016 11:32,2015,1,WESTERN EUROPE-EU,SPAIN(CANARY ISLANDS),1,GATWICK,LAS PALMAS,278503,197328,81175,267399,178769,88630,4.152595933
17/03/2016 11:32,2015,1,WESTERN EUROPE-EU,SPAIN(CANARY ISLANDS),1,GATWICK,SANTA CRUZ DE LA PALMA,29768,3669,26099,23092,1714,21378,28.91044518
17/03/2016 11:32,2015,1,WESTERN EUROPE-EU,SPAIN(CANARY ISLANDS),1,GATWICK,TENERIFE (SURREINA SOFIA),739089,590851,148238,732873,586533,146340,0.848168782
17/03/2016 11:32,2015,1,WESTERN EUROPE-EU,SPAIN(CANARY ISLANDS),1,HEATHROW,LAS PALMAS,51376,51376,0,5839,5839,0,779.8766912
17/03/2016 11:32,2015,1,WESTERN EUROPE-EU,SPAIN(CANARY ISLANDS),1,HEATHROW,TENERIFE (NORTE LOS RODEOS),25300,25300,0,0,0,0,0
17/03/2016 11:32,2015,1,WESTERN EUROPE-EU,SPAIN(CANARY ISLANDS),1,LUTON,ARRECIFE,104372,71544,32828,105162,72006,33156,-0.751221924
17/03/2016 11:32,2015,1,WESTERN EUROPE-EU,SPAIN(CANARY ISLANDS),1,LUTON,FUERTEVENTURA,31383,21800,9583,30508,19898,10610,2.86810017
17/03/2016 11:32,2015,1,WESTERN EUROPE-EU,SPAIN(CANARY ISLANDS),1,LUTON,LAS PALMAS,40078,22113,17965,39724,22210,17514,0.891148928
17/03/2016 11:32,2015,1,WESTERN EUROPE-EU,SPAIN(CANARY ISLANDS),1,LUTON,TENERIFE (SURREINA SOFIA),121783,84523,37260,149174,112186,36988,-18.36177886
17/03/2016 11:32,2015,1,WESTERN EUROPE-EU,SPAIN(CANARY ISLANDS),1,SOUTHEND,ARRECIFE,4195,4195,0,0,0,0,0
17/03/2016 11:32,2015,1,WESTERN EUROPE-EU,SPAIN(CANARY ISLANDS),1,SOUTHEND,TENERIFE (SURREINA SOFIA),14226,14226,0,18912,18912,0,-24.77791878
17/03/2016 11:32,2015,1,WESTERN EUROPE-EU,SPAIN(CANARY ISLANDS),1,STANSTED,ARRECIFE,144851,126181,18670,129307,105409,23898,12.02100428
17/03/2016 11:32,2015,1,WESTERN EUROPE-EU,SPAIN(CANARY ISLANDS),1,STANSTED,FUERTEVENTURA,102399,83926,18473,92699,74330,18369,10.4639748
17/03/2016 11:32,2015,1,WESTERN EUROPE-EU,SPAIN(CANARY ISLANDS),1,STANSTED,LAS PALMAS,103779,84877,18902,88826,70716,18110,16.83403508
17/03/2016 11:32,2015,1,WESTERN EUROPE-EU,SPAIN(CANARY ISLANDS),1,STANSTED,TENERIFE (SURREINA SOFIA),221820,191550,30270,173455,145688,27767,27.88331267
17/03/2016 11:32,2015,1,WESTERN EUROPE-EU,SPAIN(CANARY ISLANDS),2,ABERDEEN,TENERIFE (SURREINA SOFIA),26040,802,25238,32639,4648,27991,-20.21814394
17/03/2016 11:32,2015,1,WESTERN EUROPE-EU,SPAIN(CANARY ISLANDS),2,BELFAST INTERNATIONAL,ARRECIFE,75784,58721,17063,57167,49301,7866,32.56599087
17/03/2016 11:32,2015,1,WESTERN EUROPE-EU,SPAIN(CANARY ISLANDS),2,BELFAST INTERNATIONAL,LAS PALMAS,20690,11588,9102,9105,1834,7271,127.2377814
17/03/2016 11:32,2015,1,WESTERN EUROPE-EU,SPAIN(CANARY ISLANDS),2,BELFAST INTERNATIONAL,TENERIFE (SURREINA SOFIA),75224,54554,20670,78903,71448,7455,-4.662687097
17/03/2016 11:32,2015,1,WESTERN EUROPE-EU,SPAIN(CANARY ISLANDS),2,BIGGIN HILL,TENERIFE (SURREINA SOFIA),0,0,0,7,0,7,0
17/03/2016 11:32,2015,1,WESTERN EUROPE-EU,SPAIN(CANARY ISLANDS),2,BIRMINGHAM,ARRECIFE,218000,163391,54609,217921,148011,69910,0.036251669
17/03/2016 11:32,2015,1,WESTERN EUROPE-EU,SPAIN(CANARY ISLANDS),2,BIRMINGHAM,FUERTEVENTURA,124333,101140,23193,113281,93548,19733,9.756269807
17/03/2016 11:32,2015,1,WESTERN EUROPE-EU,SPAIN(CANARY ISLANDS),2,BIRMINGHAM,LAS PALMAS,117251,83627,33624,91368,65133,26235,28.32829875
17/03/2016 11:32,2015,1,WESTERN EUROPE-EU,SPAIN(CANARY ISLANDS),2,BIRMINGHAM,TENERIFE (SURREINA SOFIA),273380,216450,56930,276432,215599,60833,-1.104068993
17/03/2016 11:32,2015,1,WESTERN EUROPE-EU,SPAIN(CANARY ISLANDS),2,BLACKPOOL,ARRECIFE,0,0,0,10990,10990,0,0
17/03/2016 11:32,2015,1,WESTERN EUROPE-EU,SPAIN(CANARY ISLANDS),2,BLACKPOOL,TENERIFE (SURREINA SOFIA),0,0,0,20741,20741,0,0
17/03/2016 11:32,2015,1,WESTERN EUROPE-EU,SPAIN(CANARY ISLANDS),2,BOURNEMOUTH,ARRECIFE,18936,0,18936,35505,13541,21964,-46.66666667
17/03/2016 11:32,2015,1,WESTERN EUROPE-EU,SPAIN(CANARY ISLANDS),2,BOURNEMOUTH,FUERTEVENTURA,0,0,0,9302,9302,0,0
17/03/2016 11:32,2015,1,WESTERN EUROPE-EU,SPAIN(CANARY ISLANDS),2,BOURNEMOUTH,LAS PALMAS,19246,10756,8490,20090,12325,7765,-4.201095072
17/03/2016 11:32,2015,1,WESTERN EUROPE-EU,SPAIN(CANARY ISLANDS),2,BOURNEMOUTH,TENERIFE (SURREINA SOFIA),47190,17995,29195,52695,24356,28339,-10.44691147
17/03/2016 11:32,2015,1,WESTERN EUROPE-EU,SPAIN(CANARY ISLANDS),2,BRISTOL,ARRECIFE,135872,104919,30953,103540,81651,21889,31.2265791
17/03/2016 11:32,2015,1,WESTERN EUROPE-EU,SPAIN(CANARY ISLANDS),2,BRISTOL,FUERTEVENTURA,71307,45243,26064,60493,43238,17255,17.87644851
17/03/2016 11:32,2015,1,WESTERN EUROPE-EU,SPAIN(CANARY ISLANDS),2,BRISTOL,LAS PALMAS,68908,43855,25053,75611,53902,21709,-8.865112219
17/03/2016 11:32,2015,1,WESTERN EUROPE-EU,SPAIN(CANARY ISLANDS),2,BRISTOL,TENERIFE (SURREINA SOFIA),172766,128670,44096,165519,131603,33916,4.378349313
17/03/2016 11:32,2015,1,WESTERN EUROPE-EU,SPAIN(CANARY ISLANDS),2,CARDIFF WALES,ARRECIFE,39601,7033,32568,27721,9008,18713,42.85559684
17/03/2016 11:32,2015,1,WESTERN EUROPE-EU,SPAIN(CANARY ISLANDS),2,CARDIFF WALES,FUERTEVENTURA,1814,0,1814,1216,1063,153,49.17763158
17/03/2016 11:32,2015,1,WESTERN EUROPE-EU,SPAIN(CANARY ISLANDS),2,CARDIFF WALES,LAS PALMAS,18356,0,18356,18333,0,18333,0.125456826
17/03/2016 11:32,2015,1,WESTERN EUROPE-EU,SPAIN(CANARY ISLANDS),2,CARDIFF WALES,TENERIFE (SURREINA SOFIA),60728,25665,35063,49798,12360,37438,21.94867264
17/03/2016 11:32,2015,1,WESTERN EUROPE-EU,SPAIN(CANARY ISLANDS),2,DONCASTER SHEFFIELD,ARRECIFE,19287,0,19287,22740,0,22740,-15.18469657
17/03/2016 11:32,2015,1,WESTERN EUROPE-EU,SPAIN(CANARY ISLANDS),2,DONCASTER SHEFFIELD,LAS PALMAS,18616,0,18616,18147,0,18147,2.58444922
17/03/2016 11:32,2015,1,WESTERN EUROPE-EU,SPAIN(CANARY ISLANDS),2,DONCASTER SHEFFIELD,TENERIFE (SURREINA SOFIA),42770,0,42770,47595,3229,44366,-10.1376195
17/03/2016 11:32,2015,1,WESTERN EUROPE-EU,SPAIN(CANARY ISLANDS),2,EAST MIDLANDS INTERNATIONAL,ARRECIFE,195087,167207,27880,187801,159802,27999,3.879638554
17/03/2016 11:32,2015,1,WESTERN EUROPE-EU,SPAIN(CANARY ISLANDS),2,EAST MIDLANDS INTERNATIONAL,FUERTEVENTURA,96213,77803,18410,89333,70855,18478,7.701521274
17/03/2016 11:32,2015,1,WESTERN EUROPE-EU,SPAIN(CANARY ISLANDS),2,EAST MIDLANDS INTERNATIONAL,LAS PALMAS,77146,64255,12891,79486,62137,17349,-2.943914652
17/03/2016 11:32,2015,1,WESTERN EUROPE-EU,SPAIN(CANARY ISLANDS),2,EAST MIDLANDS INTERNATIONAL,TENERIFE (SURREINA SOFIA),285649,238092,47557,282907,235697,47210,0.969223102
17/03/2016 11:32,2015,1,WESTERN EUROPE-EU,SPAIN(CANARY ISLANDS),2,EDINBURGH,ARRECIFE,60713,40197,20516,62640,42142,20498,-3.076309068
17/03/2016 11:32,2015,1,WESTERN EUROPE-EU,SPAIN(CANARY ISLANDS),2,EDINBURGH,FUERTEVENTURA,19736,19736,0,19026,19026,0,3.73173552
17/03/2016 11:32,2015,1,WESTERN EUROPE-EU,SPAIN(CANARY ISLANDS),2,EDINBURGH,LAS PALMAS,25353,22568,2785,25761,25761,0,-1.583789449
17/03/2016 11:32,2015,1,WESTERN EUROPE-EU,SPAIN(CANARY ISLANDS),2,EDINBURGH,TENERIFE (SURREINA SOFIA),135462,105207,30255,132797,103418,29379,2.006822443
17/03/2016 11:32,2015,1,WESTERN EUROPE-EU,SPAIN(CANARY ISLANDS),2,EXETER,ARRECIFE,21799,0,21799,22619,0,22619,-3.62527079
17/03/2016 11:32,2015,1,WESTERN EUROPE-EU,SPAIN(CANARY ISLANDS),2,EXETER,LAS PALMAS,18386,0,18386,17951,0,17951,2.423263328
17/03/2016 11:32,2015,1,WESTERN EUROPE-EU,SPAIN(CANARY ISLANDS),2,EXETER,TENERIFE (SURREINA SOFIA),35162,0,35162,30565,184,30381,15.04007852
17/03/2016 11:32,2015,1,WESTERN EUROPE-EU,SPAIN(CANARY ISLANDS),2,GLASGOW,ARRECIFE,119395,96437,22958,122892,95412,27480,-2.845587996
17/03/2016 11:32,2015,1,WESTERN EUROPE-EU,SPAIN(CANARY ISLANDS),2,GLASGOW,FUERTEVENTURA,64566,52078,12488,60455,44812,15643,6.800099247
17/03/2016 11:32,2015,1,WESTERN EUROPE-EU,SPAIN(CANARY ISLANDS),2,GLASGOW,LAS PALMAS,70146,47918,22228,67366,44992,22374,4.126710804
17/03/2016 11:32,2015,1,WESTERN EUROPE-EU,SPAIN(CANARY ISLANDS),2,GLASGOW,TENERIFE (SURREINA SOFIA),243759,185467,58292,249684,186782,62902,-2.372999471
17/03/2016 11:32,2015,1,WESTERN EUROPE-EU,SPAIN(CANARY ISLANDS),2,JERSEY,TENERIFE (SURREINA SOFIA),1293,866,427,0,0,0,0
17/03/2016 11:32,2015,1,WESTERN EUROPE-EU,SPAIN(CANARY ISLANDS),2,LEEDS BRADFORD,ARRECIFE,114115,114115,0,122275,122275,0,-6.673481906
17/03/2016 11:32,2015,1,WESTERN EUROPE-EU,SPAIN(CANARY ISLANDS),2,LEEDS BRADFORD,FUERTEVENTURA,56287,56287,0,52572,52572,0,7.066499277
17/03/2016 11:32,2015,1,WESTERN EUROPE-EU,SPAIN(CANARY ISLANDS),2,LEEDS BRADFORD,LAS PALMAS,29074,29074,0,26900,26900,0,8.081784387
17/03/2016 11:32,2015,1,WESTERN EUROPE-EU,SPAIN(CANARY ISLANDS),2,LEEDS BRADFORD,TENERIFE (SURREINA SOFIA),168484,149953,18531,165483,147815,17668,1.81347933
17/03/2016 11:32,2015,1,WESTERN EUROPE-EU,SPAIN(CANARY ISLANDS),2,LIVERPOOL (JOHN LENNON),ARRECIFE,71390,71390,0,72129,72129,0,-1.024553231
17/03/2016 11:32,2015,1,WESTERN EUROPE-EU,SPAIN(CANARY ISLANDS),2,LIVERPOOL (JOHN LENNON),FUERTEVENTURA,56388,56388,0,55283,55283,0,1.998806143
17/03/2016 11:32,2015,1,WESTERN EUROPE-EU,SPAIN(CANARY ISLANDS),2,LIVERPOOL (JOHN LENNON),LAS PALMAS,10609,10609,0,12287,12287,0,-13.65671034
17/03/2016 11:32,2015,1,WESTERN EUROPE-EU,SPAIN(CANARY ISLANDS),2,LIVERPOOL (JOHN LENNON),TENERIFE (SURREINA SOFIA),32303,32303,0,36664,36572,92,-11.89450142
17/03/2016 11:32,2015,1,WESTERN EUROPE-EU,SPAIN(CANARY ISLANDS),2,MANCHESTER,ARRECIFE,397680,311830,85850,388189,302436,85753,2.444943056
17/03/2016 11:32,2015,1,WESTERN EUROPE-EU,SPAIN(CANARY ISLANDS),2,MANCHESTER,FUERTEVENTURA,207321,159441,47880,184278,131715,52563,12.50447693
17/03/2016 11:32,2015,1,WESTERN EUROPE-EU,SPAIN(CANARY ISLANDS),2,MANCHESTER,LAS PALMAS,206013,136912,69101,223221,149647,73574,-7.708952115
17/03/2016 11:32,2015,1,WESTERN EUROPE-EU,SPAIN(CANARY ISLANDS),2,MANCHESTER,SANTA CRUZ DE LA PALMA,18741,0,18741,9779,0,9779,91.64536251
17/03/2016 11:32,2015,1,WESTERN EUROPE-EU,SPAIN(CANARY ISLANDS),2,MANCHESTER,TENERIFE (SURREINA SOFIA),725492,583071,142421,743069,597176,145893,-2.365460004
17/03/2016 11:32,2015,1,WESTERN EUROPE-EU,SPAIN(CANARY ISLANDS),2,NEWCASTLE,ARRECIFE,95399,66833,28566,89912,71563,18349,6.102633686
17/03/2016 11:32,2015,1,WESTERN EUROPE-EU,SPAIN(CANARY ISLANDS),2,NEWCASTLE,FUERTEVENTURA,38554,31582,6972,36772,34756,2016,4.846078538
17/03/2016 11:32,2015,1,WESTERN EUROPE-EU,SPAIN(CANARY ISLANDS),2,NEWCASTLE,LAS PALMAS,37801,16524,21277,48588,30508,18080,-22.20095497
17/03/2016 11:32,2015,1,WESTERN EUROPE-EU,SPAIN(CANARY ISLANDS),2,NEWCASTLE,TENERIFE (SURREINA SOFIA),174716,116403,58313,183842,139104,44738,-4.964045213
17/03/2016 11:32,2015,1,WESTERN EUROPE-EU,SPAIN(CANARY ISLANDS),2,NORWICH,LAS PALMAS,4241,0,4241,0,0,0,0
17/03/2016 11:32,2015,1,WESTERN EUROPE-EU,SPAIN(CANARY ISLANDS),2,NORWICH,TENERIFE (SURREINA SOFIA),19159,0,19159,16554,0,16554,15.73637791
17/03/2016 11:32,2015,1,WESTERN EUROPE-EU,SPAIN(CANARY ISLANDS),2,PRESTWICK,ARRECIFE,37069,37069,0,40377,40377,0,-8.19278302
17/03/2016 11:32,2015,1,WESTERN EUROPE-EU,SPAIN(CANARY ISLANDS),2,PRESTWICK,FUERTEVENTURA,19136,19136,0,18068,18068,0,5.911002878
17/03/2016 11:32,2015,1,WESTERN EUROPE-EU,SPAIN(CANARY ISLANDS),2,PRESTWICK,LAS PALMAS,30607,30607,0,29054,29054,0,5.345219247
17/03/2016 11:32,2015,1,WESTERN EUROPE-EU,SPAIN(CANARY ISLANDS),2,PRESTWICK,TENERIFE (SURREINA SOFIA),81077,81065,12,73389,73389,0,10.47568437
17/03/2016 11:32,2015,1,WESTERN EUROPE-EU,SPAIN(CANARY ISLANDS),2,SOUTHAMPTON,TENERIFE (SURREINA SOFIA),310,0,310,0,0,0,0
17/03/2016 11:32,2015,1,WESTERN EUROPE-EU,SWEDEN,1,GATWICK,GOTEBORG (LANDVETTER),87020,87020,0,72695,72695,0,19.70561937
17/03/2016 11:32,2015,1,WESTERN EUROPE-EU,SWEDEN,1,GATWICK,KIRUNA,820,0,820,1851,0,1851,-55.69962183
17/03/2016 11:32,2015,1,WESTERN EUROPE-EU,SWEDEN,1,GATWICK,MALMO,76,76,0,4334,4334,0,-98.24642363
17/03/2016 11:32,2015,1,WESTERN EUROPE-EU,SWEDEN,1,GATWICK,PAJALA YLLAS,335,0,335,338,0,338,-0.887573964
17/03/2016 11:32,2015,1,WESTERN EUROPE-EU,SWEDEN,1,GATWICK,STOCKHOLM (ARLANDA),405387,405377,10,451402,451392,10,-10.19379622
17/03/2016 11:32,2015,1,WESTERN EUROPE-EU,SWEDEN,1,HEATHROW,GOTEBORG (LANDVETTER),289269,289269,0,292777,292777,0,-1.198181551
17/03/2016 11:32,2015,1,WESTERN EUROPE-EU,SWEDEN,1,HEATHROW,KIRUNA,2856,0,2856,3417,0,3417,-16.41791045
17/03/2016 11:32,2015,1,WESTERN EUROPE-EU,SWEDEN,1,HEATHROW,STOCKHOLM (ARLANDA),1002530,1002530,0,935913,935913,0,7.117862451
17/03/2016 11:32,2015,1,WESTERN EUROPE-EU,SWEDEN,1,LONDON CITY,STOCKHOLM (ARLANDA),0,0,0,50643,50643,0,0
17/03/2016 11:32,2015,1,WESTERN EUROPE-EU,SWEDEN,1,LUTON,STOCKHOLM (ARLANDA),18,0,18,21,0,21,-14.28571429
17/03/2016 11:32,2015,1,WESTERN EUROPE-EU,SWEDEN,1,LUTON,STOCKHOLM (BROMMA),16,0,16,0,0,0,0
17/03/2016 11:32,2015,1,WESTERN EUROPE-EU,SWEDEN,1,STANSTED,GOTEBORG (LANDVETTER),242260,242260,0,17962,17962,0,1248.736221
17/03/2016 11:32,2015,1,WESTERN EUROPE-EU,SWEDEN,1,STANSTED,GOTEBORG CITY,0,0,0,182886,182886,0,0
17/03/2016 11:32,2015,1,WESTERN EUROPE-EU,SWEDEN,1,STANSTED,MALMO,0,0,0,38407,38407,0,0
17/03/2016 11:32,2015,1,WESTERN EUROPE-EU,SWEDEN,1,STANSTED,PAJALA YLLAS,327,0,327,332,0,332,-1.506024096
17/03/2016 11:32,2015,1,WESTERN EUROPE-EU,SWEDEN,1,STANSTED,SKELLEFTEA,21519,21519,0,19609,19609,0,9.740425315
17/03/2016 11:32,2015,1,WESTERN EUROPE-EU,SWEDEN,1,STANSTED,STOCKHOLM (SKAVSTA),237479,237479,0,228882,228882,0,3.756083921
17/03/2016 11:32,2015,1,WESTERN EUROPE-EU,SWEDEN,1,STANSTED,VASTERAS,70256,70256,0,69170,69170,0,1.570044817
17/03/2016 11:32,2015,1,WESTERN EUROPE-EU,SWEDEN,2,ABERDEEN,GOTEBORG (LANDVETTER),78,0,78,0,0,0,0
17/03/2016 11:32,2015,1,WESTERN EUROPE-EU,SWEDEN,2,ABERDEEN,KARLSTAD,0,0,0,3,0,3,0
17/03/2016 11:32,2015,1,WESTERN EUROPE-EU,SWEDEN,2,BELFAST INTERNATIONAL,STOCKHOLM (ARLANDA),175,0,175,98,0,98,78.57142857
17/03/2016 11:32,2015,1,WESTERN EUROPE-EU,SWEDEN,2,BELFAST INTERNATIONAL,STOCKHOLM (BROMMA),0,0,0,75,0,75,0
17/03/2016 11:32,2015,1,WESTERN EUROPE-EU,SWEDEN,2,BIRMINGHAM,GOTEBORG (LANDVETTER),3105,2791,314,14791,14791,0,-79.00750456
17/03/2016 11:32,2015,1,WESTERN EUROPE-EU,SWEDEN,2,BIRMINGHAM,KIRUNA,376,0,376,144,0,144,161.1111111
17/03/2016 11:32,2015,1,WESTERN EUROPE-EU,SWEDEN,2,BIRMINGHAM,MALMO,43,0,43,0,0,0,0
17/03/2016 11:32,2015,1,WESTERN EUROPE-EU,SWEDEN,2,BIRMINGHAM,PAJALA YLLAS,333,0,333,0,0,0,0
17/03/2016 11:32,2015,1,WESTERN EUROPE-EU,SWEDEN,2,BIRMINGHAM,STOCKHOLM (ARLANDA),72,0,72,8563,8563,0,-99.15917319
17/03/2016 11:32,2015,1,WESTERN EUROPE-EU,SWEDEN,2,BIRMINGHAM,STOCKHOLM (BROMMA),24,0,24,0,0,0,0
17/03/2016 11:32,2015,1,WESTERN EUROPE-EU,SWEDEN,2,BOURNEMOUTH,KIRUNA,215,0,215,256,0,256,-16.015625
17/03/2016 11:32,2015,1,WESTERN EUROPE-EU,SWEDEN,2,BOURNEMOUTH,PAJALA YLLAS,336,0,336,312,0,312,7.692307692
17/03/2016 11:32,2015,1,WESTERN EUROPE-EU,SWEDEN,2,BRISTOL,KIRUNA,101,0,101,268,0,268,-62.31343284
17/03/2016 11:32,2015,1,WESTERN EUROPE-EU,SWEDEN,2,BRISTOL,STOCKHOLM (ARLANDA),3141,3141,0,2878,2878,0,9.138290479
17/03/2016 11:32,2015,1,WESTERN EUROPE-EU,SWEDEN,2,CARDIFF WALES,PAJALA YLLAS,336,0,336,326,0,326,3.067484663
17/03/2016 11:32,2015,1,WESTERN EUROPE-EU,SWEDEN,2,DONCASTER SHEFFIELD,KIRUNA,270,0,270,0,0,0,0
17/03/2016 11:32,2015,1,WESTERN EUROPE-EU,SWEDEN,2,DURHAM TEES VALLEY,PAJALA YLLAS,332,0,332,0,0,0,0
17/03/2016 11:32,2015,1,WESTERN EUROPE-EU,SWEDEN,2,EAST MIDLANDS INTERNATIONAL,KIRUNA,152,0,152,247,0,247,-38.46153846
17/03/2016 11:32,2015,1,WESTERN EUROPE-EU,SWEDEN,2,EAST MIDLANDS INTERNATIONAL,PAJALA YLLAS,0,0,0,335,0,335,0
17/03/2016 11:32,2015,1,WESTERN EUROPE-EU,SWEDEN,2,EDINBURGH,GOTEBORG (LANDVETTER),20787,20633,154,211,0,211,9751.658768
17/03/2016 11:32,2015,1,WESTERN EUROPE-EU,SWEDEN,2,EDINBURGH,GOTEBORG CITY,0,0,0,21177,21177,0,0
17/03/2016 11:32,2015,1,WESTERN EUROPE-EU,SWEDEN,2,EDINBURGH,STOCKHOLM (ARLANDA),83605,83390,215,62002,61758,244,34.84242444
17/03/2016 11:32,2015,1,WESTERN EUROPE-EU,SWEDEN,2,EXETER,KIRUNA,150,0,150,88,0,88,70.45454545
17/03/2016 11:32,2015,1,WESTERN EUROPE-EU,SWEDEN,2,EXETER,MALMO,154,0,154,0,0,0,0
17/03/2016 11:32,2015,1,WESTERN EUROPE-EU,SWEDEN,2,EXETER,PAJALA YLLAS,336,0,336,332,0,332,1.204819277
17/03/2016 11:32,2015,1,WESTERN EUROPE-EU,SWEDEN,2,EXETER,STOCKHOLM (ARLANDA),11,0,11,0,0,0,0
17/03/2016 11:32,2015,1,WESTERN EUROPE-EU,SWEDEN,2,GLASGOW,GOTEBORG (LANDVETTER),273,0,273,0,0,0,0
17/03/2016 11:32,2015,1,WESTERN EUROPE-EU,SWEDEN,2,GLASGOW,MALMO,914,0,914,94,0,94,872.3404255
17/03/2016 11:32,2015,1,WESTERN EUROPE-EU,SWEDEN,2,GLASGOW,STOCKHOLM (ARLANDA),0,0,0,26,0,26,0
17/03/2016 11:32,2015,1,WESTERN EUROPE-EU,SWEDEN,2,GLASGOW,VAXJO,63,0,63,0,0,0,0
17/03/2016 11:32,2015,1,WESTERN EUROPE-EU,SWEDEN,2,HUMBERSIDE,KIRUNA,164,0,164,182,0,182,-9.89010989
17/03/2016 11:32,2015,1,WESTERN EUROPE-EU,SWEDEN,2,HUMBERSIDE,PAJALA YLLAS,168,0,168,338,0,338,-50.29585799
17/03/2016 11:32,2015,1,WESTERN EUROPE-EU,SWEDEN,2,ISLE OF MAN,OSTERSUND / FROSON,0,0,0,69,0,69,0
17/03/2016 11:32,2015,1,WESTERN EUROPE-EU,SWEDEN,2,JERSEY,VISBY,268,0,268,0,0,0,0
17/03/2016 11:32,2015,1,WESTERN EUROPE-EU,SWEDEN,2,LEEDS BRADFORD,KARLSTAD,0,0,0,81,0,81,0
17/03/2016 11:32,2015,1,WESTERN EUROPE-EU,SWEDEN,2,LEEDS BRADFORD,KIRUNA,226,0,226,241,0,241,-6.22406639
17/03/2016 11:32,2015,1,WESTERN EUROPE-EU,SWEDEN,2,LIVERPOOL (JOHN LENNON),MALMO,0,0,0,355,0,355,0
17/03/2016 11:32,2015,1,WESTERN EUROPE-EU,SWEDEN,2,LIVERPOOL (JOHN LENNON),PAJALA YLLAS,317,0,317,0,0,0,0
17/03/2016 11:32,2015,1,WESTERN EUROPE-EU,SWEDEN,2,MANCHESTER,GOTEBORG (LANDVETTER),4323,4299,24,3312,3312,0,30.52536232
17/03/2016 11:32,2015,1,WESTERN EUROPE-EU,SWEDEN,2,MANCHESTER,KIRUNA,247,0,247,254,0,254,-2.755905512
17/03/2016 11:32,2015,1,WESTERN EUROPE-EU,SWEDEN,2,MANCHESTER,STOCKHOLM (ARLANDA),119770,119770,0,109141,108765,376,9.738778278
17/03/2016 11:32,2015,1,WESTERN EUROPE-EU,SWEDEN,2,NEWCASTLE,GOTEBORG CITY,8,0,8,0,0,0,0
17/03/2016 11:32,2015,1,WESTERN EUROPE-EU,SWEDEN,2,NEWCASTLE,KIRUNA,213,0,213,0,0,0,0
17/03/2016 11:32,2015,1,WESTERN EUROPE-EU,SWEDEN,2,NORWICH,PAJALA YLLAS,332,0,332,334,0,334,-0.598802395
17/03/2016 11:32,2015,2,WESTERN-EUROPE-OTHER,BOSNIA-HERZEGOVINA,2,CARDIFF WALES,SARAJEVO,158,0,158,152,0,152,3.947368421
17/03/2016 11:32,2015,2,WESTERN-EUROPE-OTHER,FAROE ISLANDS,1,GATWICK,VAGAR,243,0,243,0,0,0,0
17/03/2016 11:32,2015,2,WESTERN-EUROPE-OTHER,FAROE ISLANDS,1,STANSTED,VAGAR,532,0,532,3659,3659,0,-85.46050834
17/03/2016 11:32,2015,2,WESTERN-EUROPE-OTHER,FAROE ISLANDS,2,ABERDEEN,VAGAR,288,0,288,1372,0,1372,-79.00874636
17/03/2016 11:32,2015,2,WESTERN-EUROPE-OTHER,FAROE ISLANDS,2,BELFAST CITY (GEORGE BEST),VAGAR,78,0,78,0,0,0,0
17/03/2016 11:32,2015,2,WESTERN-EUROPE-OTHER,FAROE ISLANDS,2,BELFAST INTERNATIONAL,VAGAR,70,0,70,714,0,714,-90.19607843
17/03/2016 11:32,2015,2,WESTERN-EUROPE-OTHER,FAROE ISLANDS,2,EDINBURGH,VAGAR,8285,8285,0,0,0,0,0
17/03/2016 11:32,2015,2,WESTERN-EUROPE-OTHER,FAROE ISLANDS,2,JERSEY,VAGAR,497,0,497,0,0,0,0
17/03/2016 11:32,2015,2,WESTERN-EUROPE-OTHER,ICELAND,1,GATWICK,EGILSSTADIR,0,0,0,216,0,216,0
17/03/2016 11:32,2015,2,WESTERN-EUROPE-OTHER,ICELAND,1,GATWICK,KEFLAVIK,312650,312440,210,238366,238245,121,31.16384048
17/03/2016 11:32,2015,2,WESTERN-EUROPE-OTHER,ICELAND,1,HEATHROW,KEFLAVIK,240313,240313,0,214421,214421,0,12.07530979
17/03/2016 11:32,2015,2,WESTERN-EUROPE-OTHER,ICELAND,1,LUTON,KEFLAVIK,100530,100507,23,86034,86034,0,16.84915266
17/03/2016 11:32,2015,2,WESTERN-EUROPE-OTHER,ICELAND,1,STANSTED,EGILSSTADIR,0,0,0,47,0,47,0
17/03/2016 11:32,2015,2,WESTERN-EUROPE-OTHER,ICELAND,1,STANSTED,KEFLAVIK,4968,4968,0,0,0,0,0
17/03/2016 11:32,2015,2,WESTERN-EUROPE-OTHER,ICELAND,2,ABERDEEN,KEFLAVIK,28,0,28,101,0,101,-72.27722772
17/03/2016 11:32,2015,2,WESTERN-EUROPE-OTHER,ICELAND,2,BELFAST INTERNATIONAL,KEFLAVIK,26133,26133,0,1025,660,365,2449.560976
17/03/2016 11:32,2015,2,WESTERN-EUROPE-OTHER,ICELAND,2,BELFAST INTERNATIONAL,REYKJAVIK,0,0,0,768,768,0,0
17/03/2016 11:32,2015,2,WESTERN-EUROPE-OTHER,ICELAND,2,BIRMINGHAM,KEFLAVIK,29486,29486,0,7051,7051,0,318.1818182
17/03/2016 11:32,2015,2,WESTERN-EUROPE-OTHER,ICELAND,2,BRISTOL,KEFLAVIK,37435,37435,0,34042,34042,0,9.967099465
17/03/2016 11:32,2015,2,WESTERN-EUROPE-OTHER,ICELAND,2,EAST MIDLANDS INTERNATIONAL,KEFLAVIK,181,0,181,0,0,0,0
17/03/2016 11:32,2015,2,WESTERN-EUROPE-OTHER,ICELAND,2,EDINBURGH,KEFLAVIK,37681,37681,0,31726,31612,114,18.77009393
17/03/2016 11:32,2015,2,WESTERN-EUROPE-OTHER,ICELAND,2,GLASGOW,KEFLAVIK,74772,74592,180,65203,64793,410,14.67570511
17/03/2016 11:32,2015,2,WESTERN-EUROPE-OTHER,ICELAND,2,MANCHESTER,KEFLAVIK,110212,110212,0,89117,88577,540,23.67112897
17/03/2016 11:32,2015,2,WESTERN-EUROPE-OTHER,ICELAND,2,PRESTWICK,REYKJAVIK,103,0,103,0,0,0,0
17/03/2016 11:32,2015,2,WESTERN-EUROPE-OTHER,KOSOVO,1,GATWICK,PRISTINA,14114,14114,0,13344,13344,0,5.770383693
17/03/2016 11:32,2015,2,WESTERN-EUROPE-OTHER,MACEDONIA,1,LUTON,OHRID,7639,7639,0,0,0,0,0
17/03/2016 11:32,2015,2,WESTERN-EUROPE-OTHER,MACEDONIA,1,LUTON,SKOPJE,71251,71251,0,64775,64775,0,9.997684292
17/03/2016 11:32,2015,2,WESTERN-EUROPE-OTHER,MACEDONIA,2,ABERDEEN,SKOPJE,198,0,198,0,0,0,0
17/03/2016 11:32,2015,2,WESTERN-EUROPE-OTHER,MACEDONIA,2,BELFAST INTERNATIONAL,OHRID,136,0,136,0,0,0,0
17/03/2016 11:32,2015,2,WESTERN-EUROPE-OTHER,NORWAY,1,GATWICK,ALESUND,23307,23307,0,25817,25817,0,-9.72227602
17/03/2016 11:32,2015,2,WESTERN-EUROPE-OTHER,NORWAY,1,GATWICK,BERGEN,180386,179130,1256,182590,179745,2845,-1.207075963
17/03/2016 11:32,2015,2,WESTERN-EUROPE-OTHER,NORWAY,1,GATWICK,BODO,559,0,559,0,0,0,0
17/03/2016 11:32,2015,2,WESTERN-EUROPE-OTHER,NORWAY,1,GATWICK,EVENES,0,0,0,538,0,538,0
17/03/2016 11:32,2015,2,WESTERN-EUROPE-OTHER,NORWAY,1,GATWICK,FAGERNES/LEIRIN,3106,0,3106,2845,0,2845,9.173989455
17/03/2016 11:32,2015,2,WESTERN-EUROPE-OTHER,NORWAY,1,GATWICK,OSLO (GARDERMOEN),306246,306246,0,337905,337905,0,-9.369201403
17/03/2016 11:32,2015,2,WESTERN-EUROPE-OTHER,NORWAY,1,GATWICK,SANDEFJORD(TORP),32751,32751,0,49787,49787,0,-34.21776769
17/03/2016 11:32,2015,2,WESTERN-EUROPE-OTHER,NORWAY,1,GATWICK,STAVANGER,71005,71005,0,68751,68751,0,3.278497767
17/03/2016 11:32,2015,2,WESTERN-EUROPE-OTHER,NORWAY,1,GATWICK,TROMSOE,11034,8680,2354,30418,26426,3992,-63.72542573
17/03/2016 11:32,2015,2,WESTERN-EUROPE-OTHER,NORWAY,1,GATWICK,TRONDHEIM (VAERNES),68749,68749,0,65961,65961,0,4.226740043
17/03/2016 11:32,2015,2,WESTERN-EUROPE-OTHER,NORWAY,1,HEATHROW,BERGEN,126022,126022,0,114275,114275,0,10.27958871
17/03/2016 11:32,2015,2,WESTERN-EUROPE-OTHER,NORWAY,1,HEATHROW,OSLO (GARDERMOEN),686856,686856,0,695981,695981,0,-1.31109901
17/03/2016 11:32,2015,2,WESTERN-EUROPE-OTHER,NORWAY,1,HEATHROW,STAVANGER,198555,198555,0,212987,212987,0,-6.776000413
17/03/2016 11:32,2015,2,WESTERN-EUROPE-OTHER,NORWAY,1,LUTON,ALESUND,0,0,0,167,0,167,0
17/03/2016 11:32,2015,2,WESTERN-EUROPE-OTHER,NORWAY,1,LUTON,BERGEN,37,0,37,19,0,19,94.73684211
17/03/2016 11:32,2015,2,WESTERN-EUROPE-OTHER,NORWAY,1,LUTON,OSLO (GARDERMOEN),58,0,58,0,0,0,0
17/03/2016 11:32,2015,2,WESTERN-EUROPE-OTHER,NORWAY,1,STANSTED,BERGEN,0,0,0,510,0,510,0
17/03/2016 11:32,2015,2,WESTERN-EUROPE-OTHER,NORWAY,1,STANSTED,HAUGESUND,23916,23916,0,29033,29033,0,-17.62477181
17/03/2016 11:32,2015,2,WESTERN-EUROPE-OTHER,NORWAY,1,STANSTED,RYGGE,286983,286983,0,254616,254616,0,12.71208408
17/03/2016 11:32,2015,2,WESTERN-EUROPE-OTHER,NORWAY,1,STANSTED,SANDEFJORD(TORP),77594,77594,0,88938,88938,0,-12.75495289
17/03/2016 11:32,2015,2,WESTERN-EUROPE-OTHER,NORWAY,1,STANSTED,TROMSOE,282,0,282,0,0,0,0
17/03/2016 11:32,2015,2,WESTERN-EUROPE-OTHER,NORWAY,2,ABERDEEN,BERGEN,43964,43964,0,51870,51635,235,-15.24195103
17/03/2016 11:32,2015,2,WESTERN-EUROPE-OTHER,NORWAY,2,ABERDEEN,KRISTIANSUND (KUERNBERGET),0,0,0,2470,2422,48,0
17/03/2016 11:32,2015,2,WESTERN-EUROPE-OTHER,NORWAY,2,ABERDEEN,OSLO (GARDERMOEN),36075,36063,12,30795,30795,0,17.14564053
17/03/2016 11:32,2015,2,WESTERN-EUROPE-OTHER,NORWAY,2,ABERDEEN,STAVANGER,116837,116711,126,138334,138273,61,-15.53992511
17/03/2016 11:32,2015,2,WESTERN-EUROPE-OTHER,NORWAY,2,ABERDEEN,TRONDHEIM (VAERNES),0,0,0,33,0,33,0
17/03/2016 11:32,2015,2,WESTERN-EUROPE-OTHER,NORWAY,2,BELFAST INTERNATIONAL,OSLO (GARDERMOEN),110,110,0,0,0,0,0
17/03/2016 11:32,2015,2,WESTERN-EUROPE-OTHER,NORWAY,2,BELFAST INTERNATIONAL,TROMSOE,0,0,0,236,0,236,0
17/03/2016 11:32,2015,2,WESTERN-EUROPE-OTHER,NORWAY,2,BIRMINGHAM,BERGEN,0,0,0,219,0,219,0
17/03/2016 11:32,2015,2,WESTERN-EUROPE-OTHER,NORWAY,2,BIRMINGHAM,OSLO (GARDERMOEN),4989,4989,0,3974,3974,0,25.54101661
17/03/2016 11:32,2015,2,WESTERN-EUROPE-OTHER,NORWAY,2,BIRMINGHAM,TROMSOE,112,0,112,0,0,0,0
17/03/2016 11:32,2015,2,WESTERN-EUROPE-OTHER,NORWAY,2,BOURNEMOUTH,BERGEN,225,0,225,408,0,408,-44.85294118
17/03/2016 11:32,2015,2,WESTERN-EUROPE-OTHER,NORWAY,2,BOURNEMOUTH,TROMSOE,381,0,381,269,0,269,41.63568773
17/03/2016 11:32,2015,2,WESTERN-EUROPE-OTHER,NORWAY,2,BRISTOL,BERGEN,264,0,264,750,0,750,-64.8
17/03/2016 11:32,2015,2,WESTERN-EUROPE-OTHER,NORWAY,2,BRISTOL,TROMSOE,324,0,324,292,0,292,10.95890411
17/03/2016 11:32,2015,2,WESTERN-EUROPE-OTHER,NORWAY,2,CARDIFF WALES,TROMSOE,138,0,138,0,0,0,0
17/03/2016 11:32,2015,2,WESTERN-EUROPE-OTHER,NORWAY,2,DUNDEE,OSLO (GARDERMOEN),30,0,30,0,0,0,0
17/03/2016 11:32,2015,2,WESTERN-EUROPE-OTHER,NORWAY,2,EAST MIDLANDS INTERNATIONAL,BERGEN,169,0,169,0,0,0,0
17/03/2016 11:32,2015,2,WESTERN-EUROPE-OTHER,NORWAY,2,EAST MIDLANDS INTERNATIONAL,TROMSOE,344,0,344,0,0,0,0
17/03/2016 11:32,2015,2,WESTERN-EUROPE-OTHER,NORWAY,2,EDINBURGH,BERGEN,0,0,0,12352,12274,78,0
17/03/2016 11:32,2015,2,WESTERN-EUROPE-OTHER,NORWAY,2,EDINBURGH,OSLO (GARDERMOEN),81774,81415,359,73388,73388,0,11.42693628
17/03/2016 11:32,2015,2,WESTERN-EUROPE-OTHER,NORWAY,2,EDINBURGH,RYGGE,40009,40009,0,39267,39267,0,1.889627423
17/03/2016 11:32,2015,2,WESTERN-EUROPE-OTHER,NORWAY,2,EDINBURGH,STAVANGER,31,31,0,3306,2968,338,-99.06231095
17/03/2016 11:32,2015,2,WESTERN-EUROPE-OTHER,NORWAY,2,EDINBURGH,TRONDHEIM (VAERNES),0,0,0,355,0,355,0
17/03/2016 11:32,2015,2,WESTERN-EUROPE-OTHER,NORWAY,2,GLASGOW,BERGEN,252,0,252,350,0,350,-28
17/03/2016 11:32,2015,2,WESTERN-EUROPE-OTHER,NORWAY,2,GLASGOW,MOLDE,1181,0,1181,0,0,0,0
17/03/2016 11:32,2015,2,WESTERN-EUROPE-OTHER,NORWAY,2,GLASGOW,TROMSOE,194,0,194,246,0,246,-21.13821138
17/03/2016 11:32,2015,2,WESTERN-EUROPE-OTHER,NORWAY,2,INVERNESS,ALESUND,0,0,0,31,0,31,0
17/03/2016 11:32,2015,2,WESTERN-EUROPE-OTHER,NORWAY,2,INVERNESS,STAVANGER,0,0,0,32,0,32,0
17/03/2016 11:32,2015,2,WESTERN-EUROPE-OTHER,NORWAY,2,JERSEY,KRISTIANSAND (KJEVIK),0,0,0,233,0,233,0
17/03/2016 11:32,2015,2,WESTERN-EUROPE-OTHER,NORWAY,2,JERSEY,TROMSOE,144,0,144,0,0,0,0
17/03/2016 11:32,2015,2,WESTERN-EUROPE-OTHER,NORWAY,2,JERSEY,TRONDHEIM (VAERNES),162,0,162,0,0,0,0
17/03/2016 11:32,2015,2,WESTERN-EUROPE-OTHER,NORWAY,2,KIRKWALL,BERGEN,196,0,196,0,0,0,0
17/03/2016 11:32,2015,2,WESTERN-EUROPE-OTHER,NORWAY,2,LEEDS BRADFORD,BERGEN,0,0,0,254,0,254,0
17/03/2016 11:32,2015,2,WESTERN-EUROPE-OTHER,NORWAY,2,LEEDS BRADFORD,OSLO (GARDERMOEN),37,0,37,0,0,0,0
17/03/2016 11:32,2015,2,WESTERN-EUROPE-OTHER,NORWAY,2,LEEDS BRADFORD,STAVANGER,143,0,143,0,0,0,0
17/03/2016 11:32,2015,2,WESTERN-EUROPE-OTHER,NORWAY,2,LIVERPOOL (JOHN LENNON),HAUGESUND,0,0,0,133,0,133,0
17/03/2016 11:32,2015,2,WESTERN-EUROPE-OTHER,NORWAY,2,LIVERPOOL (JOHN LENNON),OSLO (GARDERMOEN),296,0,296,640,0,640,-53.75
17/03/2016 11:32,2015,2,WESTERN-EUROPE-OTHER,NORWAY,2,LIVERPOOL (JOHN LENNON),SANDEFJORD(TORP),33495,33495,0,29732,29732,0,12.65639715
17/03/2016 11:32,2015,2,WESTERN-EUROPE-OTHER,NORWAY,2,LIVERPOOL (JOHN LENNON),STAVANGER,1012,0,1012,200,0,200,406
17/03/2016 11:32,2015,2,WESTERN-EUROPE-OTHER,NORWAY,2,MANCHESTER,BERGEN,11162,9908,1254,10635,7692,2943,4.955336154
17/03/2016 11:32,2015,2,WESTERN-EUROPE-OTHER,NORWAY,2,MANCHESTER,HAUGESUND,0,0,0,45,0,45,0
17/03/2016 11:32,2015,2,WESTERN-EUROPE-OTHER,NORWAY,2,MANCHESTER,OSLO (GARDERMOEN),96855,96855,0,82004,81748,256,18.11009219
17/03/2016 11:32,2015,2,WESTERN-EUROPE-OTHER,NORWAY,2,MANCHESTER,RYGGE,64321,64321,0,60404,60404,0,6.484669889
17/03/2016 11:32,2015,2,WESTERN-EUROPE-OTHER,NORWAY,2,MANCHESTER,STAVANGER,24747,24747,0,22262,22192,70,11.16251909
17/03/2016 11:32,2015,2,WESTERN-EUROPE-OTHER,NORWAY,2,MANCHESTER,TROMSOE,1216,0,1216,835,0,835,45.62874251
17/03/2016 11:32,2015,2,WESTERN-EUROPE-OTHER,NORWAY,2,MANCHESTER,TRONDHEIM (VAERNES),0,0,0,143,0,143,0
17/03/2016 11:32,2015,2,WESTERN-EUROPE-OTHER,NORWAY,2,NEWCASTLE,BERGEN,571,0,571,474,0,474,20.46413502
17/03/2016 11:32,2015,2,WESTERN-EUROPE-OTHER,NORWAY,2,NEWCASTLE,SANDEFJORD(TORP),152,0,152,0,0,0,0
17/03/2016 11:32,2015,2,WESTERN-EUROPE-OTHER,NORWAY,2,NEWCASTLE,STAVANGER,13906,13906,0,20171,20171,0,-31.05944177
17/03/2016 11:32,2015,2,WESTERN-EUROPE-OTHER,NORWAY,2,NEWCASTLE,TROMSOE,388,0,388,0,0,0,0
17/03/2016 11:32,2015,2,WESTERN-EUROPE-OTHER,NORWAY,2,PRESTWICK,BERGEN,145,0,145,0,0,0,0
17/03/2016 11:32,2015,2,WESTERN-EUROPE-OTHER,NORWAY,2,SOUTHAMPTON,OSLO (GARDERMOEN),40,0,40,0,0,0,0
17/03/2016 11:32,2015,2,WESTERN-EUROPE-OTHER,NORWAY,2,STORNOWAY,OSLO (GARDERMOEN),2,0,2,0,0,0,0
17/03/2016 11:32,2015,2,WESTERN-EUROPE-OTHER,NORWAY,2,SUMBURGH,BERGEN,958,958,0,691,653,38,38.63965268
17/03/2016 11:32,2015,2,WESTERN-EUROPE-OTHER,NORWAY,2,SUMBURGH,HAUGESUND,20,20,0,0,0,0,0
17/03/2016 11:32,2015,2,WESTERN-EUROPE-OTHER,NORWAY,2,WICK JOHN O GROATS,ALESUND,54,0,54,0,0,0,0
17/03/2016 11:32,2015,2,WESTERN-EUROPE-OTHER,NORWAY,2,WICK JOHN O GROATS,BERGEN,0,0,0,30,0,30,0
17/03/2016 11:32,2015,2,WESTERN-EUROPE-OTHER,REPUBLIC OF MONTENEGRO,1,GATWICK,TIVAT,13739,13739,0,11138,11138,0,23.35248698
17/03/2016 11:32,2015,2,WESTERN-EUROPE-OTHER,REPUBLIC OF MONTENEGRO,1,LUTON,TIVAT,0,0,0,32,0,32,0
17/03/2016 11:32,2015,2,WESTERN-EUROPE-OTHER,REPUBLIC OF MONTENEGRO,1,STANSTED,PODGORICA,36223,36223,0,25791,25791,0,40.44821837
17/03/2016 11:32,2015,2,WESTERN-EUROPE-OTHER,REPUBLIC OF SERBIA,1,HEATHROW,BELGRADE,84536,84536,0,84066,84066,0,0.559084529
17/03/2016 11:32,2015,2,WESTERN-EUROPE-OTHER,REPUBLIC OF SERBIA,1,LUTON,BELGRADE,43294,43272,22,45910,45910,0,-5.698104988
17/03/2016 11:32,2015,2,WESTERN-EUROPE-OTHER,SWITZERLAND,1,GATWICK,BALE MULHOUSE,270273,270273,0,249973,249973,0,8.120877055
17/03/2016 11:32,2015,2,WESTERN-EUROPE-OTHER,SWITZERLAND,1,GATWICK,GENEVA,844939,792722,52217,816778,745906,70872,3.447815686
17/03/2016 11:32,2015,2,WESTERN-EUROPE-OTHER,SWITZERLAND,1,GATWICK,ZURICH,176164,175870,294,177375,177375,0,-0.68273432
17/03/2016 11:32,2015,2,WESTERN-EUROPE-OTHER,SWITZERLAND,1,HEATHROW,BALE MULHOUSE,246933,246933,0,226374,226374,0,9.08187336
17/03/2016 11:32,2015,2,WESTERN-EUROPE-OTHER,SWITZERLAND,1,HEATHROW,GENEVA,1021882,1018666,3216,1018551,1013631,4920,0.327033207
17/03/2016 11:32,2015,2,WESTERN-EUROPE-OTHER,SWITZERLAND,1,HEATHROW,ZURICH,1075098,1074736,362,1048878,1048159,719,2.499814087
17/03/2016 11:32,2015,2,WESTERN-EUROPE-OTHER,SWITZERLAND,1,LONDON CITY,BALE MULHOUSE,37028,37028,0,71373,71373,0,-48.1204377
17/03/2016 11:32,2015,2,WESTERN-EUROPE-OTHER,SWITZERLAND,1,LONDON CITY,BERNE,5097,5097,0,20202,20202,0,-74.76982477
17/03/2016 11:32,2015,2,WESTERN-EUROPE-OTHER,SWITZERLAND,1,LONDON CITY,GENEVA,176451,176451,0,178955,178955,0,-1.399234444
17/03/2016 11:32,2015,2,WESTERN-EUROPE-OTHER,SWITZERLAND,1,LONDON CITY,ZURICH,397363,397363,0,392899,392899,0,1.136169855
17/03/2016 11:32,2015,2,WESTERN-EUROPE-OTHER,SWITZERLAND,1,LUTON,BALE MULHOUSE,82807,82803,4,7106,7106,0,1065.311005
17/03/2016 11:32,2015,2,WESTERN-EUROPE-OTHER,SWITZERLAND,1,LUTON,BERNE,99,0,99,18,0,18,450
17/03/2016 11:32,2015,2,WESTERN-EUROPE-OTHER,SWITZERLAND,1,LUTON,GENEVA,264969,264946,23,259605,259565,40,2.066215982
17/03/2016 11:32,2015,2,WESTERN-EUROPE-OTHER,SWITZERLAND,1,LUTON,ZURICH,94030,93630,400,93224,93213,11,0.864584227
17/03/2016 11:32,2015,2,WESTERN-EUROPE-OTHER,SWITZERLAND,1,SOUTHEND,BERNE,8837,8757,80,1952,1952,0,352.7151639
17/03/2016 11:32,2015,2,WESTERN-EUROPE-OTHER,SWITZERLAND,1,SOUTHEND,GENEVA,26714,26714,0,61712,61712,0,-56.71182266
17/03/2016 11:32,2015,2,WESTERN-EUROPE-OTHER,SWITZERLAND,1,STANSTED,BALE MULHOUSE,101105,101105,0,68492,68135,357,47.61577995
17/03/2016 11:32,2015,2,WESTERN-EUROPE-OTHER,SWITZERLAND,1,STANSTED,GENEVA,59540,59540,0,58415,58415,0,1.925875203
17/03/2016 11:32,2015,2,WESTERN-EUROPE-OTHER,SWITZERLAND,1,STANSTED,ZURICH,422,422,0,0,0,0,0
17/03/2016 11:32,2015,2,WESTERN-EUROPE-OTHER,SWITZERLAND,2,ABERDEEN,GENEVA,4377,4377,0,574,574,0,662.543554
17/03/2016 11:32,2015,2,WESTERN-EUROPE-OTHER,SWITZERLAND,2,ABERDEEN,ZURICH,28,0,28,0,0,0,0
17/03/2016 11:32,2015,2,WESTERN-EUROPE-OTHER,SWITZERLAND,2,BELFAST INTERNATIONAL,GENEVA,25552,25418,134,25891,25891,0,-1.30933529
17/03/2016 11:32,2015,2,WESTERN-EUROPE-OTHER,SWITZERLAND,2,BIGGIN HILL,BERNE,0,0,0,13,0,13,0
17/03/2016 11:32,2015,2,WESTERN-EUROPE-OTHER,SWITZERLAND,2,BIGGIN HILL,ZURICH,0,0,0,2,0,2,0
17/03/2016 11:32,2015,2,WESTERN-EUROPE-OTHER,SWITZERLAND,2,BIRMINGHAM,BALE MULHOUSE,0,0,0,206,0,206,0
17/03/2016 11:32,2015,2,WESTERN-EUROPE-OTHER,SWITZERLAND,2,BIRMINGHAM,GENEVA,62665,53103,9562,61290,48277,13013,2.24343286
17/03/2016 11:32,2015,2,WESTERN-EUROPE-OTHER,SWITZERLAND,2,BIRMINGHAM,ZURICH,98991,98991,0,104601,104502,99,-5.363237445
17/03/2016 11:32,2015,2,WESTERN-EUROPE-OTHER,SWITZERLAND,2,BOURNEMOUTH,GENEVA,24701,24476,225,25180,25180,0,-1.902303415
17/03/2016 11:32,2015,2,WESTERN-EUROPE-OTHER,SWITZERLAND,2,BOURNEMOUTH,ZURICH,46,0,46,0,0,0,0
17/03/2016 11:32,2015,2,WESTERN-EUROPE-OTHER,SWITZERLAND,2,BRISTOL,BALE MULHOUSE,5858,5858,0,0,0,0,0
17/03/2016 11:32,2015,2,WESTERN-EUROPE-OTHER,SWITZERLAND,2,BRISTOL,GENEVA,206136,194214,11922,188384,183153,5231,9.423305589
17/03/2016 11:32,2015,2,WESTERN-EUROPE-OTHER,SWITZERLAND,2,BRISTOL,ZURICH,0,0,0,10835,10835,0,0
17/03/2016 11:32,2015,2,WESTERN-EUROPE-OTHER,SWITZERLAND,2,CAMBRIDGE,GENEVA,0,0,0,978,978,0,0
17/03/2016 11:32,2015,2,WESTERN-EUROPE-OTHER,SWITZERLAND,2,CARDIFF WALES,GENEVA,2086,2086,0,1557,1557,0,33.97559409
17/03/2016 11:32,2015,2,WESTERN-EUROPE-OTHER,SWITZERLAND,2,EAST MIDLANDS INTERNATIONAL,BERNE,28,0,28,0,0,0,0
17/03/2016 11:32,2015,2,WESTERN-EUROPE-OTHER,SWITZERLAND,2,EAST MIDLANDS INTERNATIONAL,GENEVA,4739,4739,0,4306,4079,227,10.05573618
17/03/2016 11:32,2015,2,WESTERN-EUROPE-OTHER,SWITZERLAND,2,EAST MIDLANDS INTERNATIONAL,ZURICH,0,0,0,27,0,27,0
17/03/2016 11:32,2015,2,WESTERN-EUROPE-OTHER,SWITZERLAND,2,EDINBURGH,BALE MULHOUSE,84779,84779,0,80861,80335,526,4.8453519
17/03/2016 11:32,2015,2,WESTERN-EUROPE-OTHER,SWITZERLAND,2,EDINBURGH,GENEVA,162353,151972,10381,156408,141904,14504,3.800956473
17/03/2016 11:32,2015,2,WESTERN-EUROPE-OTHER,SWITZERLAND,2,EDINBURGH,ZURICH,12072,10802,1270,12876,11490,1386,-6.24417521
17/03/2016 11:32,2015,2,WESTERN-EUROPE-OTHER,SWITZERLAND,2,EXETER,GENEVA,5533,2225,3308,6583,2475,4108,-15.95017469
17/03/2016 11:32,2015,2,WESTERN-EUROPE-OTHER,SWITZERLAND,2,GLASGOW,GENEVA,13271,13271,0,13513,13513,0,-1.790868053
17/03/2016 11:32,2015,2,WESTERN-EUROPE-OTHER,SWITZERLAND,2,GLASGOW,ZURICH,0,0,0,1730,1730,0,0
17/03/2016 11:32,2015,2,WESTERN-EUROPE-OTHER,SWITZERLAND,2,GUERNSEY,ZURICH,719,425,294,0,0,0,0
17/03/2016 11:32,2015,2,WESTERN-EUROPE-OTHER,SWITZERLAND,2,INVERNESS,GENEVA,1662,1662,0,1552,1552,0,7.087628866
17/03/2016 11:32,2015,2,WESTERN-EUROPE-OTHER,SWITZERLAND,2,INVERNESS,ZURICH,2207,0,2207,0,0,0,0
17/03/2016 11:32,2015,2,WESTERN-EUROPE-OTHER,SWITZERLAND,2,ISLE OF MAN,GENEVA,2104,2104,0,2325,2325,0,-9.505376344
17/03/2016 11:32,2015,2,WESTERN-EUROPE-OTHER,SWITZERLAND,2,ISLE OF MAN,ZURICH,37,0,37,0,0,0,0
17/03/2016 11:32,2015,2,WESTERN-EUROPE-OTHER,SWITZERLAND,2,JERSEY,ALTENRHEIN,0,0,0,154,0,154,0
17/03/2016 11:32,2015,2,WESTERN-EUROPE-OTHER,SWITZERLAND,2,JERSEY,BERNE,298,298,0,0,0,0,0
17/03/2016 11:32,2015,2,WESTERN-EUROPE-OTHER,SWITZERLAND,2,JERSEY,GENEVA,5304,5304,0,7379,7379,0,-28.12034151
17/03/2016 11:32,2015,2,WESTERN-EUROPE-OTHER,SWITZERLAND,2,JERSEY,ZURICH,769,751,18,6611,6611,0,-88.36787173
17/03/2016 11:32,2015,2,WESTERN-EUROPE-OTHER,SWITZERLAND,2,LEEDS BRADFORD,GENEVA,40254,40254,0,40959,40919,40,-1.721233429
17/03/2016 11:32,2015,2,WESTERN-EUROPE-OTHER,SWITZERLAND,2,LIVERPOOL (JOHN LENNON),ALTENRHEIN,35,0,35,0,0,0,0
17/03/2016 11:32,2015,2,WESTERN-EUROPE-OTHER,SWITZERLAND,2,LIVERPOOL (JOHN LENNON),BALE MULHOUSE,0,0,0,2689,0,2689,0
17/03/2016 11:32,2015,2,WESTERN-EUROPE-OTHER,SWITZERLAND,2,LIVERPOOL (JOHN LENNON),BERNE,291,0,291,0,0,0,0
17/03/2016 11:32,2015,2,WESTERN-EUROPE-OTHER,SWITZERLAND,2,LIVERPOOL (JOHN LENNON),GENEVA,132201,132014,187,133773,133761,12,-1.175125025
17/03/2016 11:32,2015,2,WESTERN-EUROPE-OTHER,SWITZERLAND,2,LIVERPOOL (JOHN LENNON),SION,177,0,177,0,0,0,0
17/03/2016 11:32,2015,2,WESTERN-EUROPE-OTHER,SWITZERLAND,2,LIVERPOOL (JOHN LENNON),ZURICH,650,0,650,0,0,0,0
17/03/2016 11:32,2015,2,WESTERN-EUROPE-OTHER,SWITZERLAND,2,MANCHESTER,BALE MULHOUSE,78036,77216,820,66020,65935,85,18.20054529
17/03/2016 11:32,2015,2,WESTERN-EUROPE-OTHER,SWITZERLAND,2,MANCHESTER,GENEVA,182604,170871,11733,165189,152087,13102,10.54246953
17/03/2016 11:32,2015,2,WESTERN-EUROPE-OTHER,SWITZERLAND,2,MANCHESTER,ZURICH,129701,129701,0,177242,177242,0,-26.82264926
17/03/2016 11:32,2015,2,WESTERN-EUROPE-OTHER,SWITZERLAND,2,NEWCASTLE,GENEVA,61175,57053,4122,32947,28596,4351,85.67699639
17/03/2016 11:32,2015,2,WESTERN-EUROPE-OTHER,SWITZERLAND,2,OXFORD (KIDLINGTON),BALE MULHOUSE,0,0,0,60,0,60,0
17/03/2016 11:32,2015,2,WESTERN-EUROPE-OTHER,SWITZERLAND,2,SOUTHAMPTON,GENEVA,9421,9421,0,14510,14510,0,-35.07236389
17/03/2016 11:32,2015,2,WESTERN-EUROPE-OTHER,TURKEY,1,GATWICK,ANKARA (ESENBOGA),9,0,9,10,0,10,-10
17/03/2016 11:32,2015,2,WESTERN-EUROPE-OTHER,TURKEY,1,GATWICK,ANTALYA,289395,88919,200476,328438,94484,233954,-11.88747952
17/03/2016 11:32,2015,2,WESTERN-EUROPE-OTHER,TURKEY,1,GATWICK,BODRUM (MILAS),151055,78686,72369,161676,77144,84532,-6.569311462
17/03/2016 11:32,2015,2,WESTERN-EUROPE-OTHER,TURKEY,1,GATWICK,DALAMAN,452424,210540,241884,465373,148171,317202,-2.7824992
17/03/2016 11:32,2015,2,WESTERN-EUROPE-OTHER,TURKEY,1,GATWICK,ISTANBUL,273046,272617,429,252814,252814,0,8.002721368
17/03/2016 11:32,2015,2,WESTERN-EUROPE-OTHER,TURKEY,1,GATWICK,ISTANBUL (SABIHA GOKCEN),150805,147644,3161,87192,86588,604,72.95738141
17/03/2016 11:32,2015,2,WESTERN-EUROPE-OTHER,TURKEY,1,GATWICK,IZMIR (ADNAN MENDERES),73975,32361,41614,75642,31968,43674,-2.203802121
17/03/2016 11:32,2015,2,WESTERN-EUROPE-OTHER,TURKEY,1,HEATHROW,BODRUM (MILAS),6788,0,6788,5275,0,5275,28.68246445
17/03/2016 11:32,2015,2,WESTERN-EUROPE-OTHER,TURKEY,1,HEATHROW,DALAMAN,18370,0,18370,13168,0,13168,39.50486027
17/03/2016 11:32,2015,2,WESTERN-EUROPE-OTHER,TURKEY,1,HEATHROW,ISTANBUL,933038,932909,129,924402,923750,652,0.934225586
17/03/2016 11:32,2015,2,WESTERN-EUROPE-OTHER,TURKEY,1,HEATHROW,ISTANBUL (SABIHA GOKCEN),2019,0,2019,0,0,0,0
17/03/2016 11:32,2015,2,WESTERN-EUROPE-OTHER,TURKEY,1,LUTON,ADANA,0,0,0,95,0,95,0
17/03/2016 11:32,2015,2,WESTERN-EUROPE-OTHER,TURKEY,1,LUTON,ANKARA (ESENBOGA),34,0,34,0,0,0,0
17/03/2016 11:32,2015,2,WESTERN-EUROPE-OTHER,TURKEY,1,LUTON,ANTALYA,26062,16706,9356,29893,19287,10606,-12.81570936
17/03/2016 11:32,2015,2,WESTERN-EUROPE-OTHER,TURKEY,1,LUTON,BODRUM (MILAS),20762,11829,8933,36364,27446,8918,-42.90507095
17/03/2016 11:32,2015,2,WESTERN-EUROPE-OTHER,TURKEY,1,LUTON,DALAMAN,51715,31975,19740,79017,59394,19623,-34.55205842
17/03/2016 11:32,2015,2,WESTERN-EUROPE-OTHER,TURKEY,1,LUTON,ISTANBUL,80357,80357,0,56153,55840,313,43.10366321
17/03/2016 11:32,2015,2,WESTERN-EUROPE-OTHER,TURKEY,1,LUTON,ISTANBUL (SABIHA GOKCEN),2,0,2,11191,10343,848,-99.9821285
17/03/2016 11:32,2015,2,WESTERN-EUROPE-OTHER,TURKEY,1,LUTON,IZMIR (ADNAN MENDERES),6905,6893,12,0,0,0,0
17/03/2016 11:32,2015,2,WESTERN-EUROPE-OTHER,TURKEY,1,LUTON,NEVSEHIR KAPADOKYA ,170,0,170,0,0,0,0
17/03/2016 11:32,2015,2,WESTERN-EUROPE-OTHER,TURKEY,1,LUTON,TRABZON,36,0,36,0,0,0,0
17/03/2016 11:32,2015,2,WESTERN-EUROPE-OTHER,TURKEY,1,STANSTED,ANTALYA,64197,0,64197,74189,0,74189,-13.46830393
17/03/2016 11:32,2015,2,WESTERN-EUROPE-OTHER,TURKEY,1,STANSTED,BALIKESIR (KOCA SEYIT),0,0,0,48,0,48,0
17/03/2016 11:32,2015,2,WESTERN-EUROPE-OTHER,TURKEY,1,STANSTED,BODRUM (MILAS),34196,27311,6885,37200,29607,7593,-8.075268817
17/03/2016 11:32,2015,2,WESTERN-EUROPE-OTHER,TURKEY,1,STANSTED,DALAMAN,102896,38087,64809,92162,41495,50667,11.64688266
17/03/2016 11:32,2015,2,WESTERN-EUROPE-OTHER,TURKEY,1,STANSTED,GAZIANTEP,1622,0,1622,802,0,802,102.244389
17/03/2016 11:32,2015,2,WESTERN-EUROPE-OTHER,TURKEY,1,STANSTED,ISTANBUL,69,0,69,0,0,0,0
17/03/2016 11:32,2015,2,WESTERN-EUROPE-OTHER,TURKEY,1,STANSTED,ISTANBUL (SABIHA GOKCEN),240429,239675,754,251792,251333,459,-4.512851878
17/03/2016 11:32,2015,2,WESTERN-EUROPE-OTHER,TURKEY,1,STANSTED,IZMIR (ADNAN MENDERES),45564,37979,7585,49736,39568,10168,-8.388290172
17/03/2016 11:32,2015,2,WESTERN-EUROPE-OTHER,TURKEY,2,ABERDEEN,BODRUM (MILAS),0,0,0,542,0,542,0
17/03/2016 11:32,2015,2,WESTERN-EUROPE-OTHER,TURKEY,2,ABERDEEN,DALAMAN,19247,0,19247,19862,0,19862,-3.096364918
17/03/2016 11:32,2015,2,WESTERN-EUROPE-OTHER,TURKEY,2,BELFAST INTERNATIONAL,ANTALYA,0,0,0,8217,0,8217,0
17/03/2016 11:32,2015,2,WESTERN-EUROPE-OTHER,TURKEY,2,BELFAST INTERNATIONAL,BODRUM (MILAS),9214,0,9214,10784,0,10784,-14.55860534
17/03/2016 11:32,2015,2,WESTERN-EUROPE-OTHER,TURKEY,2,BELFAST INTERNATIONAL,DALAMAN,31395,0,31395,39386,0,39386,-20.28893515
17/03/2016 11:32,2015,2,WESTERN-EUROPE-OTHER,TURKEY,2,BIRMINGHAM,ANTALYA,60928,0,60928,62882,0,62882,-3.107407525
17/03/2016 11:32,2015,2,WESTERN-EUROPE-OTHER,TURKEY,2,BIRMINGHAM,BODRUM (MILAS),56790,20810,35980,58253,27394,30859,-2.511458637
17/03/2016 11:32,2015,2,WESTERN-EUROPE-OTHER,TURKEY,2,BIRMINGHAM,DALAMAN,170610,58499,112111,166286,61366,104920,2.600339175
17/03/2016 11:32,2015,2,WESTERN-EUROPE-OTHER,TURKEY,2,BIRMINGHAM,ISTANBUL,139296,139296,0,118890,118890,0,17.16376482
17/03/2016 11:32,2015,2,WESTERN-EUROPE-OTHER,TURKEY,2,BIRMINGHAM,ISTANBUL (SABIHA GOKCEN),1380,0,1380,0,0,0,0
17/03/2016 11:32,2015,2,WESTERN-EUROPE-OTHER,TURKEY,2,BIRMINGHAM,IZMIR (ADNAN MENDERES),13191,0,13191,22644,0,22644,-41.74615792
17/03/2016 11:32,2015,2,WESTERN-EUROPE-OTHER,TURKEY,2,BLACKPOOL,DALAMAN,0,0,0,5868,5868,0,0
17/03/2016 11:32,2015,2,WESTERN-EUROPE-OTHER,TURKEY,2,BOURNEMOUTH,ANTALYA,7240,0,7240,8272,0,8272,-12.47582205
17/03/2016 11:32,2015,2,WESTERN-EUROPE-OTHER,TURKEY,2,BOURNEMOUTH,DALAMAN,16771,0,16771,16447,0,16447,1.969964127
17/03/2016 11:32,2015,2,WESTERN-EUROPE-OTHER,TURKEY,2,BRISTOL,ANTALYA,44354,0,44354,38091,0,38091,16.4422042
17/03/2016 11:32,2015,2,WESTERN-EUROPE-OTHER,TURKEY,2,BRISTOL,BODRUM (MILAS),32380,25846,6534,34831,25716,9115,-7.036835003
17/03/2016 11:32,2015,2,WESTERN-EUROPE-OTHER,TURKEY,2,BRISTOL,DALAMAN,89217,28598,60619,94304,28927,65377,-5.394256871
17/03/2016 11:32,2015,2,WESTERN-EUROPE-OTHER,TURKEY,2,CARDIFF WALES,ANTALYA,8300,0,8300,0,0,0,0
17/03/2016 11:32,2015,2,WESTERN-EUROPE-OTHER,TURKEY,2,CARDIFF WALES,BODRUM (MILAS),0,0,0,7717,0,7717,0
17/03/2016 11:32,2015,2,WESTERN-EUROPE-OTHER,TURKEY,2,CARDIFF WALES,DALAMAN,32507,0,32507,34618,0,34618,-6.097983708
17/03/2016 11:32,2015,2,WESTERN-EUROPE-OTHER,TURKEY,2,CARDIFF WALES,TRABZON,0,0,0,77,0,77,0
17/03/2016 11:32,2015,2,WESTERN-EUROPE-OTHER,TURKEY,2,DONCASTER SHEFFIELD,DALAMAN,29303,0,29303,31963,0,31963,-8.322122454
17/03/2016 11:32,2015,2,WESTERN-EUROPE-OTHER,TURKEY,2,DONCASTER SHEFFIELD,ISTANBUL (SABIHA GOKCEN),0,0,0,58,0,58,0
17/03/2016 11:32,2015,2,WESTERN-EUROPE-OTHER,TURKEY,2,EAST MIDLANDS INTERNATIONAL,ANTALYA,31886,7545,24341,28440,0,28440,12.11673699
17/03/2016 11:32,2015,2,WESTERN-EUROPE-OTHER,TURKEY,2,EAST MIDLANDS INTERNATIONAL,BODRUM (MILAS),16625,8722,7903,16564,8865,7699,0.368268534
17/03/2016 11:32,2015,2,WESTERN-EUROPE-OTHER,TURKEY,2,EAST MIDLANDS INTERNATIONAL,DALAMAN,66278,26477,39801,73459,25944,47515,-9.775521039
17/03/2016 11:32,2015,2,WESTERN-EUROPE-OTHER,TURKEY,2,EDINBURGH,ANTALYA,7310,0,7310,5310,0,5310,37.66478343
17/03/2016 11:32,2015,2,WESTERN-EUROPE-OTHER,TURKEY,2,EDINBURGH,BODRUM (MILAS),19009,19009,0,18934,18934,0,0.396112813
17/03/2016 11:32,2015,2,WESTERN-EUROPE-OTHER,TURKEY,2,EDINBURGH,DALAMAN,36301,17993,18308,40458,16454,24004,-10.27485293
17/03/2016 11:32,2015,2,WESTERN-EUROPE-OTHER,TURKEY,2,EDINBURGH,ISTANBUL,97498,97498,0,93029,92996,33,4.803878361
17/03/2016 11:32,2015,2,WESTERN-EUROPE-OTHER,TURKEY,2,EXETER,DALAMAN,18373,0,18373,16755,0,16755,9.65681886
17/03/2016 11:32,2015,2,WESTERN-EUROPE-OTHER,TURKEY,2,GLASGOW,ANTALYA,81890,15634,66256,60570,0,60570,35.19894337
17/03/2016 11:32,2015,2,WESTERN-EUROPE-OTHER,TURKEY,2,GLASGOW,BODRUM (MILAS),32052,16216,15836,38150,20202,17948,-15.98427261
17/03/2016 11:32,2015,2,WESTERN-EUROPE-OTHER,TURKEY,2,GLASGOW,DALAMAN,131455,42312,89143,125006,38554,86452,5.15895237
17/03/2016 11:32,2015,2,WESTERN-EUROPE-OTHER,TURKEY,2,GLASGOW,ISTANBUL (SABIHA GOKCEN),893,0,893,0,0,0,0
17/03/2016 11:32,2015,2,WESTERN-EUROPE-OTHER,TURKEY,2,GLASGOW,IZMIR (ADNAN MENDERES),0,0,0,2127,0,2127,0
17/03/2016 11:32,2015,2,WESTERN-EUROPE-OTHER,TURKEY,2,HUMBERSIDE,ANTALYA,364,0,364,142,0,142,156.3380282
17/03/2016 11:32,2015,2,WESTERN-EUROPE-OTHER,TURKEY,2,HUMBERSIDE,DALAMAN,0,0,0,5482,0,5482,0
17/03/2016 11:32,2015,2,WESTERN-EUROPE-OTHER,TURKEY,2,LEEDS BRADFORD,ANTALYA,33512,33512,0,16590,16590,0,102.0012055
17/03/2016 11:32,2015,2,WESTERN-EUROPE-OTHER,TURKEY,2,LEEDS BRADFORD,BODRUM (MILAS),17131,17131,0,33630,33630,0,-49.06036277
17/03/2016 11:32,2015,2,WESTERN-EUROPE-OTHER,TURKEY,2,LEEDS BRADFORD,DALAMAN,77327,58690,18637,73148,55106,18042,5.713074862
17/03/2016 11:32,2015,2,WESTERN-EUROPE-OTHER,TURKEY,2,LIVERPOOL (JOHN LENNON),BODRUM (MILAS),16232,16232,0,16466,16466,0,-1.421110166
17/03/2016 11:32,2015,2,WESTERN-EUROPE-OTHER,TURKEY,2,LIVERPOOL (JOHN LENNON),ISTANBUL (SABIHA GOKCEN),826,0,826,0,0,0,0
17/03/2016 11:32,2015,2,WESTERN-EUROPE-OTHER,TURKEY,2,MANCHESTER,ANTALYA,215991,43171,172820,221890,57162,164728,-2.658524494
17/03/2016 11:32,2015,2,WESTERN-EUROPE-OTHER,TURKEY,2,MANCHESTER,BODRUM (MILAS),75018,19517,55501,113382,42594,70788,-33.83605863
17/03/2016 11:32,2015,2,WESTERN-EUROPE-OTHER,TURKEY,2,MANCHESTER,CORLU (AFB),130,0,130,0,0,0,0
17/03/2016 11:32,2015,2,WESTERN-EUROPE-OTHER,TURKEY,2,MANCHESTER,DALAMAN,411777,168662,243115,470644,201066,269578,-12.50775533
17/03/2016 11:32,2015,2,WESTERN-EUROPE-OTHER,TURKEY,2,MANCHESTER,ISTANBUL,247367,247367,0,201297,201297,0,22.88658053
17/03/2016 11:32,2015,2,WESTERN-EUROPE-OTHER,TURKEY,2,MANCHESTER,ISTANBUL (SABIHA GOKCEN),2601,0,2601,65,0,65,3901.538462
17/03/2016 11:32,2015,2,WESTERN-EUROPE-OTHER,TURKEY,2,MANCHESTER,IZMIR (ADNAN MENDERES),39177,0,39177,43870,0,43870,-10.69751539
17/03/2016 11:32,2015,2,WESTERN-EUROPE-OTHER,TURKEY,2,MANCHESTER,TEKIRDAG (CORLU),773,0,773,0,0,0,0
17/03/2016 11:32,2015,2,WESTERN-EUROPE-OTHER,TURKEY,2,NEWCASTLE,ANTALYA,40630,7857,32773,31553,0,31553,28.76747061
17/03/2016 11:32,2015,2,WESTERN-EUROPE-OTHER,TURKEY,2,NEWCASTLE,BODRUM (MILAS),19234,8772,10462,30129,10322,19807,-36.16117362
17/03/2016 11:32,2015,2,WESTERN-EUROPE-OTHER,TURKEY,2,NEWCASTLE,DALAMAN,126517,26985,99532,134236,32475,101761,-5.750320331
17/03/2016 11:32,2015,2,WESTERN-EUROPE-OTHER,TURKEY,2,NEWQUAY,ANTALYA,0,0,0,248,0,248,0
17/03/2016 11:32,2015,2,WESTERN-EUROPE-OTHER,TURKEY,2,NORWICH,ANTALYA,282,0,282,0,0,0,0
17/03/2016 11:32,2015,2,WESTERN-EUROPE-OTHER,TURKEY,2,NORWICH,DALAMAN,13318,0,13318,13523,0,13523,-1.515935813
17/03/2016 11:32,2015,3,EASTERN EUROPE-EU,BULGARIA,1,GATWICK,BURGAS,37500,0,37500,38570,0,38570,-2.774176821
17/03/2016 11:32,2015,3,EASTERN EUROPE-EU,BULGARIA,1,GATWICK,PLOVDIV,2918,0,2918,490,0,490,495.5102041
17/03/2016 11:32,2015,3,EASTERN EUROPE-EU,BULGARIA,1,GATWICK,SOFIA,126049,114923,11126,127115,115800,11315,-0.838610707
17/03/2016 11:32,2015,3,EASTERN EUROPE-EU,BULGARIA,1,GATWICK,VARNA,1965,0,1965,2240,0,2240,-12.27678571
17/03/2016 11:32,2015,3,EASTERN EUROPE-EU,BULGARIA,1,HEATHROW,SOFIA,182313,182313,0,169596,169596,0,7.498407981
17/03/2016 11:32,2015,3,EASTERN EUROPE-EU,BULGARIA,1,LUTON,BURGAS,81774,74903,6871,68588,61886,6702,19.22493731
17/03/2016 11:32,2015,3,EASTERN EUROPE-EU,BULGARIA,1,LUTON,SOFIA,231215,231215,0,150892,150576,316,53.23211303
17/03/2016 11:32,2015,3,EASTERN EUROPE-EU,BULGARIA,1,LUTON,VARNA,75005,75005,0,57955,57955,0,29.4193771
17/03/2016 11:32,2015,3,EASTERN EUROPE-EU,BULGARIA,1,STANSTED,BURGAS,2247,0,2247,1867,0,1867,20.3535083
17/03/2016 11:32,2015,3,EASTERN EUROPE-EU,BULGARIA,1,STANSTED,PLOVDIV,54612,54612,0,53410,53410,0,2.250514885
17/03/2016 11:32,2015,3,EASTERN EUROPE-EU,BULGARIA,1,STANSTED,SOFIA,11508,11508,0,31556,31556,0,-63.53149956
17/03/2016 11:32,2015,3,EASTERN EUROPE-EU,BULGARIA,2,ABERDEEN,BURGAS,5638,0,5638,4381,0,4381,28.69207943
17/03/2016 11:32,2015,3,EASTERN EUROPE-EU,BULGARIA,2,BELFAST INTERNATIONAL,BURGAS,13208,0,13208,11636,0,11636,13.50979718
17/03/2016 11:32,2015,3,EASTERN EUROPE-EU,BULGARIA,2,BELFAST INTERNATIONAL,PLOVDIV,2923,0,2923,2465,0,2465,18.5801217
17/03/2016 11:32,2015,3,EASTERN EUROPE-EU,BULGARIA,2,BIRMINGHAM,BURGAS,21330,0,21330,23117,0,23117,-7.730241813
17/03/2016 11:32,2015,3,EASTERN EUROPE-EU,BULGARIA,2,BIRMINGHAM,SOFIA,3423,0,3423,3458,0,3458,-1.012145749
17/03/2016 11:32,2015,3,EASTERN EUROPE-EU,BULGARIA,2,BRISTOL,BURGAS,19727,0,19727,20720,0,20720,-4.792471042
17/03/2016 11:32,2015,3,EASTERN EUROPE-EU,BULGARIA,2,BRISTOL,SOFIA,3871,0,3871,4049,0,4049,-4.396147197
17/03/2016 11:32,2015,3,EASTERN EUROPE-EU,BULGARIA,2,CARDIFF WALES,BURGAS,12882,0,12882,12173,0,12173,5.824365399
17/03/2016 11:32,2015,3,EASTERN EUROPE-EU,BULGARIA,2,DONCASTER SHEFFIELD,BURGAS,5222,0,5222,3941,0,3941,32.5044405
17/03/2016 11:32,2015,3,EASTERN EUROPE-EU,BULGARIA,2,EAST MIDLANDS INTERNATIONAL,BURGAS,19375,0,19375,14066,0,14066,37.74349495
17/03/2016 11:32,2015,3,EASTERN EUROPE-EU,BULGARIA,2,EAST MIDLANDS INTERNATIONAL,SOFIA,4460,0,4460,3971,0,3971,12.31427852
17/03/2016 11:32,2015,3,EASTERN EUROPE-EU,BULGARIA,2,EDINBURGH,BURGAS,10297,0,10297,9797,0,9797,5.103603144
17/03/2016 11:32,2015,3,EASTERN EUROPE-EU,BULGARIA,2,GLASGOW,BURGAS,23357,0,23357,24076,0,24076,-2.986376474
17/03/2016 11:32,2015,3,EASTERN EUROPE-EU,BULGARIA,2,GLASGOW,SOFIA,0,0,0,1007,0,1007,0
17/03/2016 11:32,2015,3,EASTERN EUROPE-EU,BULGARIA,2,HUMBERSIDE,BURGAS,4932,0,4932,4785,741,4044,3.072100313
17/03/2016 11:32,2015,3,EASTERN EUROPE-EU,BULGARIA,2,HUMBERSIDE,SOFIA,183,0,183,0,0,0,0
17/03/2016 11:32,2015,3,EASTERN EUROPE-EU,BULGARIA,2,LEEDS BRADFORD,BURGAS,4817,0,4817,4637,0,4637,3.881820142
17/03/2016 11:32,2015,3,EASTERN EUROPE-EU,BULGARIA,2,LIVERPOOL (JOHN LENNON),SOFIA,0,0,0,589,0,589,0
17/03/2016 11:32,2015,3,EASTERN EUROPE-EU,BULGARIA,2,LIVERPOOL (JOHN LENNON),VARNA,0,0,0,141,0,141,0
17/03/2016 11:32,2015,3,EASTERN EUROPE-EU,BULGARIA,2,MANCHESTER,BURGAS,64549,10072,54477,58530,0,58530,10.28361524
17/03/2016 11:32,2015,3,EASTERN EUROPE-EU,BULGARIA,2,MANCHESTER,SOFIA,57365,49002,8363,57055,45795,11260,0.543335378
17/03/2016 11:32,2015,3,EASTERN EUROPE-EU,BULGARIA,2,MANCHESTER,VARNA,6035,0,6035,5981,0,5981,0.902859054
17/03/2016 11:32,2015,3,EASTERN EUROPE-EU,BULGARIA,2,NEWCASTLE,BURGAS,28977,0,28977,24945,0,24945,16.16355983
17/03/2016 11:32,2015,3,EASTERN EUROPE-EU,BULGARIA,2,NEWCASTLE,SOFIA,2106,0,2106,1938,0,1938,8.66873065
17/03/2016 11:32,2015,3,EASTERN EUROPE-EU,BULGARIA,2,NEWQUAY,BURGAS,0,0,0,170,0,170,0
17/03/2016 11:32,2015,3,EASTERN EUROPE-EU,BULGARIA,2,NORWICH,BURGAS,4279,0,4279,5518,0,5518,-22.4537876
17/03/2016 11:32,2015,3,EASTERN EUROPE-EU,CZECH REPUBLIC,1,GATWICK,PRAGUE,243500,243461,39,192643,192643,0,26.39960964
17/03/2016 11:32,2015,3,EASTERN EUROPE-EU,CZECH REPUBLIC,1,HEATHROW,PRAGUE,433345,433345,0,414056,414056,0,4.658548602
17/03/2016 11:32,2015,3,EASTERN EUROPE-EU,CZECH REPUBLIC,1,LUTON,BRNO (TURANY),45470,45470,0,44716,44716,0,1.686197334
17/03/2016 11:32,2015,3,EASTERN EUROPE-EU,CZECH REPUBLIC,1,LUTON,PRAGUE,126735,126519,216,124270,124270,0,1.983584131
17/03/2016 11:32,2015,3,EASTERN EUROPE-EU,CZECH REPUBLIC,1,SOUTHEND,PRAGUE,33,0,33,0,0,0,0
17/03/2016 11:32,2015,3,EASTERN EUROPE-EU,CZECH REPUBLIC,1,STANSTED,BRNO (TURANY),116274,116274,0,115272,115272,0,0.869248386
17/03/2016 11:32,2015,3,EASTERN EUROPE-EU,CZECH REPUBLIC,1,STANSTED,OSTRAVA,57526,57526,0,50365,50365,0,14.21820709
17/03/2016 11:32,2015,3,EASTERN EUROPE-EU,CZECH REPUBLIC,1,STANSTED,PRAGUE,333672,333444,228,203351,203351,0,64.08672689
17/03/2016 11:32,2015,3,EASTERN EUROPE-EU,CZECH REPUBLIC,2,BELFAST INTERNATIONAL,PRAGUE,19641,19641,0,0,0,0,0
17/03/2016 11:32,2015,3,EASTERN EUROPE-EU,CZECH REPUBLIC,2,BIRMINGHAM,BRNO (TURANY),43,0,43,0,0,0,0
17/03/2016 11:32,2015,3,EASTERN EUROPE-EU,CZECH REPUBLIC,2,BIRMINGHAM,PRAGUE,106,0,106,0,0,0,0
17/03/2016 11:32,2015,3,EASTERN EUROPE-EU,CZECH REPUBLIC,2,BRISTOL,PRAGUE,65469,65469,0,63333,63333,0,3.37264933
17/03/2016 11:32,2015,3,EASTERN EUROPE-EU,CZECH REPUBLIC,2,EAST MIDLANDS INTERNATIONAL,PRAGUE,26119,26119,0,29571,29571,0,-11.67359913
17/03/2016 11:32,2015,3,EASTERN EUROPE-EU,CZECH REPUBLIC,2,EDINBURGH,PRAGUE,73992,73992,0,78953,78752,201,-6.283485111
17/03/2016 11:32,2015,3,EASTERN EUROPE-EU,CZECH REPUBLIC,2,GLASGOW,PRAGUE,22277,22163,114,0,0,0,0
17/03/2016 11:32,2015,3,EASTERN EUROPE-EU,CZECH REPUBLIC,2,HUMBERSIDE,PRAGUE,0,0,0,135,0,135,0
17/03/2016 11:32,2015,3,EASTERN EUROPE-EU,CZECH REPUBLIC,2,INVERNESS,BRNO (TURANY),82,0,82,0,0,0,0
17/03/2016 11:32,2015,3,EASTERN EUROPE-EU,CZECH REPUBLIC,2,INVERNESS,PRAGUE,82,0,82,0,0,0,0
17/03/2016 11:32,2015,3,EASTERN EUROPE-EU,CZECH REPUBLIC,2,LEEDS BRADFORD,PRAGUE,34304,34304,0,45208,45208,0,-24.11962485
17/03/2016 11:32,2015,3,EASTERN EUROPE-EU,CZECH REPUBLIC,2,LIVERPOOL (JOHN LENNON),PRAGUE,3838,3838,0,0,0,0,0
17/03/2016 11:32,2015,3,EASTERN EUROPE-EU,CZECH REPUBLIC,2,MANCHESTER,PRAGUE,118455,118368,87,119516,119090,426,-0.887747247
17/03/2016 11:32,2015,3,EASTERN EUROPE-EU,CZECH REPUBLIC,2,NEWCASTLE,PRAGUE,25547,25547,0,24979,24979,0,2.273910084
17/03/2016 11:32,2015,3,EASTERN EUROPE-EU,ESTONIA,1,GATWICK,TALLIN,53770,53770,0,61962,61962,0,-13.22100642
17/03/2016 11:32,2015,3,EASTERN EUROPE-EU,ESTONIA,1,LUTON,TALLIN,8,0,8,54,0,54,-85.18518519
17/03/2016 11:32,2015,3,EASTERN EUROPE-EU,ESTONIA,1,STANSTED,TALLIN,72491,72491,0,64603,64603,0,12.20995929
17/03/2016 11:32,2015,3,EASTERN EUROPE-EU,ESTONIA,2,ABERDEEN,TALLIN,44,0,44,0,0,0,0
17/03/2016 11:32,2015,3,EASTERN EUROPE-EU,ESTONIA,2,BIRMINGHAM,TALLIN,0,0,0,150,0,150,0
17/03/2016 11:32,2015,3,EASTERN EUROPE-EU,ESTONIA,2,BRISTOL,TALLIN,6,0,6,0,0,0,0
17/03/2016 11:32,2015,3,EASTERN EUROPE-EU,ESTONIA,2,CARDIFF WALES,TALLIN,0,0,0,100,0,100,0
17/03/2016 11:32,2015,3,EASTERN EUROPE-EU,ESTONIA,2,GLASGOW,TALLIN,152,0,152,0,0,0,0
17/03/2016 11:32,2015,3,EASTERN EUROPE-EU,ESTONIA,2,MANCHESTER,TALLIN,20639,20639,0,19333,19333,0,6.755288884
17/03/2016 11:32,2015,3,EASTERN EUROPE-EU,HUNGARY,1,GATWICK,BUDAPEST,177393,176956,437,151268,151162,106,17.27067192
17/03/2016 11:32,2015,3,EASTERN EUROPE-EU,HUNGARY,1,HEATHROW,BUDAPEST,291955,291955,0,279174,279174,0,4.578148395
17/03/2016 11:32,2015,3,EASTERN EUROPE-EU,HUNGARY,1,LUTON,BUDAPEST,468107,467949,158,428056,427960,96,9.356486067
17/03/2016 11:32,2015,3,EASTERN EUROPE-EU,HUNGARY,1,LUTON,DEBRECEN,108515,108515,0,93819,93819,0,15.66420448
17/03/2016 11:32,2015,3,EASTERN EUROPE-EU,HUNGARY,1,STANSTED,BUDAPEST,368605,368446,159,293453,293453,0,25.60955247
17/03/2016 11:32,2015,3,EASTERN EUROPE-EU,HUNGARY,2,BELFAST INTERNATIONAL,BUDAPEST,362,0,362,0,0,0,0
17/03/2016 11:32,2015,3,EASTERN EUROPE-EU,HUNGARY,2,BELFAST INTERNATIONAL,DEBRECEN,0,0,0,120,0,120,0
17/03/2016 11:32,2015,3,EASTERN EUROPE-EU,HUNGARY,2,BIRMINGHAM,BUDAPEST,9225,9147,78,0,0,0,0
17/03/2016 11:32,2015,3,EASTERN EUROPE-EU,HUNGARY,2,BRISTOL,BUDAPEST,57028,57028,0,42763,42763,0,33.35827702
17/03/2016 11:32,2015,3,EASTERN EUROPE-EU,HUNGARY,2,EAST MIDLANDS INTERNATIONAL,BUDAPEST,25101,25101,0,25260,24940,320,-0.629453682
17/03/2016 11:32,2015,3,EASTERN EUROPE-EU,HUNGARY,2,EDINBURGH,BUDAPEST,43178,43178,0,37131,37131,0,16.28558347
17/03/2016 11:32,2015,3,EASTERN EUROPE-EU,HUNGARY,2,GLASGOW,BUDAPEST,17421,17278,143,0,0,0,0
17/03/2016 11:32,2015,3,EASTERN EUROPE-EU,HUNGARY,2,LEEDS BRADFORD,BUDAPEST,26496,26496,0,20659,20659,0,28.25402972
17/03/2016 11:32,2015,3,EASTERN EUROPE-EU,HUNGARY,2,MANCHESTER,BUDAPEST,135536,135367,169,135017,135017,0,0.384396039
17/03/2016 11:32,2015,3,EASTERN EUROPE-EU,LATVIA,1,GATWICK,RIGA,87226,87226,0,82556,82556,0,5.656766316
17/03/2016 11:32,2015,3,EASTERN EUROPE-EU,LATVIA,1,LUTON,RIGA,154227,154227,0,116997,116997,0,31.82132875
17/03/2016 11:32,2015,3,EASTERN EUROPE-EU,LATVIA,1,STANSTED,RIGA,255605,255605,0,241305,241305,0,5.92611011
17/03/2016 11:32,2015,3,EASTERN EUROPE-EU,LATVIA,2,ABERDEEN,RIGA,0,0,0,15736,15558,178,0
17/03/2016 11:32,2015,3,EASTERN EUROPE-EU,LATVIA,2,BELFAST INTERNATIONAL,RIGA,67,0,67,0,0,0,0
17/03/2016 11:32,2015,3,EASTERN EUROPE-EU,LATVIA,2,DONCASTER SHEFFIELD,RIGA,33410,33410,0,16886,16886,0,97.85621225
17/03/2016 11:32,2015,3,EASTERN EUROPE-EU,LATVIA,2,EAST MIDLANDS INTERNATIONAL,RIGA,59526,59526,0,54224,54224,0,9.7779581
17/03/2016 11:32,2015,3,EASTERN EUROPE-EU,LATVIA,2,GLASGOW,RIGA,20325,20325,0,3103,3103,0,555.0112794
17/03/2016 11:32,2015,3,EASTERN EUROPE-EU,LATVIA,2,LEEDS BRADFORD,RIGA,34740,34740,0,14828,14828,0,134.286485
17/03/2016 11:32,2015,3,EASTERN EUROPE-EU,LATVIA,2,LIVERPOOL (JOHN LENNON),RIGA,20281,20281,0,0,0,0,0
17/03/2016 11:32,2015,3,EASTERN EUROPE-EU,LATVIA,2,MANCHESTER,RIGA,52951,52951,0,42941,42941,0,23.3110547
17/03/2016 11:32,2015,3,EASTERN EUROPE-EU,LATVIA,2,PRESTWICK,RIGA,0,0,0,19688,19688,0,0
17/03/2016 11:32,2015,3,EASTERN EUROPE-EU,LITHUANIA,1,GATWICK,KAUNAS,55465,55465,0,54146,54146,0,2.436006353
17/03/2016 11:32,2015,3,EASTERN EUROPE-EU,LITHUANIA,1,GATWICK,PALANGA,0,0,0,585,585,0,0
17/03/2016 11:32,2015,3,EASTERN EUROPE-EU,LITHUANIA,1,GATWICK,VILNIUS,415,0,415,1123,337,786,-63.04541407
17/03/2016 11:32,2015,3,EASTERN EUROPE-EU,LITHUANIA,1,LUTON,KAUNAS,86289,86289,0,88156,88156,0,-2.117836562
17/03/2016 11:32,2015,3,EASTERN EUROPE-EU,LITHUANIA,1,LUTON,VILNIUS,230143,230091,52,190040,190040,0,21.10239949
17/03/2016 11:32,2015,3,EASTERN EUROPE-EU,LITHUANIA,1,STANSTED,KAUNAS,134168,134168,0,128900,128900,0,4.086889061
17/03/2016 11:32,2015,3,EASTERN EUROPE-EU,LITHUANIA,1,STANSTED,VILNIUS,128544,128544,0,124949,124949,0,2.877173887
17/03/2016 11:32,2015,3,EASTERN EUROPE-EU,LITHUANIA,2,ABERDEEN,VILNIUS,3,0,3,0,0,0,0
17/03/2016 11:32,2015,3,EASTERN EUROPE-EU,LITHUANIA,2,BELFAST CITY (GEORGE BEST),KAUNAS,0,0,0,136,0,136,0
17/03/2016 11:32,2015,3,EASTERN EUROPE-EU,LITHUANIA,2,BELFAST INTERNATIONAL,VILNIUS,21777,21777,0,0,0,0,0
17/03/2016 11:32,2015,3,EASTERN EUROPE-EU,LITHUANIA,2,BIRMINGHAM,KAUNAS,34763,34763,0,26489,26489,0,31.23560723
17/03/2016 11:32,2015,3,EASTERN EUROPE-EU,LITHUANIA,2,BRISTOL,KAUNAS,36704,36704,0,35119,35119,0,4.513226459
17/03/2016 11:32,2015,3,EASTERN EUROPE-EU,LITHUANIA,2,DONCASTER SHEFFIELD,VILNIUS,40597,40597,0,31091,31091,0,30.5747644
17/03/2016 11:32,2015,3,EASTERN EUROPE-EU,LITHUANIA,2,EDINBURGH,KAUNAS,21276,21276,0,20791,20791,0,2.332740128
17/03/2016 11:32,2015,3,EASTERN EUROPE-EU,LITHUANIA,2,EDINBURGH,VILNIUS,258,0,258,537,0,537,-51.95530726
17/03/2016 11:32,2015,3,EASTERN EUROPE-EU,LITHUANIA,2,GLASGOW,VILNIUS,8222,8222,0,0,0,0,0
17/03/2016 11:32,2015,3,EASTERN EUROPE-EU,LITHUANIA,2,LIVERPOOL (JOHN LENNON),VILNIUS,37103,37103,0,35918,35918,0,3.299181469
17/03/2016 11:32,2015,3,EASTERN EUROPE-EU,POLAND,1,GATWICK,KRAKOW,105487,104640,847,106993,106086,907,-1.407568719
17/03/2016 11:32,2015,3,EASTERN EUROPE-EU,POLAND,1,GATWICK,RZESZOW,359,0,359,428,0,428,-16.12149533
17/03/2016 11:32,2015,3,EASTERN EUROPE-EU,POLAND,1,GATWICK,WARSAW (CHOPIN),75234,75234,0,20871,20871,0,260.4714676
17/03/2016 11:32,2015,3,EASTERN EUROPE-EU,POLAND,1,HEATHROW,KRAKOW,38287,38287,0,0,0,0,0
17/03/2016 11:32,2015,3,EASTERN EUROPE-EU,POLAND,1,HEATHROW,WARSAW (CHOPIN),417107,417107,0,407667,407667,0,2.315615441
17/03/2016 11:32,2015,3,EASTERN EUROPE-EU,POLAND,1,LUTON,BYDGOSZCZ,777,0,777,0,0,0,0
17/03/2016 11:32,2015,3,EASTERN EUROPE-EU,POLAND,1,LUTON,GDANSK,270356,270221,135,234037,234022,15,15.51848639
17/03/2016 11:32,2015,3,EASTERN EUROPE-EU,POLAND,1,LUTON,KATOWICE,299739,299739,0,219144,219144,0,36.7771876
17/03/2016 11:32,2015,3,EASTERN EUROPE-EU,POLAND,1,LUTON,KRAKOW,876,0,876,898,0,898,-2.449888641
17/03/2016 11:32,2015,3,EASTERN EUROPE-EU,POLAND,1,LUTON,LODZ LUBLINEK,0,0,0,16,0,16,0
17/03/2016 11:32,2015,3,EASTERN EUROPE-EU,POLAND,1,LUTON,LUBLIN (PORT LOTNICZY),88724,88724,0,48169,48169,0,84.19315327
17/03/2016 11:32,2015,3,EASTERN EUROPE-EU,POLAND,1,LUTON,POZNAN,136493,136493,0,102939,102939,0,32.59600346
17/03/2016 11:32,2015,3,EASTERN EUROPE-EU,POLAND,1,LUTON,RZESZOW,54681,54681,0,52682,52682,0,3.794464903
17/03/2016 11:32,2015,3,EASTERN EUROPE-EU,POLAND,1,LUTON,SZCZECIN (GOLENOW),44842,44842,0,6366,6366,0,604.3983663
17/03/2016 11:32,2015,3,EASTERN EUROPE-EU,POLAND,1,LUTON,WARSAW (CHOPIN),356462,356462,0,321815,321815,0,10.76612339
17/03/2016 11:32,2015,3,EASTERN EUROPE-EU,POLAND,1,LUTON,WROCLAW,103239,103239,0,81419,81419,0,26.79964136
17/03/2016 11:32,2015,3,EASTERN EUROPE-EU,POLAND,1,SOUTHEND,KRAKOW,0,0,0,38862,38862,0,0
17/03/2016 11:32,2015,3,EASTERN EUROPE-EU,POLAND,1,STANSTED,BYDGOSZCZ,113907,113907,0,112686,112686,0,1.083541877
17/03/2016 11:32,2015,3,EASTERN EUROPE-EU,POLAND,1,STANSTED,GDANSK,207284,207284,0,163057,163036,21,27.12364388
17/03/2016 11:32,2015,3,EASTERN EUROPE-EU,POLAND,1,STANSTED,KATOWICE,132461,132461,0,129069,128843,226,2.628051662
17/03/2016 11:32,2015,3,EASTERN EUROPE-EU,POLAND,1,STANSTED,KRAKOW,307139,306043,1096,258988,258541,447,18.5919811
17/03/2016 11:32,2015,3,EASTERN EUROPE-EU,POLAND,1,STANSTED,LODZ LUBLINEK,106128,106128,0,100837,100837,0,5.247081924
17/03/2016 11:32,2015,3,EASTERN EUROPE-EU,POLAND,1,STANSTED,LUBLIN (PORT LOTNICZY),68294,68294,0,61621,61621,0,10.82910047
17/03/2016 11:32,2015,3,EASTERN EUROPE-EU,POLAND,1,STANSTED,POZNAN,124916,124916,0,128195,128195,0,-2.557822068
17/03/2016 11:32,2015,3,EASTERN EUROPE-EU,POLAND,1,STANSTED,RZESZOW,140157,140157,0,115162,115162,0,21.70420799
17/03/2016 11:32,2015,3,EASTERN EUROPE-EU,POLAND,1,STANSTED,SZCZECIN (GOLENOW),98677,98677,0,62965,62965,0,56.71722385
17/03/2016 11:32,2015,3,EASTERN EUROPE-EU,POLAND,1,STANSTED,WARSAW (MODLIN MASOVIA),371836,371836,0,330289,330289,0,12.57898386
17/03/2016 11:32,2015,3,EASTERN EUROPE-EU,POLAND,1,STANSTED,WROCLAW,209654,209654,0,180406,180406,0,16.2123211
17/03/2016 11:32,2015,3,EASTERN EUROPE-EU,POLAND,2,ABERDEEN,GDANSK,18118,18118,0,0,0,0,0
17/03/2016 11:32,2015,3,EASTERN EUROPE-EU,POLAND,2,BELFAST INTERNATIONAL,GDANSK,0,0,0,142,0,142,0
17/03/2016 11:32,2015,3,EASTERN EUROPE-EU,POLAND,2,BELFAST INTERNATIONAL,KATOWICE,23155,23155,0,0,0,0,0
17/03/2016 11:32,2015,3,EASTERN EUROPE-EU,POLAND,2,BELFAST INTERNATIONAL,KRAKOW,44157,44157,0,44742,44742,0,-1.307496312
17/03/2016 11:32,2015,3,EASTERN EUROPE-EU,POLAND,2,BIRMINGHAM,BYDGOSZCZ,52020,52020,0,55445,55445,0,-6.177292813
17/03/2016 11:32,2015,3,EASTERN EUROPE-EU,POLAND,2,BIRMINGHAM,GDANSK,39394,39394,0,26223,26165,58,50.22690005
17/03/2016 11:32,2015,3,EASTERN EUROPE-EU,POLAND,2,BIRMINGHAM,KATOWICE,37154,37105,49,36668,36668,0,1.325406349
17/03/2016 11:32,2015,3,EASTERN EUROPE-EU,POLAND,2,BIRMINGHAM,KRAKOW,38173,37349,824,38240,37004,1236,-0.175209205
17/03/2016 11:32,2015,3,EASTERN EUROPE-EU,POLAND,2,BIRMINGHAM,POZNAN,863,863,0,0,0,0,0
17/03/2016 11:32,2015,3,EASTERN EUROPE-EU,POLAND,2,BIRMINGHAM,RZESZOW,0,0,0,7992,7992,0,0
17/03/2016 11:32,2015,3,EASTERN EUROPE-EU,POLAND,2,BIRMINGHAM,WARSAW (CHOPIN),9027,9027,0,0,0,0,0
17/03/2016 11:32,2015,3,EASTERN EUROPE-EU,POLAND,2,BOURNEMOUTH,KRAKOW,0,0,0,175,0,175,0
17/03/2016 11:32,2015,3,EASTERN EUROPE-EU,POLAND,2,BRISTOL,GDANSK,37815,37815,0,36355,36355,0,4.015953789
17/03/2016 11:32,2015,3,EASTERN EUROPE-EU,POLAND,2,BRISTOL,KATOWICE,21856,21856,0,7857,7857,0,178.1723304
17/03/2016 11:32,2015,3,EASTERN EUROPE-EU,POLAND,2,BRISTOL,KRAKOW,59842,59842,0,60898,60898,0,-1.734047095
17/03/2016 11:32,2015,3,EASTERN EUROPE-EU,POLAND,2,BRISTOL,POZNAN,35257,35257,0,35530,35530,0,-0.768364762
17/03/2016 11:32,2015,3,EASTERN EUROPE-EU,POLAND,2,BRISTOL,RZESZOW,28491,28491,0,22322,22322,0,27.63641251
17/03/2016 11:32,2015,3,EASTERN EUROPE-EU,POLAND,2,BRISTOL,SZCZECIN (GOLENOW),0,0,0,46,0,46,0
17/03/2016 11:32,2015,3,EASTERN EUROPE-EU,POLAND,2,BRISTOL,WARSAW (CHOPIN),0,0,0,50,0,50,0
17/03/2016 11:32,2015,3,EASTERN EUROPE-EU,POLAND,2,BRISTOL,WARSAW (MODLIN MASOVIA),55946,55946,0,52676,52676,0,6.20776065
17/03/2016 11:32,2015,3,EASTERN EUROPE-EU,POLAND,2,BRISTOL,WROCLAW,38130,38130,0,36171,36171,0,5.415940947
17/03/2016 11:32,2015,3,EASTERN EUROPE-EU,POLAND,2,CARDIFF WALES,KRAKOW,366,0,366,375,0,375,-2.4
17/03/2016 11:32,2015,3,EASTERN EUROPE-EU,POLAND,2,DONCASTER SHEFFIELD,GDANSK,76029,76029,0,64439,64439,0,17.98600227
17/03/2016 11:32,2015,3,EASTERN EUROPE-EU,POLAND,2,DONCASTER SHEFFIELD,KATOWICE,77627,77627,0,55867,55867,0,38.94964827
17/03/2016 11:32,2015,3,EASTERN EUROPE-EU,POLAND,2,DONCASTER SHEFFIELD,LUBLIN (PORT LOTNICZY),9348,9348,0,0,0,0,0
17/03/2016 11:32,2015,3,EASTERN EUROPE-EU,POLAND,2,DONCASTER SHEFFIELD,POZNAN,54101,54101,0,43612,43612,0,24.05071999
17/03/2016 11:32,2015,3,EASTERN EUROPE-EU,POLAND,2,DONCASTER SHEFFIELD,WARSAW (CHOPIN),44286,44286,0,36831,36831,0,20.24110125
17/03/2016 11:32,2015,3,EASTERN EUROPE-EU,POLAND,2,DONCASTER SHEFFIELD,WARSAW (MODLIN MASOVIA),144,144,0,0,0,0,0
17/03/2016 11:32,2015,3,EASTERN EUROPE-EU,POLAND,2,DONCASTER SHEFFIELD,WROCLAW,48618,48618,0,43486,43486,0,11.80149933
17/03/2016 11:32,2015,3,EASTERN EUROPE-EU,POLAND,2,EAST MIDLANDS INTERNATIONAL,KRAKOW,46814,46383,431,43157,42720,437,8.47371226
17/03/2016 11:32,2015,3,EASTERN EUROPE-EU,POLAND,2,EAST MIDLANDS INTERNATIONAL,LODZ LUBLINEK,46701,46701,0,43244,43244,0,7.994172602
17/03/2016 11:32,2015,3,EASTERN EUROPE-EU,POLAND,2,EAST MIDLANDS INTERNATIONAL,RZESZOW,55202,55202,0,48858,48858,0,12.98456752
17/03/2016 11:32,2015,3,EASTERN EUROPE-EU,POLAND,2,EAST MIDLANDS INTERNATIONAL,WARSAW (CHOPIN),21,0,21,0,0,0,0
17/03/2016 11:32,2015,3,EASTERN EUROPE-EU,POLAND,2,EAST MIDLANDS INTERNATIONAL,WARSAW (MODLIN MASOVIA),53860,53860,0,44890,44890,0,19.98217866
17/03/2016 11:32,2015,3,EASTERN EUROPE-EU,POLAND,2,EAST MIDLANDS INTERNATIONAL,WROCLAW,81458,81458,0,77795,77795,0,4.708528826
17/03/2016 11:32,2015,3,EASTERN EUROPE-EU,POLAND,2,EDINBURGH,GDANSK,50064,49664,400,39820,39468,352,25.72576595
17/03/2016 11:32,2015,3,EASTERN EUROPE-EU,POLAND,2,EDINBURGH,KRAKOW,117527,117071,456,109805,109380,425,7.032466645
17/03/2016 11:32,2015,3,EASTERN EUROPE-EU,POLAND,2,EDINBURGH,POZNAN,19388,19388,0,21398,21398,0,-9.393401252
17/03/2016 11:32,2015,3,EASTERN EUROPE-EU,POLAND,2,EDINBURGH,RZESZOW,6568,6568,0,0,0,0,0
17/03/2016 11:32,2015,3,EASTERN EUROPE-EU,POLAND,2,EXETER,KRAKOW,434,0,434,449,0,449,-3.340757238
17/03/2016 11:32,2015,3,EASTERN EUROPE-EU,POLAND,2,GLASGOW,BYDGOSZCZ,32474,32474,0,5765,5765,0,463.2957502
17/03/2016 11:32,2015,3,EASTERN EUROPE-EU,POLAND,2,GLASGOW,GDANSK,37849,37849,0,32669,32669,0,15.85601028
17/03/2016 11:32,2015,3,EASTERN EUROPE-EU,POLAND,2,GLASGOW,KATOWICE,33393,33393,0,8277,8277,0,303.4432765
17/03/2016 11:32,2015,3,EASTERN EUROPE-EU,POLAND,2,GLASGOW,KRAKOW,436,0,436,456,0,456,-4.385964912
17/03/2016 11:32,2015,3,EASTERN EUROPE-EU,POLAND,2,GLASGOW,LUBLIN (PORT LOTNICZY),8929,8929,0,0,0,0,0
17/03/2016 11:32,2015,3,EASTERN EUROPE-EU,POLAND,2,GLASGOW,POZNAN,30146,30146,0,5371,5371,0,461.2735059
17/03/2016 11:32,2015,3,EASTERN EUROPE-EU,POLAND,2,GLASGOW,WARSAW (CHOPIN),42207,41762,445,33502,32460,1042,25.98352337
17/03/2016 11:32,2015,3,EASTERN EUROPE-EU,POLAND,2,GLASGOW,WARSAW (MODLIN MASOVIA),54653,54653,0,9109,9109,0,499.9890218
17/03/2016 11:32,2015,3,EASTERN EUROPE-EU,POLAND,2,GLASGOW,WROCLAW,37924,37924,0,6598,6598,0,474.7802364
17/03/2016 11:32,2015,3,EASTERN EUROPE-EU,POLAND,2,LEEDS BRADFORD,GDANSK,40357,40357,0,25002,25002,0,61.41508679
17/03/2016 11:32,2015,3,EASTERN EUROPE-EU,POLAND,2,LEEDS BRADFORD,KRAKOW,55172,54714,458,49460,49014,446,11.54872624
17/03/2016 11:32,2015,3,EASTERN EUROPE-EU,POLAND,2,LIVERPOOL (JOHN LENNON),GDANSK,52589,52589,0,40962,40962,0,28.38484449
17/03/2016 11:32,2015,3,EASTERN EUROPE-EU,POLAND,2,LIVERPOOL (JOHN LENNON),KRAKOW,104733,104733,0,88700,88700,0,18.07553551
17/03/2016 11:32,2015,3,EASTERN EUROPE-EU,POLAND,2,LIVERPOOL (JOHN LENNON),LODZ LUBLINEK,0,0,0,6862,6862,0,0
17/03/2016 11:32,2015,3,EASTERN EUROPE-EU,POLAND,2,LIVERPOOL (JOHN LENNON),POZNAN,35579,35579,0,35838,35838,0,-0.722696579
17/03/2016 11:32,2015,3,EASTERN EUROPE-EU,POLAND,2,LIVERPOOL (JOHN LENNON),SZCZECIN (GOLENOW),23274,23274,0,20096,20096,0,15.81409236
17/03/2016 11:32,2015,3,EASTERN EUROPE-EU,POLAND,2,LIVERPOOL (JOHN LENNON),WARSAW (CHOPIN),28838,28838,0,30065,30065,0,-4.081157492
17/03/2016 11:32,2015,3,EASTERN EUROPE-EU,POLAND,2,LIVERPOOL (JOHN LENNON),WARSAW (MODLIN MASOVIA),75067,75067,0,55969,55969,0,34.12246065
17/03/2016 11:32,2015,3,EASTERN EUROPE-EU,POLAND,2,LIVERPOOL (JOHN LENNON),WROCLAW,57519,57519,0,51109,51109,0,12.54182238
17/03/2016 11:32,2015,3,EASTERN EUROPE-EU,POLAND,2,MANCHESTER,GDANSK,35766,35766,0,33169,33169,0,7.829599928
17/03/2016 11:32,2015,3,EASTERN EUROPE-EU,POLAND,2,MANCHESTER,KATOWICE,0,0,0,7293,7293,0,0
17/03/2016 11:32,2015,3,EASTERN EUROPE-EU,POLAND,2,MANCHESTER,KRAKOW,57939,57084,855,53701,53253,448,7.891845589
17/03/2016 11:32,2015,3,EASTERN EUROPE-EU,POLAND,2,MANCHESTER,POZNAN,167,167,0,0,0,0,0
17/03/2016 11:32,2015,3,EASTERN EUROPE-EU,POLAND,2,MANCHESTER,RZESZOW,37947,37947,0,36255,36255,0,4.666942491
17/03/2016 11:32,2015,3,EASTERN EUROPE-EU,POLAND,2,MANCHESTER,WARSAW (MODLIN MASOVIA),44257,44257,0,40455,40455,0,9.398096651
17/03/2016 11:32,2015,3,EASTERN EUROPE-EU,POLAND,2,NEWCASTLE,KRAKOW,26556,26124,432,25595,25153,442,3.754639578
17/03/2016 11:32,2015,3,EASTERN EUROPE-EU,POLAND,2,PRESTWICK,BYDGOSZCZ,0,0,0,7177,7177,0,0
17/03/2016 11:32,2015,3,EASTERN EUROPE-EU,POLAND,2,PRESTWICK,WARSAW (MODLIN MASOVIA),0,0,0,44491,44491,0,0
17/03/2016 11:32,2015,3,EASTERN EUROPE-EU,POLAND,2,PRESTWICK,WROCLAW,0,0,0,31295,31295,0,0
17/03/2016 11:32,2015,3,EASTERN EUROPE-EU,ROMANIA,1,GATWICK,BUCHAREST (OTOPENI),13332,13332,0,56528,56528,0,-76.41522785
17/03/2016 11:32,2015,3,EASTERN EUROPE-EU,ROMANIA,1,HEATHROW,BUCHAREST (BANEASA),13,0,13,0,0,0,0
17/03/2016 11:32,2015,3,EASTERN EUROPE-EU,ROMANIA,1,HEATHROW,BUCHAREST (OTOPENI),253590,253590,0,236535,236535,0,7.21034942
17/03/2016 11:32,2015,3,EASTERN EUROPE-EU,ROMANIA,1,LUTON,BACAU,72459,72459,0,66023,66023,0,9.74811808
17/03/2016 11:32,2015,3,EASTERN EUROPE-EU,ROMANIA,1,LUTON,BUCHAREST (OTOPENI),417520,417481,39,340945,340945,0,22.45963425
17/03/2016 11:32,2015,3,EASTERN EUROPE-EU,ROMANIA,1,LUTON,CLUJ NAPOCA,190976,190955,21,128354,128354,0,48.78850679
17/03/2016 11:32,2015,3,EASTERN EUROPE-EU,ROMANIA,1,LUTON,CONSTANTA,17583,17583,0,0,0,0,0
17/03/2016 11:32,2015,3,EASTERN EUROPE-EU,ROMANIA,1,LUTON,CRAIOVA,27092,27092,0,38553,38553,0,-29.72790704
17/03/2016 11:32,2015,3,EASTERN EUROPE-EU,ROMANIA,1,LUTON,IASI,34589,34589,0,16417,16417,0,110.6901383
17/03/2016 11:32,2015,3,EASTERN EUROPE-EU,ROMANIA,1,LUTON,SIBIU,40064,40064,0,22731,22731,0,76.25269456
17/03/2016 11:32,2015,3,EASTERN EUROPE-EU,ROMANIA,1,LUTON,TIMISOARA,75878,75878,0,56709,56709,0,33.80239468
17/03/2016 11:32,2015,3,EASTERN EUROPE-EU,ROMANIA,1,LUTON,TIRGU MURES,69163,69163,0,55265,55265,0,25.14792364
17/03/2016 11:32,2015,3,EASTERN EUROPE-EU,ROMANIA,1,STANSTED,BUCHAREST (OTOPENI),252646,252646,0,116769,116769,0,116.3639322
17/03/2016 11:32,2015,3,EASTERN EUROPE-EU,ROMANIA,2,BELFAST INTERNATIONAL,BUCHAREST (OTOPENI),290,0,290,0,0,0,0
17/03/2016 11:32,2015,3,EASTERN EUROPE-EU,ROMANIA,2,CARDIFF WALES,BUCHAREST (OTOPENI),0,0,0,118,0,118,0
17/03/2016 11:32,2015,3,EASTERN EUROPE-EU,ROMANIA,2,DONCASTER SHEFFIELD,BUCHAREST (OTOPENI),32822,32822,0,17049,17049,0,92.51569007
17/03/2016 11:32,2015,3,EASTERN EUROPE-EU,ROMANIA,2,EDINBURGH,BUCHAREST (OTOPENI),0,0,0,96,0,96,0
17/03/2016 11:32,2015,3,EASTERN EUROPE-EU,ROMANIA,2,GLASGOW,BUCHAREST (OTOPENI),1923,1923,0,281,0,281,584.341637
17/03/2016 11:32,2015,3,EASTERN EUROPE-EU,ROMANIA,2,INVERNESS,BUCHAREST (OTOPENI),78,0,78,0,0,0,0
17/03/2016 11:32,2015,3,EASTERN EUROPE-EU,ROMANIA,2,LIVERPOOL (JOHN LENNON),BACAU,12451,12451,0,0,0,0,0
17/03/2016 11:32,2015,3,EASTERN EUROPE-EU,ROMANIA,2,LIVERPOOL (JOHN LENNON),BUCHAREST (OTOPENI),40303,40303,0,1572,1572,0,2463.804071
17/03/2016 11:32,2015,3,EASTERN EUROPE-EU,ROMANIA,2,MANCHESTER,BUCHAREST (OTOPENI),0,0,0,74,74,0,0
17/03/2016 11:32,2015,3,EASTERN EUROPE-EU,SLOVAK REPUBLIC,1,LUTON,BRATISLAVA,72175,72127,48,69813,69813,0,3.383324023
17/03/2016 11:32,2015,3,EASTERN EUROPE-EU,SLOVAK REPUBLIC,1,LUTON,KOSICE,127734,127734,0,110202,110202,0,15.90896717
17/03/2016 11:32,2015,3,EASTERN EUROPE-EU,SLOVAK REPUBLIC,1,LUTON,TATRY-POPRAD,62428,62428,0,9071,9071,0,588.2151913
17/03/2016 11:32,2015,3,EASTERN EUROPE-EU,SLOVAK REPUBLIC,1,SOUTHEND,BRATISLAVA,33,0,33,0,0,0,0
17/03/2016 11:32,2015,3,EASTERN EUROPE-EU,SLOVAK REPUBLIC,1,STANSTED,BRATISLAVA,232641,232641,0,207303,207303,0,12.22268853
17/03/2016 11:32,2015,3,EASTERN EUROPE-EU,SLOVAK REPUBLIC,2,BELFAST INTERNATIONAL,BRATISLAVA,250,52,198,0,0,0,0
17/03/2016 11:32,2015,3,EASTERN EUROPE-EU,SLOVAK REPUBLIC,2,BELFAST INTERNATIONAL,PIESTANY,86,0,86,0,0,0,0
17/03/2016 11:32,2015,3,EASTERN EUROPE-EU,SLOVAK REPUBLIC,2,BIRMINGHAM,BRATISLAVA,54278,54278,0,46012,46012,0,17.96487873
17/03/2016 11:32,2015,3,EASTERN EUROPE-EU,SLOVAK REPUBLIC,2,BIRMINGHAM,KOSICE,0,0,0,136,136,0,0
17/03/2016 11:32,2015,3,EASTERN EUROPE-EU,SLOVAK REPUBLIC,2,BRISTOL,KOSICE,6186,6186,0,0,0,0,0
17/03/2016 11:32,2015,3,EASTERN EUROPE-EU,SLOVAK REPUBLIC,2,DONCASTER SHEFFIELD,KOSICE,19314,19314,0,0,0,0,0
17/03/2016 11:32,2015,3,EASTERN EUROPE-EU,SLOVAK REPUBLIC,2,EDINBURGH,BRATISLAVA,23561,23561,0,23087,22897,190,2.053103478
17/03/2016 11:32,2015,3,EASTERN EUROPE-EU,SLOVAK REPUBLIC,2,HUMBERSIDE,BRATISLAVA,0,0,0,186,0,186,0
17/03/2016 11:32,2015,3,EASTERN EUROPE-EU,SLOVAK REPUBLIC,2,HUMBERSIDE,PIESTANY,0,0,0,338,0,338,0
17/03/2016 11:32,2015,3,EASTERN EUROPE-EU,SLOVAK REPUBLIC,2,LIVERPOOL (JOHN LENNON),BRATISLAVA,54677,54677,0,43239,43239,0,26.4529707
17/03/2016 11:32,2015,4,EASTERN EUROPE -OTHER,ALBANIA,1,GATWICK,TIRANA,74159,62687,11472,57345,50868,6477,29.32077775
17/03/2016 11:32,2015,4,EASTERN EUROPE -OTHER,ALBANIA,1,STANSTED,TIRANA,2106,0,2106,0,0,0,0
17/03/2016 11:32,2015,4,EASTERN EUROPE -OTHER,ALBANIA,2,BELFAST INTERNATIONAL,TIRANA,60,0,60,0,0,0,0
17/03/2016 11:32,2015,4,EASTERN EUROPE -OTHER,ARMENIA,2,EDINBURGH,YEREVAN,218,0,218,0,0,0,0
17/03/2016 11:32,2015,4,EASTERN EUROPE -OTHER,AZERBAIJAN,1,HEATHROW,BAKU (HEYDER ALIYEV INT'L),82685,82685,0,81297,81297,0,1.707320073
17/03/2016 11:32,2015,4,EASTERN EUROPE -OTHER,AZERBAIJAN,1,LUTON,BAKU (HEYDER ALIYEV INT'L),12,0,12,49,0,49,-75.51020408
17/03/2016 11:32,2015,4,EASTERN EUROPE -OTHER,AZERBAIJAN,2,GLASGOW,BAKU (HEYDER ALIYEV INT'L),218,0,218,0,0,0,0
17/03/2016 11:32,2015,4,EASTERN EUROPE -OTHER,BELARUS,1,GATWICK,MINSK INT'L ,22137,22137,0,22573,22459,114,-1.931511097
17/03/2016 11:32,2015,4,EASTERN EUROPE -OTHER,BELARUS,2,BELFAST INTERNATIONAL,MINSK INT'L ,66,0,66,92,0,92,-28.26086957
17/03/2016 11:32,2015,4,EASTERN EUROPE -OTHER,BELARUS,2,MANCHESTER,MINSK INT'L ,2323,2323,0,2382,2382,0,-2.47691016
17/03/2016 11:32,2015,4,EASTERN EUROPE -OTHER,GEORGIA,2,GLASGOW,TBILISI,254,0,254,0,0,0,0
17/03/2016 11:32,2015,4,EASTERN EUROPE -OTHER,KAZAKHSTAN,1,HEATHROW,ALMATY,23259,23259,0,37394,37394,0,-37.80018185
17/03/2016 11:32,2015,4,EASTERN EUROPE -OTHER,KAZAKHSTAN,1,HEATHROW,ASTANA,26197,26197,0,19187,19187,0,36.53515401
17/03/2016 11:32,2015,4,EASTERN EUROPE -OTHER,KAZAKHSTAN,1,LUTON,ALMATY,2,0,2,0,0,0,0
17/03/2016 11:32,2015,4,EASTERN EUROPE -OTHER,KYRGYZSTAN,1,LUTON,BISHKEK (FRUNZE),0,0,0,1,0,1,0
17/03/2016 11:32,2015,4,EASTERN EUROPE -OTHER,REPUBLIC OF MOLDOVA,1,LUTON,CHISINAU (KISHINEV),7832,7832,0,774,774,0,911.8863049
17/03/2016 11:32,2015,4,EASTERN EUROPE -OTHER,REPUBLIC OF MOLDOVA,1,STANSTED,CHISINAU (KISHINEV),33598,33598,0,24152,24152,0,39.11063266
17/03/2016 11:32,2015,4,EASTERN EUROPE -OTHER,RUSSIA,1,GATWICK,ADLER / SOCHI,0,0,0,777,0,777,0
17/03/2016 11:32,2015,4,EASTERN EUROPE -OTHER,RUSSIA,1,GATWICK,MOSCOW (DOMODEDOVO),113235,113235,0,209948,209948,0,-46.06521615
17/03/2016 11:32,2015,4,EASTERN EUROPE -OTHER,RUSSIA,1,HEATHROW,IRKUTSK,0,0,0,287,0,287,0
17/03/2016 11:32,2015,4,EASTERN EUROPE -OTHER,RUSSIA,1,HEATHROW,MOSCOW (DOMODEDOVO),247141,247141,0,289259,289259,0,-14.56065326
17/03/2016 11:32,2015,4,EASTERN EUROPE -OTHER,RUSSIA,1,HEATHROW,MOSCOW (SHEREMETYEVO),293876,293876,0,293234,293234,0,0.218937777
17/03/2016 11:32,2015,4,EASTERN EUROPE -OTHER,RUSSIA,1,HEATHROW,MOSCOW (VNUKOVO),90672,90672,0,100419,100419,0,-9.706330475
17/03/2016 11:32,2015,4,EASTERN EUROPE -OTHER,RUSSIA,1,HEATHROW,ST PETERSBURG,79823,79823,0,86803,86803,0,-8.041196733
17/03/2016 11:32,2015,4,EASTERN EUROPE -OTHER,RUSSIA,1,LUTON,ADLER / SOCHI,1230,0,1230,0,0,0,0
17/03/2016 11:32,2015,4,EASTERN EUROPE -OTHER,RUSSIA,1,LUTON,MOSCOW (SHEREMETYEVO),3,0,3,0,0,0,0
17/03/2016 11:32,2015,4,EASTERN EUROPE -OTHER,RUSSIA,1,LUTON,MOSCOW (VNUKOVO),3,0,3,2,0,2,50
17/03/2016 11:32,2015,4,EASTERN EUROPE -OTHER,RUSSIA,1,LUTON,ST PETERSBURG,2,0,2,0,0,0,0
17/03/2016 11:32,2015,4,EASTERN EUROPE -OTHER,RUSSIA,1,STANSTED,ST PETERSBURG,0,0,0,109,0,109,0
17/03/2016 11:32,2015,4,EASTERN EUROPE -OTHER,RUSSIA,2,ABERDEEN,KAZAN,44,0,44,0,0,0,0
17/03/2016 11:32,2015,4,EASTERN EUROPE -OTHER,RUSSIA,2,ABERDEEN,MOSCOW (SHEREMETYEVO),43,0,43,0,0,0,0
17/03/2016 11:32,2015,4,EASTERN EUROPE -OTHER,RUSSIA,2,BIGGIN HILL,MOSCOW (SHEREMETYEVO),10,0,10,2,0,2,400
17/03/2016 11:32,2015,4,EASTERN EUROPE -OTHER,RUSSIA,2,BIRMINGHAM,ST PETERSBURG,0,0,0,159,0,159,0
17/03/2016 11:32,2015,4,EASTERN EUROPE -OTHER,RUSSIA,2,LIVERPOOL (JOHN LENNON),KAZAN,163,0,163,0,0,0,0
17/03/2016 11:32,2015,4,EASTERN EUROPE -OTHER,RUSSIA,2,LIVERPOOL (JOHN LENNON),KRASNODAR,41,0,41,210,0,210,-80.47619048
17/03/2016 11:32,2015,4,EASTERN EUROPE -OTHER,RUSSIA,2,MANCHESTER,MOSCOW (DOMODEDOVO),19426,19426,0,37929,37929,0,-48.78325292
17/03/2016 11:32,2015,4,EASTERN EUROPE -OTHER,RUSSIA,2,MANCHESTER,MOSCOW (SHEREMETYEVO),431,0,431,245,0,245,75.91836735
17/03/2016 11:32,2015,4,EASTERN EUROPE -OTHER,TAJIKISTAN,1,GATWICK,DUSHANBE,0,0,0,85,0,85,0
17/03/2016 11:32,2015,4,EASTERN EUROPE -OTHER,TURKMENISTAN,1,HEATHROW,ASHKHABAD,18493,18493,0,26933,26933,0,-31.3370215
17/03/2016 11:32,2015,4,EASTERN EUROPE -OTHER,TURKMENISTAN,2,BIRMINGHAM,ASHKHABAD,43933,43933,0,59448,59448,0,-26.09843897
17/03/2016 11:32,2015,4,EASTERN EUROPE -OTHER,UKRAINE,1,GATWICK,KIEV (BORISPOL),125892,125426,466,104085,104085,0,20.9511457
17/03/2016 11:32,2015,4,EASTERN EUROPE -OTHER,UKRAINE,1,HEATHROW,KIEV (BORISPOL),72523,72523,0,71632,71632,0,1.243857494
17/03/2016 11:32,2015,4,EASTERN EUROPE -OTHER,UKRAINE,1,LUTON,KIEV (BORISPOL),120,0,120,0,0,0,0
17/03/2016 11:32,2015,4,EASTERN EUROPE -OTHER,UKRAINE,1,LUTON,KIEV (ZHULYANY),30092,30088,4,39216,39216,0,-23.26601387
17/03/2016 11:32,2015,4,EASTERN EUROPE -OTHER,UKRAINE,2,LIVERPOOL (JOHN LENNON),KIEV (BORISPOL),299,0,299,0,0,0,0
17/03/2016 11:32,2015,4,EASTERN EUROPE -OTHER,UKRAINE,2,LIVERPOOL (JOHN LENNON),KIEV (ZHULYANY),460,0,460,0,0,0,0
17/03/2016 11:32,2015,4,EASTERN EUROPE -OTHER,UZBEKISTAN,1,GATWICK,TASHKENT,205,0,205,628,0,628,-67.3566879
17/03/2016 11:32,2015,4,EASTERN EUROPE -OTHER,UZBEKISTAN,1,HEATHROW,TASHKENT,25098,25098,0,24049,24049,0,4.361927731
17/03/2016 11:32,2015,25,NEAR EAST,ISRAEL,1,GATWICK,TEL AVIV,51911,51387,524,34743,33850,893,49.4142705
17/03/2016 11:32,2015,25,NEAR EAST,ISRAEL,1,HEATHROW,TEL AVIV,584298,584298,0,517478,517345,133,12.91262624
17/03/2016 11:32,2015,25,NEAR EAST,ISRAEL,1,LUTON,OVDA,1067,671,396,759,0,759,40.57971014
17/03/2016 11:32,2015,25,NEAR EAST,ISRAEL,1,LUTON,TEL AVIV,313035,310174,2861,290902,290196,706,7.608404205
17/03/2016 11:32,2015,25,NEAR EAST,ISRAEL,1,STANSTED,TEL AVIV,365,0,365,0,0,0,0
17/03/2016 11:32,2015,25,NEAR EAST,ISRAEL,2,CARDIFF WALES,TEL AVIV,283,0,283,0,0,0,0
17/03/2016 11:32,2015,25,NEAR EAST,ISRAEL,2,MANCHESTER,OVDA,7,0,7,25,0,25,-72
17/03/2016 11:32,2015,25,NEAR EAST,ISRAEL,2,MANCHESTER,TEL AVIV,34193,34193,0,38876,38721,155,-12.04599239
17/03/2016 11:32,2015,25,NEAR EAST,JORDAN,1,GATWICK,AMMAN,0,0,0,13505,13505,0,0
17/03/2016 11:32,2015,25,NEAR EAST,JORDAN,1,GATWICK,AQABA,0,0,0,403,0,403,0
17/03/2016 11:32,2015,25,NEAR EAST,JORDAN,1,HEATHROW,AMMAN,203783,203783,0,235231,235231,0,-13.36898623
17/03/2016 11:32,2015,25,NEAR EAST,JORDAN,1,LUTON,AQABA,0,0,0,45,0,45,0
17/03/2016 11:32,2015,25,NEAR EAST,JORDAN,2,EXETER,AMMAN,0,0,0,88,0,88,0
17/03/2016 11:32,2015,25,NEAR EAST,JORDAN,2,GLASGOW,AMMAN,112,0,112,0,0,0,0
17/03/2016 11:32,2015,25,NEAR EAST,JORDAN,2,MANCHESTER,AMMAN,103,0,103,0,0,0,0
17/03/2016 11:32,2015,25,NEAR EAST,LEBANON,1,HEATHROW,BEIRUT,255510,255510,0,261002,261002,0,-2.104198435
17/03/2016 11:32,2015,25,NEAR EAST,LEBANON,2,BELFAST INTERNATIONAL,BEIRUT,51,0,51,0,0,0,0
17/03/2016 11:32,2015,30,NORTH AFRICA,ALGERIA,1,GATWICK,ALGIERS,54914,54914,0,50484,50484,0,8.775057444
17/03/2016 11:32,2015,30,NORTH AFRICA,ALGERIA,1,GATWICK,HASSI MESSAOUD,2838,0,2838,7111,0,7111,-60.09000141
17/03/2016 11:32,2015,30,NORTH AFRICA,ALGERIA,1,HEATHROW,ALGIERS,71565,71565,0,69580,69580,0,2.852831273
17/03/2016 11:32,2015,30,NORTH AFRICA,ALGERIA,1,LUTON,ALGIERS,5,0,5,0,0,0,0
17/03/2016 11:32,2015,30,NORTH AFRICA,ALGERIA,1,STANSTED,HASSI MESSAOUD,5752,0,5752,0,0,0,0
17/03/2016 11:32,2015,30,NORTH AFRICA,EGYPT,1,GATWICK,HURGHADA,150140,60339,89801,156495,69062,87433,-4.060832614
17/03/2016 11:32,2015,30,NORTH AFRICA,EGYPT,1,GATWICK,LUXOR,8569,0,8569,12099,0,12099,-29.17596496
17/03/2016 11:32,2015,30,NORTH AFRICA,EGYPT,1,GATWICK,MARSA ALAM,16545,0,16545,17241,0,17241,-4.036888812
17/03/2016 11:32,2015,30,NORTH AFRICA,EGYPT,1,GATWICK,MERSA MATROUH,150,0,150,0,0,0,0
17/03/2016 11:32,2015,30,NORTH AFRICA,EGYPT,1,GATWICK,SHARM EL SHEIKH (OPHIRA),364385,192213,172172,382908,202922,179986,-4.837454428
17/03/2016 11:32,2015,30,NORTH AFRICA,EGYPT,1,HEATHROW,CAIRO,337505,337505,0,358233,358233,0,-5.786178269
17/03/2016 11:32,2015,30,NORTH AFRICA,EGYPT,1,HEATHROW,LUXOR,11067,11067,0,8249,8249,0,34.16171657
17/03/2016 11:32,2015,30,NORTH AFRICA,EGYPT,1,LUTON,MERSA MATROUH,133,0,133,0,0,0,0
17/03/2016 11:32,2015,30,NORTH AFRICA,EGYPT,1,LUTON,SHARM EL SHEIKH (OPHIRA),127600,114858,12742,160847,142690,18157,-20.66995343
17/03/2016 11:32,2015,30,NORTH AFRICA,EGYPT,1,STANSTED,SHARM EL SHEIKH (OPHIRA),50202,35432,14770,53688,42141,11547,-6.493071077
17/03/2016 11:32,2015,30,NORTH AFRICA,EGYPT,2,BELFAST INTERNATIONAL,SHARM EL SHEIKH (OPHIRA),6289,0,6289,6549,0,6549,-3.970071767
17/03/2016 11:32,2015,30,NORTH AFRICA,EGYPT,2,BIRMINGHAM,HURGHADA,26631,9831,16800,31077,13086,17991,-14.30640023
17/03/2016 11:32,2015,30,NORTH AFRICA,EGYPT,2,BIRMINGHAM,SHARM EL SHEIKH (OPHIRA),127024,60363,66661,118921,57526,61395,6.813767123
17/03/2016 11:32,2015,30,NORTH AFRICA,EGYPT,2,BOURNEMOUTH,SHARM EL SHEIKH (OPHIRA),381,0,381,2971,0,2971,-87.17603501
17/03/2016 11:32,2015,30,NORTH AFRICA,EGYPT,2,BRISTOL,SHARM EL SHEIKH (OPHIRA),38037,0,38037,32822,0,32822,15.88873317
17/03/2016 11:32,2015,30,NORTH AFRICA,EGYPT,2,CARDIFF WALES,SHARM EL SHEIKH (OPHIRA),15448,0,15448,23096,0,23096,-33.11395913
17/03/2016 11:32,2015,30,NORTH AFRICA,EGYPT,2,DONCASTER SHEFFIELD,SHARM EL SHEIKH (OPHIRA),21724,0,21724,20705,0,20705,4.921516542
17/03/2016 11:32,2015,30,NORTH AFRICA,EGYPT,2,EAST MIDLANDS INTERNATIONAL,HURGHADA,5787,0,5787,4351,0,4351,33.00390715
17/03/2016 11:32,2015,30,NORTH AFRICA,EGYPT,2,EAST MIDLANDS INTERNATIONAL,SHARM EL SHEIKH (OPHIRA),34398,0,34398,35120,0,35120,-2.055808656
17/03/2016 11:32,2015,30,NORTH AFRICA,EGYPT,2,EDINBURGH,SHARM EL SHEIKH (OPHIRA),17019,0,17019,19849,0,19849,-14.25764522
17/03/2016 11:32,2015,30,NORTH AFRICA,EGYPT,2,EXETER,SHARM EL SHEIKH (OPHIRA),13834,0,13834,10825,0,10825,27.79676674
17/03/2016 11:32,2015,30,NORTH AFRICA,EGYPT,2,GLASGOW,SHARM EL SHEIKH (OPHIRA),27921,0,27921,26927,0,26927,3.691462101
17/03/2016 11:32,2015,30,NORTH AFRICA,EGYPT,2,LIVERPOOL (JOHN LENNON),CAIRO,2,0,2,0,0,0,0
17/03/2016 11:32,2015,30,NORTH AFRICA,EGYPT,2,MANCHESTER,CAIRO,13260,13260,0,39385,39385,0,-66.33236004
17/03/2016 11:32,2015,30,NORTH AFRICA,EGYPT,2,MANCHESTER,HURGHADA,124896,34962,89934,103851,22974,80877,20.26460987
17/03/2016 11:32,2015,30,NORTH AFRICA,EGYPT,2,MANCHESTER,SHARM EL SHEIKH (OPHIRA),281697,114258,167439,308309,148160,160149,-8.631600115
17/03/2016 11:32,2015,30,NORTH AFRICA,EGYPT,2,NEWCASTLE,HURGHADA,14855,0,14855,1173,0,1173,1166.410912
17/03/2016 11:32,2015,30,NORTH AFRICA,EGYPT,2,NEWCASTLE,SHARM EL SHEIKH (OPHIRA),49521,0,49521,57433,0,57433,-13.7760521
17/03/2016 11:32,2015,30,NORTH AFRICA,LIBYA,1,GATWICK,TRIPOLI,0,0,0,12615,12605,10,0
17/03/2016 11:32,2015,30,NORTH AFRICA,LIBYA,1,HEATHROW,TRIPOLI,0,0,0,16625,16625,0,0
17/03/2016 11:32,2015,30,NORTH AFRICA,LIBYA,2,MANCHESTER,TRIPOLI,0,0,0,8456,8456,0,0
17/03/2016 11:32,2015,30,NORTH AFRICA,MOROCCO,1,GATWICK,AGADIR (AL MASSIRA),84769,84507,262,83563,83282,281,1.443222479
17/03/2016 11:32,2015,30,NORTH AFRICA,MOROCCO,1,GATWICK,CASABLANCA MOHAMED V,46916,46916,0,22607,22364,243,107.5286416
17/03/2016 11:32,2015,30,NORTH AFRICA,MOROCCO,1,GATWICK,ERRACHIDIA,0,0,0,367,0,367,0
17/03/2016 11:32,2015,30,NORTH AFRICA,MOROCCO,1,GATWICK,MARRAKESH,307440,307052,388,366354,366354,0,-16.0811674
17/03/2016 11:32,2015,30,NORTH AFRICA,MOROCCO,1,GATWICK,OUARZAZATE,928,0,928,339,0,339,173.7463127
17/03/2016 11:32,2015,30,NORTH AFRICA,MOROCCO,1,GATWICK,RABAT,2689,2689,0,0,0,0,0
17/03/2016 11:32,2015,30,NORTH AFRICA,MOROCCO,1,GATWICK,TANGIERS (IBN BATUTA),23634,23634,0,20437,20437,0,15.64319616
17/03/2016 11:32,2015,30,NORTH AFRICA,MOROCCO,1,HEATHROW,AGADIR (AL MASSIRA),0,0,0,4715,4715,0,0
17/03/2016 11:32,2015,30,NORTH AFRICA,MOROCCO,1,HEATHROW,CASABLANCA MOHAMED V,96311,96311,0,91724,91724,0,5.000872182
17/03/2016 11:32,2015,30,NORTH AFRICA,MOROCCO,1,HEATHROW,TANGIERS (IBN BATUTA),0,0,0,8589,8589,0,0
17/03/2016 11:32,2015,30,NORTH AFRICA,MOROCCO,1,LUTON,CASABLANCA MOHAMED V,0,0,0,114,0,114,0
17/03/2016 11:32,2015,30,NORTH AFRICA,MOROCCO,1,LUTON,ESSAOUIRA,17883,17883,0,0,0,0,0
17/03/2016 11:32,2015,30,NORTH AFRICA,MOROCCO,1,LUTON,MARRAKESH,65905,65898,7,55817,55674,143,18.07334683
17/03/2016 11:32,2015,30,NORTH AFRICA,MOROCCO,1,LUTON,OUJDA ANGAD,0,0,0,27,0,27,0
17/03/2016 11:32,2015,30,NORTH AFRICA,MOROCCO,1,LUTON,RABAT,0,0,0,100,0,100,0
17/03/2016 11:32,2015,30,NORTH AFRICA,MOROCCO,1,LUTON,TANGIERS (IBN BATUTA),39,0,39,0,0,0,0
17/03/2016 11:32,2015,30,NORTH AFRICA,MOROCCO,1,STANSTED,AGADIR (AL MASSIRA),0,0,0,8262,8262,0,0
17/03/2016 11:32,2015,30,NORTH AFRICA,MOROCCO,1,STANSTED,FEZ,33316,33316,0,32299,32299,0,3.148704294
17/03/2016 11:32,2015,30,NORTH AFRICA,MOROCCO,1,STANSTED,MARRAKESH,146752,146752,0,113389,113389,0,29.42348905
17/03/2016 11:32,2015,30,NORTH AFRICA,MOROCCO,1,STANSTED,RABAT,51774,51774,0,38643,38643,0,33.98028103
17/03/2016 11:32,2015,30,NORTH AFRICA,MOROCCO,2,BIGGIN HILL,MARRAKESH,18,0,18,0,0,0,0
17/03/2016 11:32,2015,30,NORTH AFRICA,MOROCCO,2,BIRMINGHAM,CASABLANCA MOHAMED V,0,0,0,194,0,194,0
17/03/2016 11:32,2015,30,NORTH AFRICA,MOROCCO,2,BIRMINGHAM,MARRAKESH,12297,12297,0,15187,15187,0,-19.02943307
17/03/2016 11:32,2015,30,NORTH AFRICA,MOROCCO,2,BRISTOL,MARRAKESH,30627,30627,0,29889,29889,0,2.469135802
17/03/2016 11:32,2015,30,NORTH AFRICA,MOROCCO,2,EAST MIDLANDS INTERNATIONAL,CASABLANCA MOHAMED V,0,0,0,36,0,36,0
17/03/2016 11:32,2015,30,NORTH AFRICA,MOROCCO,2,GLASGOW,CASABLANCA MOHAMED V,0,0,0,216,0,216,0
17/03/2016 11:32,2015,30,NORTH AFRICA,MOROCCO,2,GLASGOW,MARRAKESH,30913,30913,0,5193,5193,0,495.2821105
17/03/2016 11:32,2015,30,NORTH AFRICA,MOROCCO,2,MANCHESTER,AGADIR (AL MASSIRA),65478,65478,0,58347,58347,0,12.22170806
17/03/2016 11:32,2015,30,NORTH AFRICA,MOROCCO,2,MANCHESTER,CASABLANCA MOHAMED V,171,0,171,137,0,137,24.81751825
17/03/2016 11:32,2015,30,NORTH AFRICA,MOROCCO,2,MANCHESTER,MARRAKESH,83456,83456,0,76545,76545,0,9.028675942
17/03/2016 11:32,2015,30,NORTH AFRICA,TUNISIA,1,GATWICK,ENFIDHA - HAMMAMET INTL,67715,12877,54838,164574,19901,144673,-58.85437554
17/03/2016 11:32,2015,30,NORTH AFRICA,TUNISIA,1,GATWICK,JERBA,7231,0,7231,17473,0,17473,-58.61615063
17/03/2016 11:32,2015,30,NORTH AFRICA,TUNISIA,1,GATWICK,MONASTIR,2906,0,2906,9180,0,9180,-68.34422658
17/03/2016 11:32,2015,30,NORTH AFRICA,TUNISIA,1,GATWICK,TUNIS,23475,23475,0,6089,6089,0,285.5312859
17/03/2016 11:32,2015,30,NORTH AFRICA,TUNISIA,1,HEATHROW,MONASTIR,104,104,0,0,0,0,0
17/03/2016 11:32,2015,30,NORTH AFRICA,TUNISIA,1,HEATHROW,TUNIS,41927,41927,0,62855,62855,0,-33.29568053
17/03/2016 11:32,2015,30,NORTH AFRICA,TUNISIA,1,LUTON,ENFIDHA - HAMMAMET INTL,4735,0,4735,12113,0,12113,-60.90976637
17/03/2016 11:32,2015,30,NORTH AFRICA,TUNISIA,1,LUTON,MONASTIR,0,0,0,210,0,210,0
17/03/2016 11:32,2015,30,NORTH AFRICA,TUNISIA,1,STANSTED,ENFIDHA - HAMMAMET INTL,15493,0,15493,35720,0,35720,-56.62653975
17/03/2016 11:32,2015,30,NORTH AFRICA,TUNISIA,1,STANSTED,MONASTIR,2371,2371,0,0,0,0,0
17/03/2016 11:32,2015,30,NORTH AFRICA,TUNISIA,2,ABERDEEN,ENFIDHA - HAMMAMET INTL,0,0,0,2829,0,2829,0
17/03/2016 11:32,2015,30,NORTH AFRICA,TUNISIA,2,BELFAST INTERNATIONAL,ENFIDHA - HAMMAMET INTL,2902,0,2902,11427,0,11427,-74.60400805
17/03/2016 11:32,2015,30,NORTH AFRICA,TUNISIA,2,BELFAST INTERNATIONAL,MONASTIR,0,0,0,205,0,205,0
17/03/2016 11:32,2015,30,NORTH AFRICA,TUNISIA,2,BIRMINGHAM,ENFIDHA - HAMMAMET INTL,39542,0,39542,81046,0,81046,-51.21042371
17/03/2016 11:32,2015,30,NORTH AFRICA,TUNISIA,2,BIRMINGHAM,JERBA,3160,0,3160,0,0,0,0
17/03/2016 11:32,2015,30,NORTH AFRICA,TUNISIA,2,BRISTOL,ENFIDHA - HAMMAMET INTL,2970,0,2970,67338,0,67338,-95.5894146
17/03/2016 11:32,2015,30,NORTH AFRICA,TUNISIA,2,BRISTOL,MONASTIR,0,0,0,219,0,219,0
17/03/2016 11:32,2015,30,NORTH AFRICA,TUNISIA,2,CARDIFF WALES,ENFIDHA - HAMMAMET INTL,9798,0,9798,26836,0,26836,-63.48934267
17/03/2016 11:32,2015,30,NORTH AFRICA,TUNISIA,2,CARDIFF WALES,MONASTIR,0,0,0,328,0,328,0
17/03/2016 11:32,2015,30,NORTH AFRICA,TUNISIA,2,DONCASTER SHEFFIELD,ENFIDHA - HAMMAMET INTL,9392,0,9392,16677,0,16677,-43.68291659
17/03/2016 11:32,2015,30,NORTH AFRICA,TUNISIA,2,DONCASTER SHEFFIELD,MONASTIR,0,0,0,187,0,187,0
17/03/2016 11:32,2015,30,NORTH AFRICA,TUNISIA,2,EAST MIDLANDS INTERNATIONAL,ENFIDHA - HAMMAMET INTL,36584,1228,35356,68788,0,68788,-46.81630517
17/03/2016 11:32,2015,30,NORTH AFRICA,TUNISIA,2,EAST MIDLANDS INTERNATIONAL,MONASTIR,0,0,0,309,0,309,0
17/03/2016 11:32,2015,30,NORTH AFRICA,TUNISIA,2,EDINBURGH,ENFIDHA - HAMMAMET INTL,2903,0,2903,8974,0,8974,-67.65099175
17/03/2016 11:32,2015,30,NORTH AFRICA,TUNISIA,2,EXETER,ENFIDHA - HAMMAMET INTL,1653,0,1653,5972,0,5972,-72.32083054
17/03/2016 11:32,2015,30,NORTH AFRICA,TUNISIA,2,GLASGOW,ENFIDHA - HAMMAMET INTL,32294,1775,30519,55077,0,55077,-41.36572435
17/03/2016 11:32,2015,30,NORTH AFRICA,TUNISIA,2,GLASGOW,MONASTIR,0,0,0,856,0,856,0
17/03/2016 11:32,2015,30,NORTH AFRICA,TUNISIA,2,HUMBERSIDE,ENFIDHA - HAMMAMET INTL,0,0,0,4677,4399,278,0
17/03/2016 11:32,2015,30,NORTH AFRICA,TUNISIA,2,LEEDS BRADFORD,ENFIDHA - HAMMAMET INTL,4159,1360,2799,8871,0,8871,-53.11689776
17/03/2016 11:32,2015,30,NORTH AFRICA,TUNISIA,2,MANCHESTER,ENFIDHA - HAMMAMET INTL,79106,12507,66599,150359,18967,131392,-47.38858332
17/03/2016 11:32,2015,30,NORTH AFRICA,TUNISIA,2,MANCHESTER,JERBA,6040,0,6040,10499,0,10499,-42.4707115
17/03/2016 11:32,2015,30,NORTH AFRICA,TUNISIA,2,MANCHESTER,MONASTIR,3720,0,3720,11251,225,11026,-66.93627233
17/03/2016 11:32,2015,30,NORTH AFRICA,TUNISIA,2,MANCHESTER,TUNIS,0,0,0,168,168,0,0
17/03/2016 11:32,2015,30,NORTH AFRICA,TUNISIA,2,NEWCASTLE,ENFIDHA - HAMMAMET INTL,21192,1224,19968,45144,0,45144,-53.05688464
17/03/2016 11:32,2015,30,NORTH AFRICA,TUNISIA,2,NORWICH,ENFIDHA - HAMMAMET INTL,4101,0,4101,11817,0,11817,-65.29576035
17/03/2016 11:32,2015,35,EAST AFRICA,ETHIOPIA,1,HEATHROW,ADDIS ABABA,161558,161558,0,156101,155923,178,3.495813608
17/03/2016 11:32,2015,35,EAST AFRICA,KENYA,1,GATWICK,MOMBASA,0,0,0,10876,0,10876,0
17/03/2016 11:32,2015,35,EAST AFRICA,KENYA,1,HEATHROW,MOMBASA,224,224,0,0,0,0,0
17/03/2016 11:32,2015,35,EAST AFRICA,KENYA,1,HEATHROW,NAIROBI,290217,290217,0,333498,333498,0,-12.97788892
17/03/2016 11:32,2015,35,EAST AFRICA,KENYA,2,DURHAM TEES VALLEY,NAIROBI,453,0,453,0,0,0,0
17/03/2016 11:32,2015,35,EAST AFRICA,KENYA,2,MANCHESTER,NAIROBI,580,0,580,0,0,0,0
17/03/2016 11:32,2015,35,EAST AFRICA,UGANDA,1,HEATHROW,ENTEBBE,43857,43857,0,57596,57596,0,-23.85408709
17/03/2016 11:32,2015,40,WEST AFRICA,BURKINO FASO,1,LUTON,OUAGADOUGOU,0,0,0,3,0,3,0
17/03/2016 11:32,2015,40,WEST AFRICA,CAMEROON,1,GATWICK,DOUALA,0,0,0,50,50,0,0
17/03/2016 11:32,2015,40,WEST AFRICA,GABON,1,LUTON,LIBREVILLE,0,0,0,21,0,21,0
17/03/2016 11:32,2015,40,WEST AFRICA,GAMBIA,1,GATWICK,BANJUL,42880,9023,33857,53503,3426,50077,-19.8549614
17/03/2016 11:32,2015,40,WEST AFRICA,GAMBIA,1,STANSTED,BANJUL,0,0,0,315,0,315,0
17/03/2016 11:32,2015,40,WEST AFRICA,GAMBIA,2,BIRMINGHAM,BANJUL,7999,3324,4675,8433,0,8433,-5.146448476
17/03/2016 11:32,2015,40,WEST AFRICA,GAMBIA,2,EAST MIDLANDS INTERNATIONAL,BANJUL,218,0,218,0,0,0,0
17/03/2016 11:32,2015,40,WEST AFRICA,GAMBIA,2,MANCHESTER,BANJUL,19036,6475,12561,29532,0,29532,-35.54110795
17/03/2016 11:32,2015,40,WEST AFRICA,GHANA,1,GATWICK,ACCRA,560,0,560,137,0,137,308.7591241
17/03/2016 11:32,2015,40,WEST AFRICA,GHANA,1,HEATHROW,ACCRA,194935,194935,0,208706,208706,0,-6.598277002
17/03/2016 11:32,2015,40,WEST AFRICA,LIBERIA,1,HEATHROW,MONROVIA (ROBERTS),0,0,0,12098,12098,0,0
17/03/2016 11:32,2015,40,WEST AFRICA,NIGERIA,1,GATWICK,LAGOS,5175,5105,70,652,0,652,693.7116564
17/03/2016 11:32,2015,40,WEST AFRICA,NIGERIA,1,HEATHROW,ABUJA,133971,133971,0,141101,141101,0,-5.053117979
17/03/2016 11:32,2015,40,WEST AFRICA,NIGERIA,1,HEATHROW,LAGOS,448473,448473,0,492255,492255,0,-8.894170704
17/03/2016 11:32,2015,40,WEST AFRICA,NIGERIA,1,STANSTED,LAGOS,0,0,0,152,0,152,0
17/03/2016 11:32,2015,40,WEST AFRICA,SENEGAL,1,LUTON,DAKAR,44,0,44,0,0,0,0
17/03/2016 11:32,2015,40,WEST AFRICA,SIERRA LEONE,1,GATWICK,FREETOWN,0,0,0,13102,13102,0,0
17/03/2016 11:32,2015,40,WEST AFRICA,SIERRA LEONE,1,HEATHROW,FREETOWN,0,0,0,22121,22121,0,0
17/03/2016 11:32,2015,45,CENTRAL AFRICA,ANGOLA,1,HEATHROW,LUANDA,29953,29953,0,37417,37417,0,-19.94815191
17/03/2016 11:32,2015,45,CENTRAL AFRICA,CHAD,1,LUTON,NDJAMENA,0,0,0,85,0,85,0
17/03/2016 11:32,2015,50,SOUTHERN AFRICA,REPUBLIC OF SOUTH AFRICA,1,HEATHROW,CAPE TOWN,417649,417649,0,422296,422296,0,-1.10041298
17/03/2016 11:32,2015,50,SOUTHERN AFRICA,REPUBLIC OF SOUTH AFRICA,1,HEATHROW,JOHANNESBURG,938503,938503,0,939725,939725,0,-0.130038043
17/03/2016 11:32,2015,55,MIDDLE EAST,BAHRAIN,1,HEATHROW,BAHRAIN,282835,282835,0,294436,294436,0,-3.940075263
17/03/2016 11:32,2015,55,MIDDLE EAST,BAHRAIN,1,LUTON,BAHRAIN,4,0,4,0,0,0,0
17/03/2016 11:32,2015,55,MIDDLE EAST,IRAN,1,HEATHROW,TEHRAN IMAM KHOMEINI,50397,50397,0,54668,54668,0,-7.812614326
17/03/2016 11:32,2015,55,MIDDLE EAST,IRAQ,1,GATWICK,BAGHDAD (GECA),12760,12760,0,12156,12156,0,4.968739717
17/03/2016 11:32,2015,55,MIDDLE EAST,IRAQ,1,GATWICK,ERBIL INTERNATIONAL,2468,2468,0,207,207,0,1092.270531
17/03/2016 11:32,2015,55,MIDDLE EAST,IRAQ,1,GATWICK,SULAYMANIYAH INT,12082,12082,0,14162,14162,0,-14.68719107
17/03/2016 11:32,2015,55,MIDDLE EAST,IRAQ,2,MANCHESTER,ERBIL INTERNATIONAL,2089,2089,0,0,0,0,0
17/03/2016 11:32,2015,55,MIDDLE EAST,IRAQ,2,MANCHESTER,SULAYMANIYAH INT,5804,5804,0,0,0,0,0
17/03/2016 11:32,2015,55,MIDDLE EAST,KUWAIT,1,HEATHROW,KUWAIT,272975,272975,0,272539,272539,0,0.159977104
17/03/2016 11:32,2015,55,MIDDLE EAST,OMAN,1,GATWICK,MUSCAT,536,0,536,0,0,0,0
17/03/2016 11:32,2015,55,MIDDLE EAST,OMAN,1,HEATHROW,MUSCAT,179275,179275,0,183294,183294,0,-2.192652242
17/03/2016 11:32,2015,55,MIDDLE EAST,OMAN,1,LUTON,MUSCAT,0,0,0,27,0,27,0
17/03/2016 11:32,2015,55,MIDDLE EAST,QATAR,1,HEATHROW,DOHA HAMAD,1072031,1072001,30,895522,895430,92,19.71018021
17/03/2016 11:32,2015,55,MIDDLE EAST,QATAR,1,LUTON,DOHA HAMAD,0,0,0,3,0,3,0
17/03/2016 11:32,2015,55,MIDDLE EAST,QATAR,2,BIRMINGHAM,DOHA HAMAD,208,208,0,0,0,0,0
17/03/2016 11:32,2015,55,MIDDLE EAST,QATAR,2,EDINBURGH,DOHA HAMAD,115529,115529,0,54006,54006,0,113.9188238
17/03/2016 11:32,2015,55,MIDDLE EAST,QATAR,2,LIVERPOOL (JOHN LENNON),DOHA HAMAD,44,0,44,0,0,0,0
17/03/2016 11:32,2015,55,MIDDLE EAST,QATAR,2,MANCHESTER,DOHA HAMAD,293357,293357,0,239380,239380,0,22.54866739
17/03/2016 11:32,2015,55,MIDDLE EAST,SAUDI ARABIA,1,GATWICK,JEDDAH,0,0,0,10109,9690,419,0
17/03/2016 11:32,2015,55,MIDDLE EAST,SAUDI ARABIA,1,GATWICK,MEDINA,0,0,0,419,0,419,0
17/03/2016 11:32,2015,55,MIDDLE EAST,SAUDI ARABIA,1,GATWICK,RIYADH,29,0,29,6050,6050,0,-99.52066116
17/03/2016 11:32,2015,55,MIDDLE EAST,SAUDI ARABIA,1,HEATHROW,JEDDAH,223910,223910,0,240022,240022,0,-6.712718001
17/03/2016 11:32,2015,55,MIDDLE EAST,SAUDI ARABIA,1,HEATHROW,RIYADH,258982,258982,0,268740,268705,35,-3.631018829
17/03/2016 11:32,2015,55,MIDDLE EAST,SAUDI ARABIA,1,LUTON,JEDDAH,35,0,35,12,0,12,191.6666667
17/03/2016 11:32,2015,55,MIDDLE EAST,SAUDI ARABIA,1,LUTON,RIYADH,33,0,33,8,0,8,312.5
17/03/2016 11:32,2015,55,MIDDLE EAST,SAUDI ARABIA,1,LUTON,TABUK,7,0,7,0,0,0,0
17/03/2016 11:32,2015,55,MIDDLE EAST,SAUDI ARABIA,2,MANCHESTER,JEDDAH,77982,77982,0,39614,39614,0,96.85464735
17/03/2016 11:32,2015,55,MIDDLE EAST,UNITED ARAB EMIRATES,1,GATWICK,DUBAI,866101,866101,0,775362,775362,0,11.70279173
17/03/2016 11:32,2015,55,MIDDLE EAST,UNITED ARAB EMIRATES,1,HEATHROW,ABU DHABI INTERNATIONAL,835901,835901,0,642725,642725,0,30.05577813
17/03/2016 11:32,2015,55,MIDDLE EAST,UNITED ARAB EMIRATES,1,HEATHROW,DUBAI,2451738,2451738,0,2437889,2437889,0,0.568073444
17/03/2016 11:32,2015,55,MIDDLE EAST,UNITED ARAB EMIRATES,1,HEATHROW,DUBAI (WORLD CENTRAL),0,0,0,5295,5295,0,0
17/03/2016 11:32,2015,55,MIDDLE EAST,UNITED ARAB EMIRATES,1,LUTON,ABU DHABI - BATEEN,10,0,10,0,0,0,0
17/03/2016 11:32,2015,55,MIDDLE EAST,UNITED ARAB EMIRATES,1,LUTON,DUBAI,0,0,0,45,0,45,0
17/03/2016 11:32,2015,55,MIDDLE EAST,UNITED ARAB EMIRATES,1,SOUTHEND,SHARJAH,8,0,8,0,0,0,0
17/03/2016 11:32,2015,55,MIDDLE EAST,UNITED ARAB EMIRATES,2,BIRMINGHAM,DUBAI,610649,610649,0,527859,527859,0,15.68411261
17/03/2016 11:32,2015,55,MIDDLE EAST,UNITED ARAB EMIRATES,2,BIRMINGHAM,DUBAI (WORLD CENTRAL),1,0,1,0,0,0,0
17/03/2016 11:32,2015,55,MIDDLE EAST,UNITED ARAB EMIRATES,2,CARDIFF WALES,SHARJAH,79,0,79,0,0,0,0
17/03/2016 11:32,2015,55,MIDDLE EAST,UNITED ARAB EMIRATES,2,EDINBURGH,ABU DHABI INTERNATIONAL,72773,72773,0,0,0,0,0
17/03/2016 11:32,2015,55,MIDDLE EAST,UNITED ARAB EMIRATES,2,GLASGOW,DUBAI,429602,429602,0,424561,424561,0,1.187344104
17/03/2016 11:32,2015,55,MIDDLE EAST,UNITED ARAB EMIRATES,2,GLASGOW,SHARJAH,1,0,1,0,0,0,0
17/03/2016 11:32,2015,55,MIDDLE EAST,UNITED ARAB EMIRATES,2,MANCHESTER,ABU DHABI INTERNATIONAL,431673,431364,309,394547,394394,153,9.40977881
17/03/2016 11:32,2015,55,MIDDLE EAST,UNITED ARAB EMIRATES,2,MANCHESTER,DUBAI,861194,861194,0,799630,799630,0,7.699060816
17/03/2016 11:32,2015,55,MIDDLE EAST,UNITED ARAB EMIRATES,2,NEWCASTLE,DUBAI,233489,233489,0,215737,215737,0,8.228537525
17/03/2016 11:32,2015,60,INDIAN SUB-CONTINENT,BANGLADESH,1,HEATHROW,DHAKHA,68105,68105,0,64417,64388,29,5.725196765
17/03/2016 11:32,2015,60,INDIAN SUB-CONTINENT,BANGLADESH,1,HEATHROW,SYLHET,49083,49083,0,39953,39953,0,22.85185092
17/03/2016 11:32,2015,60,INDIAN SUB-CONTINENT,INDIA,1,GATWICK,GOA,42653,8389,34264,39715,0,39715,7.397708674
17/03/2016 11:32,2015,60,INDIAN SUB-CONTINENT,INDIA,1,HEATHROW,AMRITSAR,601,601,0,0,0,0,0
17/03/2016 11:32,2015,60,INDIAN SUB-CONTINENT,INDIA,1,HEATHROW,BANGALORE (BENGALURU),171970,171970,0,180234,180234,0,-4.585150416
17/03/2016 11:32,2015,60,INDIAN SUB-CONTINENT,INDIA,1,HEATHROW,CHENNAI,126878,126878,0,140367,140367,0,-9.609808573
17/03/2016 11:32,2015,60,INDIAN SUB-CONTINENT,INDIA,1,HEATHROW,DELHI,1034172,1034172,0,1067486,1067486,0,-3.120790343
17/03/2016 11:32,2015,60,INDIAN SUB-CONTINENT,INDIA,1,HEATHROW,HYDERABAD ( RAJIV GHANDI ),136114,136114,0,143357,143357,0,-5.052421577
17/03/2016 11:32,2015,60,INDIAN SUB-CONTINENT,INDIA,1,HEATHROW,MUMBAI,949485,949354,131,1048492,1048492,0,-9.442799754
17/03/2016 11:32,2015,60,INDIAN SUB-CONTINENT,INDIA,1,LUTON,DELHI,0,0,0,26,0,26,0
17/03/2016 11:32,2015,60,INDIAN SUB-CONTINENT,INDIA,2,BIRMINGHAM,DELHI,130092,130092,0,79436,79436,0,63.76957551
17/03/2016 11:32,2015,60,INDIAN SUB-CONTINENT,INDIA,2,BIRMINGHAM,MUMBAI,4240,4240,0,0,0,0,0
17/03/2016 11:32,2015,60,INDIAN SUB-CONTINENT,INDIA,2,MANCHESTER,GOA,27257,9230,18027,40856,4303,36553,-33.28519679
17/03/2016 11:32,2015,60,INDIAN SUB-CONTINENT,PAKISTAN,1,GATWICK,ISLAMABAD,1137,0,1137,1056,0,1056,7.670454545
17/03/2016 11:32,2015,60,INDIAN SUB-CONTINENT,PAKISTAN,1,HEATHROW,ISLAMABAD,114875,114875,0,111982,111982,0,2.583450912
17/03/2016 11:32,2015,60,INDIAN SUB-CONTINENT,PAKISTAN,1,HEATHROW,KARACHI,35475,35475,0,40330,40330,0,-12.03818497
17/03/2016 11:32,2015,60,INDIAN SUB-CONTINENT,PAKISTAN,1,HEATHROW,LAHORE,95362,95362,0,86492,86492,0,10.25528373
17/03/2016 11:32,2015,60,INDIAN SUB-CONTINENT,PAKISTAN,1,STANSTED,ISLAMABAD,0,0,0,223,0,223,0
17/03/2016 11:32,2015,60,INDIAN SUB-CONTINENT,PAKISTAN,2,BIRMINGHAM,ISLAMABAD,72160,72160,0,82437,82437,0,-12.46648956
17/03/2016 11:32,2015,60,INDIAN SUB-CONTINENT,PAKISTAN,2,LEEDS BRADFORD,ISLAMABAD,0,0,0,13647,13647,0,0
17/03/2016 11:32,2015,60,INDIAN SUB-CONTINENT,PAKISTAN,2,MANCHESTER,ISLAMABAD,134049,134049,0,120400,120400,0,11.33637874
17/03/2016 11:32,2015,60,INDIAN SUB-CONTINENT,PAKISTAN,2,MANCHESTER,KARACHI,1028,1028,0,1577,1577,0,-34.81293595
17/03/2016 11:32,2015,60,INDIAN SUB-CONTINENT,PAKISTAN,2,MANCHESTER,LAHORE,48913,48913,0,55174,55174,0,-11.34773625
17/03/2016 11:32,2015,60,INDIAN SUB-CONTINENT,SRI LANKA,1,GATWICK,COLOMBO,19126,19126,0,68228,68228,0,-71.96752067
17/03/2016 11:32,2015,60,INDIAN SUB-CONTINENT,SRI LANKA,1,HEATHROW,COLOMBO,203205,203205,0,200890,200890,0,1.152371945
17/03/2016 11:32,2015,65,FAR EAST,BRUNEI,1,HEATHROW,BANDAR SERI BEGAWAN,85594,85594,0,93026,93026,0,-7.98916432
17/03/2016 11:32,2015,65,FAR EAST,CHINA,1,GATWICK,BEIJING,0,0,0,32180,32180,0,0
17/03/2016 11:32,2015,65,FAR EAST,CHINA,1,HEATHROW,BEIJING,448316,448316,0,353676,353676,0,26.75895452
17/03/2016 11:32,2015,65,FAR EAST,CHINA,1,HEATHROW,CHENGDU,56649,56649,0,44639,44639,0,26.90472457
17/03/2016 11:32,2015,65,FAR EAST,CHINA,1,HEATHROW,GUANGZHOU BAIYUN INTERNATIONAL,136498,136498,0,125940,125940,0,8.383357154
17/03/2016 11:32,2015,65,FAR EAST,CHINA,1,HEATHROW,SHANGHAI (PU DONG),431072,431072,0,415786,415786,0,3.676410461
17/03/2016 11:32,2015,65,FAR EAST,CHINA,1,LUTON,URUMQI,0,0,0,23,0,23,0
17/03/2016 11:32,2015,65,FAR EAST,CHINA,2,BIRMINGHAM,BEIJING,6715,0,6715,1375,0,1375,388.3636364
17/03/2016 11:32,2015,65,FAR EAST,HONG KONG,1,HEATHROW,HONG KONG (CHEK LAP KOK),1584486,1584486,0,1563714,1563714,0,1.328375905
17/03/2016 11:32,2015,65,FAR EAST,HONG KONG,2,MANCHESTER,HONG KONG (CHEK LAP KOK),124172,124172,0,7570,7570,0,1540.317041
17/03/2016 11:32,2015,65,FAR EAST,INDONESIA,1,GATWICK,JAKARTA (SOEKARNO-HATTA INTNL),72838,72838,0,29471,29471,0,147.151437
17/03/2016 11:32,2015,65,FAR EAST,JAPAN,1,GATWICK,OSAKA (KANSAI),0,0,0,198,0,198,0
17/03/2016 11:32,2015,65,FAR EAST,JAPAN,1,HEATHROW,TOKYO (HANEDA),429905,429905,0,319827,319827,0,34.41798222
17/03/2016 11:32,2015,65,FAR EAST,JAPAN,1,HEATHROW,TOKYO (NARITA),181423,181423,0,402937,402937,0,-54.97484718
17/03/2016 11:32,2015,65,FAR EAST,JAPAN,2,EDINBURGH,OSAKA (KANSAI),0,0,0,198,0,198,0
17/03/2016 11:32,2015,65,FAR EAST,JAPAN,2,NEWCASTLE,TOKYO (NARITA),0,0,0,2,2,0,0
17/03/2016 11:32,2015,65,FAR EAST,MALAYSIA,1,HEATHROW,KUALA LUMPUR (SEPANG),606746,606746,0,573642,573642,0,5.770846626
17/03/2016 11:32,2015,65,FAR EAST,MALAYSIA,2,LIVERPOOL (JOHN LENNON),KUALA LUMPUR (SEPANG),108,0,108,0,0,0,0
17/03/2016 11:32,2015,65,FAR EAST,PHILIPPINES,1,HEATHROW,MANILA,85392,85392,0,97267,97267,0,-12.20866275
17/03/2016 11:32,2015,65,FAR EAST,REPUBLIC OF KOREA,1,HEATHROW,SEOUL (INCHEON),456557,456557,0,438679,438679,0,4.075417332
17/03/2016 11:32,2015,65,FAR EAST,SINGAPORE,1,HEATHROW,SINGAPORE,1150240,1150240,0,1125125,1125125,0,2.232196423
17/03/2016 11:32,2015,65,FAR EAST,SINGAPORE,2,MANCHESTER,SINGAPORE,108950,108950,0,102962,102962,0,5.815737845
17/03/2016 11:32,2015,65,FAR EAST,TAIWAN,1,HEATHROW,TAIPEI,123578,123578,0,118692,118692,0,4.116536919
17/03/2016 11:32,2015,65,FAR EAST,THAILAND,1,GATWICK,PHUKET,12928,0,12928,13189,0,13189,-1.978921829
17/03/2016 11:32,2015,65,FAR EAST,THAILAND,1,HEATHROW,BANGKOK SUVARNABHUMI ,599558,599558,0,568774,568774,0,5.41234304
17/03/2016 11:32,2015,65,FAR EAST,THAILAND,2,MANCHESTER,BANGKOK (DON MUANG),95,0,95,0,0,0,0
17/03/2016 11:32,2015,65,FAR EAST,VIETNAM,1,GATWICK,HANOI,11857,11857,0,45781,45781,0,-74.10060942
17/03/2016 11:32,2015,65,FAR EAST,VIETNAM,1,GATWICK,HO CHI MINH CITY,11894,11894,0,46413,46413,0,-74.37355913
17/03/2016 11:32,2015,65,FAR EAST,VIETNAM,1,HEATHROW,HANOI,46106,46106,0,0,0,0,0
17/03/2016 11:32,2015,65,FAR EAST,VIETNAM,1,HEATHROW,HO CHI MINH CITY,36852,36852,0,0,0,0,0
17/03/2016 11:32,2015,70,AUSTRALASIA,AUSTRALIA,1,HEATHROW,MELBOURNE,139556,139224,332,141842,141205,637,-1.611652402
17/03/2016 11:32,2015,70,AUSTRALASIA,AUSTRALIA,1,HEATHROW,SYDNEY,304131,302799,1332,346121,345485,636,-12.1315956
17/03/2016 11:32,2015,70,AUSTRALASIA,NEW ZEALAND,1,HEATHROW,AUCKLAND INTERNATIONAL,125887,125887,0,126413,126413,0,-0.416096446
17/03/2016 11:32,2015,75,CANADA,CANADA,1,GATWICK,CALGARY,34589,34589,0,50183,50183,0,-31.07426818
17/03/2016 11:32,2015,75,CANADA,CANADA,1,GATWICK,EDMONTON,0,0,0,5010,5010,0,0
17/03/2016 11:32,2015,75,CANADA,CANADA,1,GATWICK,HALIFAX INT,5688,5688,0,6189,6189,0,-8.095007271
17/03/2016 11:32,2015,75,CANADA,CANADA,1,GATWICK,MONTREAL (DORVAL),18495,18425,70,12156,12156,0,52.14708786
17/03/2016 11:32,2015,75,CANADA,CANADA,1,GATWICK,OTTAWA INTERNATIONAL,0,0,0,5263,5263,0,0
17/03/2016 11:32,2015,75,CANADA,CANADA,1,GATWICK,TORONTO,197014,197014,0,185017,185000,17,6.484269013
17/03/2016 11:32,2015,75,CANADA,CANADA,1,GATWICK,VANCOUVER,102678,102678,0,91453,91453,0,12.27406427
17/03/2016 11:32,2015,75,CANADA,CANADA,1,HEATHROW,CALGARY,304623,304623,0,280605,280605,0,8.559362805
17/03/2016 11:32,2015,75,CANADA,CANADA,1,HEATHROW,EDMONTON,39754,39754,0,69410,69410,0,-42.72583201
17/03/2016 11:32,2015,75,CANADA,CANADA,1,HEATHROW,HALIFAX INT,84120,84120,0,86320,86320,0,-2.548656163
17/03/2016 11:32,2015,75,CANADA,CANADA,1,HEATHROW,MONTREAL (DORVAL),317390,317390,0,342437,342437,0,-7.314338112
17/03/2016 11:32,2015,75,CANADA,CANADA,1,HEATHROW,OTTAWA INTERNATIONAL,112635,112635,0,107783,107783,0,4.50163755
17/03/2016 11:32,2015,75,CANADA,CANADA,1,HEATHROW,ST JOHNS,41995,41995,0,34514,34514,0,21.67526221
17/03/2016 11:32,2015,75,CANADA,CANADA,1,HEATHROW,TORONTO,1032206,1032206,0,1036608,1036608,0,-0.424654257
17/03/2016 11:32,2015,75,CANADA,CANADA,1,HEATHROW,VANCOUVER,550641,550641,0,570590,570590,0,-3.496205682
17/03/2016 11:32,2015,75,CANADA,CANADA,2,BELFAST INTERNATIONAL,TORONTO,221,0,221,0,0,0,0
17/03/2016 11:32,2015,75,CANADA,CANADA,2,BIRMINGHAM,TORONTO,12024,12024,0,11761,11761,0,2.236204404
17/03/2016 11:32,2015,75,CANADA,CANADA,2,CARDIFF WALES,ST JOHNS,0,0,0,52,0,52,0
17/03/2016 11:32,2015,75,CANADA,CANADA,2,EDINBURGH,GANDER,176,0,176,0,0,0,0
17/03/2016 11:32,2015,75,CANADA,CANADA,2,EDINBURGH,TORONTO,32316,32219,97,29808,29808,0,8.413848631
17/03/2016 11:32,2015,75,CANADA,CANADA,2,GLASGOW,CALGARY,4055,4055,0,4138,4138,0,-2.005799903
17/03/2016 11:32,2015,75,CANADA,CANADA,2,GLASGOW,HALIFAX INT,0,0,0,655,0,655,0
17/03/2016 11:32,2015,75,CANADA,CANADA,2,GLASGOW,TORONTO,96959,96959,0,62801,62801,0,54.39085365
17/03/2016 11:32,2015,75,CANADA,CANADA,2,GLASGOW,VANCOUVER,14931,14931,0,14943,14943,0,-0.08030516
17/03/2016 11:32,2015,75,CANADA,CANADA,2,MANCHESTER,CALGARY,20047,20047,0,19825,19595,230,1.119798235
17/03/2016 11:32,2015,75,CANADA,CANADA,2,MANCHESTER,MONTREAL (DORVAL),0,0,0,79,0,79,0
17/03/2016 11:32,2015,75,CANADA,CANADA,2,MANCHESTER,TORONTO,103453,103369,84,106303,106303,0,-2.681015588
17/03/2016 11:32,2015,75,CANADA,CANADA,2,MANCHESTER,VANCOUVER,28206,28206,0,29228,29228,0,-3.496647051
17/03/2016 11:32,2015,75,CANADA,CANADA,2,NEWCASTLE,CALGARY,0,0,0,168,0,168,0
17/03/2016 11:32,2015,75,CANADA,CANADA,2,NEWCASTLE,GOOSE BAY,0,0,0,123,0,123,0
17/03/2016 11:32,2015,80,UNITED STATES OF AMERICA,USA,1,GATWICK,ATLANTA,0,0,0,368,0,368,0
17/03/2016 11:32,2015,80,UNITED STATES OF AMERICA,USA,1,GATWICK,BALTIMORE,0,0,0,139,0,139,0
17/03/2016 11:32,2015,80,UNITED STATES OF AMERICA,USA,1,GATWICK,BOSTON,0,0,0,161,0,161,0
17/03/2016 11:32,2015,80,UNITED STATES OF AMERICA,USA,1,GATWICK,BUFFALO,382,0,382,0,0,0,0
17/03/2016 11:32,2015,80,UNITED STATES OF AMERICA,USA,1,GATWICK,CINCINNATI,0,0,0,197,0,197,0
17/03/2016 11:32,2015,80,UNITED STATES OF AMERICA,USA,1,GATWICK,DALLAS/FORT WORTH,0,0,0,400,0,400,0
17/03/2016 11:32,2015,80,UNITED STATES OF AMERICA,USA,1,GATWICK,DETROIT,0,0,0,582,0,582,0
17/03/2016 11:32,2015,80,UNITED STATES OF AMERICA,USA,1,GATWICK,FORT LAUDERDALE,40848,40848,0,27932,27593,339,46.24087069
17/03/2016 11:32,2015,80,UNITED STATES OF AMERICA,USA,1,GATWICK,JACKSONVILLE,0,0,0,216,0,216,0
17/03/2016 11:32,2015,80,UNITED STATES OF AMERICA,USA,1,GATWICK,LAS VEGAS,309622,309622,0,317843,317843,0,-2.586497107
17/03/2016 11:32,2015,80,UNITED STATES OF AMERICA,USA,1,GATWICK,LOS ANGELES INTERNATIONAL,88490,88391,99,28187,28187,0,213.9390499
17/03/2016 11:32,2015,80,UNITED STATES OF AMERICA,USA,1,GATWICK,NEW YORK (JF KENNEDY),147879,147879,0,42313,42313,0,249.4883369
17/03/2016 11:32,2015,80,UNITED STATES OF AMERICA,USA,1,GATWICK,OAKLAND,0,0,0,213,0,213,0
17/03/2016 11:32,2015,80,UNITED STATES OF AMERICA,USA,1,GATWICK,ORLANDO,737221,737221,0,705046,705046,0,4.563532025
17/03/2016 11:32,2015,80,UNITED STATES OF AMERICA,USA,1,GATWICK,SANFORD,49491,0,49491,64030,0,64030,-22.70654381
17/03/2016 11:32,2015,80,UNITED STATES OF AMERICA,USA,1,GATWICK,TAMPA,158156,158156,0,149961,149961,0,5.464754169
17/03/2016 11:32,2015,80,UNITED STATES OF AMERICA,USA,1,GATWICK,WASHINGTON (DULLES),81,0,81,0,0,0,0
17/03/2016 11:32,2015,80,UNITED STATES OF AMERICA,USA,1,HEATHROW,ATLANTA,611883,611883,0,563480,563098,382,8.590012068
17/03/2016 11:32,2015,80,UNITED STATES OF AMERICA,USA,1,HEATHROW,AUSTIN (BERGSTROM),124495,124495,0,97539,97539,0,27.63612504
17/03/2016 11:32,2015,80,UNITED STATES OF AMERICA,USA,1,HEATHROW,BALTIMORE,113531,113531,0,112870,112870,0,0.585629485
17/03/2016 11:32,2015,80,UNITED STATES OF AMERICA,USA,1,HEATHROW,BOSTON,858358,858358,0,891078,891078,0,-3.671956888
17/03/2016 11:32,2015,80,UNITED STATES OF AMERICA,USA,1,HEATHROW,BUFFALO,361,0,361,0,0,0,0
17/03/2016 11:32,2015,80,UNITED STATES OF AMERICA,USA,1,HEATHROW,CHARLOTTE,292938,292938,0,191089,191089,0,53.29924799
17/03/2016 11:32,2015,80,UNITED STATES OF AMERICA,USA,1,HEATHROW,CHICAGO (O'HARE),1059686,1059686,0,1160217,1160217,0,-8.664844594
17/03/2016 11:32,2015,80,UNITED STATES OF AMERICA,USA,1,HEATHROW,COLUMBUS RICKENBACKER AFB,529,0,529,0,0,0,0
17/03/2016 11:32,2015,80,UNITED STATES OF AMERICA,USA,1,HEATHROW,DALLAS/FORT WORTH,637977,637977,0,658449,658449,0,-3.109124625
17/03/2016 11:32,2015,80,UNITED STATES OF AMERICA,USA,1,HEATHROW,DENVER INTERNATIONAL,187639,187639,0,160342,160342,0,17.0242357
17/03/2016 11:32,2015,80,UNITED STATES OF AMERICA,USA,1,HEATHROW,DETROIT,191483,191189,294,185840,185840,0,3.036482996
17/03/2016 11:32,2015,80,UNITED STATES OF AMERICA,USA,1,HEATHROW,FORT LAUDERDALE,179,0,179,0,0,0,0
17/03/2016 11:32,2015,80,UNITED STATES OF AMERICA,USA,1,HEATHROW,HOUSTON,564300,564300,0,594417,594417,0,-5.066645133
17/03/2016 11:32,2015,80,UNITED STATES OF AMERICA,USA,1,HEATHROW,JACKSONVILLE,404,0,404,0,0,0,0
17/03/2016 11:32,2015,80,UNITED STATES OF AMERICA,USA,1,HEATHROW,KANSAS CITY,403,0,403,0,0,0,0
17/03/2016 11:32,2015,80,UNITED STATES OF AMERICA,USA,1,HEATHROW,LAS VEGAS,231104,231104,0,228236,228236,0,1.256594052
17/03/2016 11:32,2015,80,UNITED STATES OF AMERICA,USA,1,HEATHROW,LOS ANGELES INTERNATIONAL,1518903,1518903,0,1354610,1354610,0,12.12843549
17/03/2016 11:32,2015,80,UNITED STATES OF AMERICA,USA,1,HEATHROW,MIAMI INTERNATIONAL,1030673,1030489,184,1008257,1008257,0,2.223242685
17/03/2016 11:32,2015,80,UNITED STATES OF AMERICA,USA,1,HEATHROW,MINNEAPOLIS-ST PAUL,138063,138063,0,135447,135447,0,1.931382755
17/03/2016 11:32,2015,80,UNITED STATES OF AMERICA,USA,1,HEATHROW,NEW YORK (JF KENNEDY),3050499,3050499,0,2972729,2972729,0,2.616114688
17/03/2016 11:32,2015,80,UNITED STATES OF AMERICA,USA,1,HEATHROW,NEW YORK (NEWARK),999986,999577,409,1168357,1168258,99,-14.41092063
17/03/2016 11:32,2015,80,UNITED STATES OF AMERICA,USA,1,HEATHROW,ORLANDO,653,0,653,656,0,656,-0.457317073
17/03/2016 11:32,2015,80,UNITED STATES OF AMERICA,USA,1,HEATHROW,PHILADELPHIA INTERNATIONAL,468083,468083,0,383400,383400,0,22.08737611
17/03/2016 11:32,2015,80,UNITED STATES OF AMERICA,USA,1,HEATHROW,PHOENIX,216935,216935,0,211304,211304,0,2.66488093
17/03/2016 11:32,2015,80,UNITED STATES OF AMERICA,USA,1,HEATHROW,RALEIGH,115279,115279,0,117996,117996,0,-2.302620428
17/03/2016 11:32,2015,80,UNITED STATES OF AMERICA,USA,1,HEATHROW,SAN DIEGO,177623,177623,0,173431,173431,0,2.417099596
17/03/2016 11:32,2015,80,UNITED STATES OF AMERICA,USA,1,HEATHROW,SAN FRANCISCO,1046981,1046981,0,937643,937643,0,11.66094132
17/03/2016 11:32,2015,80,UNITED STATES OF AMERICA,USA,1,HEATHROW,SEATTLE (TACOMA),349759,349759,0,328307,328307,0,6.534128118
17/03/2016 11:32,2015,80,UNITED STATES OF AMERICA,USA,1,HEATHROW,WASHINGTON (DULLES),866457,866457,0,884649,884649,0,-2.056408813
17/03/2016 11:32,2015,80,UNITED STATES OF AMERICA,USA,1,LONDON CITY,NEW YORK (JF KENNEDY),21375,21375,0,23953,23953,0,-10.76274371
17/03/2016 11:32,2015,80,UNITED STATES OF AMERICA,USA,1,LUTON,BALTIMORE,0,0,0,16,0,16,0
17/03/2016 11:32,2015,80,UNITED STATES OF AMERICA,USA,1,LUTON,BOSTON,6,0,6,0,0,0,0
17/03/2016 11:32,2015,80,UNITED STATES OF AMERICA,USA,1,LUTON,DALLAS,2,0,2,0,0,0,0
17/03/2016 11:32,2015,80,UNITED STATES OF AMERICA,USA,1,LUTON,MILWAUKEE,78,0,78,0,0,0,0
17/03/2016 11:32,2015,80,UNITED STATES OF AMERICA,USA,1,LUTON,NEW YORK (JF KENNEDY),27,0,27,12,0,12,125
17/03/2016 11:32,2015,80,UNITED STATES OF AMERICA,USA,1,LUTON,NEW YORK (NEWARK),12660,12660,0,114,0,114,11005.26316
17/03/2016 11:32,2015,80,UNITED STATES OF AMERICA,USA,1,SOUTHEND,LOS ANGELES INTERNATIONAL,8,0,8,0,0,0,0
17/03/2016 11:32,2015,80,UNITED STATES OF AMERICA,USA,1,STANSTED,LAS VEGAS,3226,3226,0,0,0,0,0
17/03/2016 11:32,2015,80,UNITED STATES OF AMERICA,USA,1,STANSTED,ORLANDO,6340,6340,0,0,0,0,0
17/03/2016 11:32,2015,80,UNITED STATES OF AMERICA,USA,2,BELFAST INTERNATIONAL,CHICAGO (O'HARE),260,0,260,0,0,0,0
17/03/2016 11:32,2015,80,UNITED STATES OF AMERICA,USA,2,BELFAST INTERNATIONAL,DETROIT,0,0,0,118,0,118,0
17/03/2016 11:32,2015,80,UNITED STATES OF AMERICA,USA,2,BELFAST INTERNATIONAL,LAS VEGAS,1118,622,496,0,0,0,0
17/03/2016 11:32,2015,80,UNITED STATES OF AMERICA,USA,2,BELFAST INTERNATIONAL,NEW YORK (JF KENNEDY),553,0,553,0,0,0,0
17/03/2016 11:32,2015,80,UNITED STATES OF AMERICA,USA,2,BELFAST INTERNATIONAL,NEW YORK (NEWARK),69258,69258,0,82958,82958,0,-16.51438077
17/03/2016 11:32,2015,80,UNITED STATES OF AMERICA,USA,2,BELFAST INTERNATIONAL,ORLANDO,5831,2520,3311,1243,1243,0,369.1069992
17/03/2016 11:32,2015,80,UNITED STATES OF AMERICA,USA,2,BIRMINGHAM,NEW YORK (JF KENNEDY),50950,50950,0,0,0,0,0
17/03/2016 11:32,2015,80,UNITED STATES OF AMERICA,USA,2,BIRMINGHAM,NEW YORK (NEWARK),88573,88573,0,94346,94346,0,-6.118966358
17/03/2016 11:32,2015,80,UNITED STATES OF AMERICA,USA,2,BIRMINGHAM,ORLANDO,0,0,0,650,650,0,0
17/03/2016 11:32,2015,80,UNITED STATES OF AMERICA,USA,2,BIRMINGHAM,SANFORD,15550,0,15550,17840,0,17840,-12.83632287
17/03/2016 11:32,2015,80,UNITED STATES OF AMERICA,USA,2,CARDIFF WALES,ORLANDO,555,0,555,632,0,632,-12.1835443
17/03/2016 11:32,2015,80,UNITED STATES OF AMERICA,USA,2,EAST MIDLANDS INTERNATIONAL,NEW YORK (NEWARK),866,866,0,869,869,0,-0.345224396
17/03/2016 11:32,2015,80,UNITED STATES OF AMERICA,USA,2,EAST MIDLANDS INTERNATIONAL,SANFORD,12115,0,12115,11255,0,11255,7.641048423
17/03/2016 11:32,2015,80,UNITED STATES OF AMERICA,USA,2,EDINBURGH,ATLANTA,0,0,0,186,0,186,0
17/03/2016 11:32,2015,80,UNITED STATES OF AMERICA,USA,2,EDINBURGH,CHICAGO (O'HARE),33479,33479,0,30905,30905,0,8.328749393
17/03/2016 11:32,2015,80,UNITED STATES OF AMERICA,USA,2,EDINBURGH,LAS VEGAS,0,0,0,485,0,485,0
17/03/2016 11:32,2015,80,UNITED STATES OF AMERICA,USA,2,EDINBURGH,MOLINE (QUAD CITY),98,0,98,0,0,0,0
17/03/2016 11:32,2015,80,UNITED STATES OF AMERICA,USA,2,EDINBURGH,NEW YORK (JF KENNEDY),45471,45471,0,0,0,0,0
17/03/2016 11:32,2015,80,UNITED STATES OF AMERICA,USA,2,EDINBURGH,NEW YORK (NEWARK),143414,143414,0,142526,142526,0,0.623044216
17/03/2016 11:32,2015,80,UNITED STATES OF AMERICA,USA,2,EDINBURGH,PHILADELPHIA INTERNATIONAL,0,0,0,33733,33733,0,0
17/03/2016 11:32,2015,80,UNITED STATES OF AMERICA,USA,2,EDINBURGH,SANFORD,2331,0,2331,2113,0,2113,10.31708471
17/03/2016 11:32,2015,80,UNITED STATES OF AMERICA,USA,2,GLASGOW,LAS VEGAS,19370,19370,0,307,0,307,6209.446254
17/03/2016 11:32,2015,80,UNITED STATES OF AMERICA,USA,2,GLASGOW,MINOT INTERNATIONAL,1,0,1,0,0,0,0
17/03/2016 11:32,2015,80,UNITED STATES OF AMERICA,USA,2,GLASGOW,NEW YORK (NEWARK),105588,105582,6,103877,103877,0,1.647140368
17/03/2016 11:32,2015,80,UNITED STATES OF AMERICA,USA,2,GLASGOW,ORLANDO,80669,80412,257,72405,72405,0,11.41357641
17/03/2016 11:32,2015,80,UNITED STATES OF AMERICA,USA,2,GLASGOW,PHILADELPHIA INTERNATIONAL,42696,42696,0,43597,43597,0,-2.066655963
17/03/2016 11:32,2015,80,UNITED STATES OF AMERICA,USA,2,GLASGOW,SANFORD,16008,0,16008,16478,0,16478,-2.852287899
17/03/2016 11:32,2015,80,UNITED STATES OF AMERICA,USA,2,LEEDS BRADFORD,NEW YORK (NEWARK),2195,2195,0,2220,2220,0,-1.126126126
17/03/2016 11:32,2015,80,UNITED STATES OF AMERICA,USA,2,LEEDS BRADFORD,SANFORD,0,0,0,229,0,229,0
17/03/2016 11:32,2015,80,UNITED STATES OF AMERICA,USA,2,MANCHESTER,ATLANTA,140600,140600,0,121834,121834,0,15.40292529
17/03/2016 11:32,2015,80,UNITED STATES OF AMERICA,USA,2,MANCHESTER,CHARLOTTE,0,0,0,27880,27880,0,0
17/03/2016 11:32,2015,80,UNITED STATES OF AMERICA,USA,2,MANCHESTER,CHICAGO (O'HARE),82222,82222,0,106797,106797,0,-23.010946
17/03/2016 11:32,2015,80,UNITED STATES OF AMERICA,USA,2,MANCHESTER,KANSAS CITY,0,0,0,75,0,75,0
17/03/2016 11:32,2015,80,UNITED STATES OF AMERICA,USA,2,MANCHESTER,LAS VEGAS,113577,113577,0,97983,97983,0,15.91500566
17/03/2016 11:32,2015,80,UNITED STATES OF AMERICA,USA,2,MANCHESTER,LOS ANGELES INTERNATIONAL,0,0,0,125,0,125,0
17/03/2016 11:32,2015,80,UNITED STATES OF AMERICA,USA,2,MANCHESTER,MIAMI INTERNATIONAL,36594,36594,0,119,0,119,30651.2605
17/03/2016 11:32,2015,80,UNITED STATES OF AMERICA,USA,2,MANCHESTER,MOLINE (QUAD CITY),0,0,0,86,0,86,0
17/03/2016 11:32,2015,80,UNITED STATES OF AMERICA,USA,2,MANCHESTER,NEW YORK (JF KENNEDY),232786,232786,0,112996,112996,0,106.0126022
17/03/2016 11:32,2015,80,UNITED STATES OF AMERICA,USA,2,MANCHESTER,NEW YORK (LA GUARDIA),88,0,88,0,0,0,0
17/03/2016 11:32,2015,80,UNITED STATES OF AMERICA,USA,2,MANCHESTER,NEW YORK (NEWARK),111439,111439,0,114317,114317,0,-2.517560818
17/03/2016 11:32,2015,80,UNITED STATES OF AMERICA,USA,2,MANCHESTER,ORLANDO,450575,450575,0,426879,426241,638,5.550987516
17/03/2016 11:32,2015,80,UNITED STATES OF AMERICA,USA,2,MANCHESTER,PHILADELPHIA INTERNATIONAL,129865,129865,0,145579,145579,0,-10.79413926
17/03/2016 11:32,2015,80,UNITED STATES OF AMERICA,USA,2,MANCHESTER,SANFORD,53213,0,53213,79275,0,79275,-32.87543362
17/03/2016 11:32,2015,80,UNITED STATES OF AMERICA,USA,2,MANCHESTER,SEATTLE (TACOMA),111,0,111,0,0,0,0
17/03/2016 11:32,2015,80,UNITED STATES OF AMERICA,USA,2,MANCHESTER,WASHINGTON (DULLES),64432,64432,0,76486,76486,0,-15.75974688
17/03/2016 11:32,2015,80,UNITED STATES OF AMERICA,USA,2,NEWCASTLE,NEW YORK (JF KENNEDY),0,0,0,155,0,155,0
17/03/2016 11:32,2015,80,UNITED STATES OF AMERICA,USA,2,NEWCASTLE,NEW YORK (NEWARK),17044,17044,0,2159,2159,0,689.4395553
17/03/2016 11:32,2015,80,UNITED STATES OF AMERICA,USA,2,NEWCASTLE,SANFORD,17126,0,17126,15660,0,15660,9.361430396
17/03/2016 11:32,2015,80,UNITED STATES OF AMERICA,USA,2,PRESTWICK,NEW YORK (JF KENNEDY),0,0,0,200,0,200,0
17/03/2016 11:32,2015,85,CENTRAL AMERICA,BELIZE,2,CARDIFF WALES,BELIZE CITY,0,0,0,168,0,168,0
17/03/2016 11:32,2015,85,CENTRAL AMERICA,COSTA RICA,1,GATWICK,LIBERIA,4454,0,4454,0,0,0,0
17/03/2016 11:32,2015,85,CENTRAL AMERICA,CUBA,1,GATWICK,CUNAGUA (CAYO COCO),0,0,0,4817,0,4817,0
17/03/2016 11:32,2015,85,CENTRAL AMERICA,CUBA,1,GATWICK,HAVANA,85995,85995,0,80261,80261,0,7.144192073
17/03/2016 11:32,2015,85,CENTRAL AMERICA,CUBA,1,GATWICK,HOLGUIN (FRANK PAIS),32605,5188,27417,38802,0,38802,-15.97082625
17/03/2016 11:32,2015,85,CENTRAL AMERICA,CUBA,2,GLASGOW,CUNAGUA (CAYO COCO),637,0,637,630,0,630,1.111111111
17/03/2016 11:32,2015,85,CENTRAL AMERICA,CUBA,2,GLASGOW,HOLGUIN (FRANK PAIS),223,223,0,0,0,0,0
17/03/2016 11:32,2015,85,CENTRAL AMERICA,CUBA,2,MANCHESTER,CUNAGUA (CAYO COCO),32385,3052,29333,31744,0,31744,2.019279234
17/03/2016 11:32,2015,85,CENTRAL AMERICA,CUBA,2,MANCHESTER,HOLGUIN (FRANK PAIS),47838,0,47838,36110,0,36110,32.4785378
17/03/2016 11:32,2015,85,CENTRAL AMERICA,CUBA,2,MANCHESTER,VARADERO,32378,2360,30018,21262,0,21262,52.28106481
17/03/2016 11:32,2015,85,CENTRAL AMERICA,DOMINICAN REPUBLIC,1,GATWICK,PUERTO PLATA,30733,0,30733,28987,0,28987,6.023389795
17/03/2016 11:32,2015,85,CENTRAL AMERICA,DOMINICAN REPUBLIC,1,GATWICK,PUNTA CANA,139339,53046,86293,143972,70577,73395,-3.217986831
17/03/2016 11:32,2015,85,CENTRAL AMERICA,DOMINICAN REPUBLIC,2,GLASGOW,PUNTA CANA,0,0,0,6070,0,6070,0
17/03/2016 11:32,2015,85,CENTRAL AMERICA,DOMINICAN REPUBLIC,2,MANCHESTER,PUERTO PLATA,29496,0,29496,28665,0,28665,2.899005756
17/03/2016 11:32,2015,85,CENTRAL AMERICA,DOMINICAN REPUBLIC,2,MANCHESTER,PUNTA CANA,79181,0,79181,63634,0,63634,24.43190747
17/03/2016 11:32,2015,85,CENTRAL AMERICA,MEXICO,1,GATWICK,CANCUN,400189,247006,153183,388195,242197,145998,3.089684308
17/03/2016 11:32,2015,85,CENTRAL AMERICA,MEXICO,1,GATWICK,PUERTO VALLARTA,29385,0,29385,19172,0,19172,53.27039433
17/03/2016 11:32,2015,85,CENTRAL AMERICA,MEXICO,1,HEATHROW,MEXICO CITY,232998,232998,0,190328,190328,0,22.41919213
17/03/2016 11:32,2015,85,CENTRAL AMERICA,MEXICO,1,STANSTED,CANCUN,3213,3213,0,292,0,292,1000.342466
17/03/2016 11:32,2015,85,CENTRAL AMERICA,MEXICO,2,BIRMINGHAM,CANCUN,49210,0,49210,27323,0,27323,80.10467372
17/03/2016 11:32,2015,85,CENTRAL AMERICA,MEXICO,2,EAST MIDLANDS INTERNATIONAL,CANCUN,12196,0,12196,10896,0,10896,11.93098385
17/03/2016 11:32,2015,85,CENTRAL AMERICA,MEXICO,2,EDINBURGH,CANCUN,2331,0,2331,2121,0,2121,9.900990099
17/03/2016 11:32,2015,85,CENTRAL AMERICA,MEXICO,2,GLASGOW,CANCUN,34767,19115,15652,27089,13135,13954,28.34360811
17/03/2016 11:32,2015,85,CENTRAL AMERICA,MEXICO,2,MANCHESTER,CANCUN,215852,78821,137031,227008,96960,130048,-4.914364251
17/03/2016 11:32,2015,85,CENTRAL AMERICA,MEXICO,2,MANCHESTER,PUERTO VALLARTA,28104,0,28104,18422,0,18422,52.55672565
17/03/2016 11:32,2015,85,CENTRAL AMERICA,MEXICO,2,NEWCASTLE,CANCUN,17327,0,17327,16173,0,16173,7.135349039
17/03/2016 11:32,2015,90,SOUTH AMERICA,ARGENTINA,1,HEATHROW,BUENOS AIRES,151603,151190,413,173549,173549,0,-12.64542003
17/03/2016 11:32,2015,90,SOUTH AMERICA,BRAZIL,1,GATWICK,BELO HORIZONTE,0,0,0,229,0,229,0
17/03/2016 11:32,2015,90,SOUTH AMERICA,BRAZIL,1,GATWICK,MANAUS-EDUARDO GOMES,0,0,0,660,0,660,0
17/03/2016 11:32,2015,90,SOUTH AMERICA,BRAZIL,1,HEATHROW,RIO DE JANEIRO (GALEAO),166647,166647,0,188737,188737,0,-11.70411737
17/03/2016 11:32,2015,90,SOUTH AMERICA,BRAZIL,1,HEATHROW,SAO PAULO (GUARULHOS),462775,462775,0,435757,435757,0,6.200244632
17/03/2016 11:32,2015,90,SOUTH AMERICA,BRAZIL,1,LUTON,RIO DE JANEIRO (GALEAO),0,0,0,47,0,47,0
17/03/2016 11:32,2015,90,SOUTH AMERICA,CHILE,1,GATWICK,SANTIAGO DE CHILE,0,0,0,359,0,359,0
17/03/2016 11:32,2015,90,SOUTH AMERICA,COLOMBIA,1,HEATHROW,BOGOTA,109427,109427,0,41685,41685,0,162.5092959
17/03/2016 11:32,2015,90,SOUTH AMERICA,VENEZUELA,1,HEATHROW,CARACAS,235,0,235,0,0,0,0
17/03/2016 11:32,2015,95,CARIBBEAN AREA,ANTIGUA AND BARBUDA,1,GATWICK,ANTIGUA,108406,108406,0,95045,95045,0,14.05755169
17/03/2016 11:32,2015,95,CARIBBEAN AREA,ANTIGUA AND BARBUDA,2,MANCHESTER,ANTIGUA,2002,2002,0,0,0,0,0
17/03/2016 11:32,2015,95,CARIBBEAN AREA,BAHAMAS,1,HEATHROW,NASSAU,52503,52503,0,44063,44063,0,19.15439257
17/03/2016 11:32,2015,95,CARIBBEAN AREA,BARBADOS,1,GATWICK,BRIDGETOWN,433135,373150,59985,410342,361829,48513,5.554634914
17/03/2016 11:32,2015,95,CARIBBEAN AREA,BARBADOS,1,LUTON,BRIDGETOWN,38,0,38,0,0,0,0
17/03/2016 11:32,2015,95,CARIBBEAN AREA,BARBADOS,1,STANSTED,BRIDGETOWN,188,0,188,0,0,0,0
17/03/2016 11:32,2015,95,CARIBBEAN AREA,BARBADOS,2,BIRMINGHAM,BRIDGETOWN,34583,0,34583,31478,0,31478,9.864032022
17/03/2016 11:32,2015,95,CARIBBEAN AREA,BARBADOS,2,BOURNEMOUTH,BRIDGETOWN,509,0,509,249,0,249,104.4176707
17/03/2016 11:32,2015,95,CARIBBEAN AREA,BARBADOS,2,BRISTOL,BRIDGETOWN,0,0,0,504,0,504,0
17/03/2016 11:32,2015,95,CARIBBEAN AREA,BARBADOS,2,CARDIFF WALES,BRIDGETOWN,1643,0,1643,2047,0,2047,-19.73619932
17/03/2016 11:32,2015,95,CARIBBEAN AREA,BARBADOS,2,DONCASTER SHEFFIELD,BRIDGETOWN,0,0,0,390,0,390,0
17/03/2016 11:32,2015,95,CARIBBEAN AREA,BARBADOS,2,EAST MIDLANDS INTERNATIONAL,BRIDGETOWN,824,0,824,1161,0,1161,-29.02670112
17/03/2016 11:32,2015,95,CARIBBEAN AREA,BARBADOS,2,EXETER,BRIDGETOWN,0,0,0,512,0,512,0
17/03/2016 11:32,2015,95,CARIBBEAN AREA,BARBADOS,2,GLASGOW,BRIDGETOWN,7282,3637,3645,6410,0,6410,13.60374415
17/03/2016 11:32,2015,95,CARIBBEAN AREA,BARBADOS,2,MANCHESTER,BRIDGETOWN,140426,72165,68261,137643,69334,68309,2.021897227
17/03/2016 11:32,2015,95,CARIBBEAN AREA,BARBADOS,2,NEWCASTLE,BRIDGETOWN,1654,0,1654,2654,0,2654,-37.67897513
17/03/2016 11:32,2015,95,CARIBBEAN AREA,BERMUDA,1,GATWICK,BERMUDA,92674,92674,0,90418,90418,0,2.495078414
17/03/2016 11:32,2015,95,CARIBBEAN AREA,CAYMAN ISLANDS,1,HEATHROW,GRAND CAYMAN,31576,31576,0,34348,34348,0,-8.070338884
17/03/2016 11:32,2015,95,CARIBBEAN AREA,GRENADA,1,GATWICK,GRENADA,98985,98985,0,87297,87297,0,13.38877625
17/03/2016 11:32,2015,95,CARIBBEAN AREA,ISLE OF CURACAO NETH.ANTILLES,1,GATWICK,ARUBA,16282,0,16282,13434,0,13434,21.19994045
17/03/2016 11:32,2015,95,CARIBBEAN AREA,JAMAICA,1,GATWICK,KINGSTON,86131,86131,0,86327,86267,60,-0.227043683
17/03/2016 11:32,2015,95,CARIBBEAN AREA,JAMAICA,1,GATWICK,MONTEGO BAY,206334,115514,90820,175576,114986,60590,17.51833964
17/03/2016 11:32,2015,95,CARIBBEAN AREA,JAMAICA,2,BIRMINGHAM,MONTEGO BAY,39266,0,39266,22204,0,22204,76.84201045
17/03/2016 11:32,2015,95,CARIBBEAN AREA,JAMAICA,2,CARDIFF WALES,MONTEGO BAY,1026,0,1026,0,0,0,0
17/03/2016 11:32,2015,95,CARIBBEAN AREA,JAMAICA,2,DONCASTER SHEFFIELD,MONTEGO BAY,435,0,435,0,0,0,0
17/03/2016 11:32,2015,95,CARIBBEAN AREA,JAMAICA,2,EAST MIDLANDS INTERNATIONAL,MONTEGO BAY,922,0,922,0,0,0,0
17/03/2016 11:32,2015,95,CARIBBEAN AREA,JAMAICA,2,GLASGOW,MONTEGO BAY,1323,0,1323,242,0,242,446.6942149
17/03/2016 11:32,2015,95,CARIBBEAN AREA,JAMAICA,2,MANCHESTER,MONTEGO BAY,81296,20840,60456,64833,21104,43729,25.39293261
17/03/2016 11:32,2015,95,CARIBBEAN AREA,JAMAICA,2,NEWCASTLE,MONTEGO BAY,2295,0,2295,0,0,0,0
17/03/2016 11:32,2015,95,CARIBBEAN AREA,PUERTO RICO,1,GATWICK,SAN JUAN (PUERTO RICO),8181,8181,0,574,0,574,1325.261324
17/03/2016 11:32,2015,95,CARIBBEAN AREA,SAINT KITTS AND NEVIS,1,GATWICK,ST KITTS,52310,52310,0,44254,44254,0,18.20400416
17/03/2016 11:32,2015,95,CARIBBEAN AREA,SAINT KITTS AND NEVIS,1,STANSTED,ST KITTS,353,0,353,0,0,0,0
17/03/2016 11:32,2015,95,CARIBBEAN AREA,ST LUCIA,1,GATWICK,ST LUCIA (HEWANORRA),18302,18302,0,31207,31207,0,-41.35290159
17/03/2016 11:32,2015,95,CARIBBEAN AREA,ST LUCIA,2,MANCHESTER,ST LUCIA (HEWANORRA),3219,3219,0,11124,11124,0,-71.06256742
17/03/2016 11:32,2015,95,CARIBBEAN AREA,TRINIDAD AND TOBAGO,1,GATWICK,PORT OF SPAIN,178170,178170,0,154409,154409,0,15.38835172
17/03/2016 11:32,2015,95,CARIBBEAN AREA,TRINIDAD AND TOBAGO,1,GATWICK,TOBAGO,81558,70539,11019,66689,40978,25711,22.29603083
17/03/2016 11:32,2015,95,CARIBBEAN AREA,TURKS AND CAICOS ISLANDS,1,GATWICK,PROVIDENCIALES,22645,22645,0,0,0,0,0
17/03/2016 11:32,2015,95,CARIBBEAN AREA,TURKS AND CAICOS ISLANDS,1,HEATHROW,PROVIDENCIALES,1567,1567,0,7898,7898,0,-80.15953406
17/03/2016 11:32,2015,95,CARIBBEAN AREA,VIRGIN ISLANDS (U.S.A),2,LIVERPOOL (JOHN LENNON),ST THOMAS ISLANDS,56,0,56,0,0,0,0
17/03/2016 11:32,2015,100,INDIAN OCEAN ISLANDS,MALDIVE ISLANDS,1,GATWICK,MALE INTERNATIONAL,10178,10178,0,9133,0,9133,11.44202343
17/03/2016 11:32,2015,100,INDIAN OCEAN ISLANDS,MAURITIUS,1,GATWICK,MAURITIUS,109018,108782,236,96657,96436,221,12.78852023
17/03/2016 11:32,2015,100,INDIAN OCEAN ISLANDS,MAURITIUS,1,HEATHROW,MAURITIUS,81497,81497,0,83420,83420,0,-2.305202589
17/03/2016 11:32,2015,100,INDIAN OCEAN ISLANDS,MAURITIUS,1,STANSTED,MAURITIUS,214,0,214,252,0,252,-15.07936508
17/03/2016 11:32,2015,105,ATLANTIC OCEAN ISLANDS,CAPE VERDE ISLANDS,1,GATWICK,BOA VISTA (RABIL),47141,47141,0,44071,44071,0,6.966032085
17/03/2016 11:32,2015,105,ATLANTIC OCEAN ISLANDS,CAPE VERDE ISLANDS,1,GATWICK,ILHA DO SAL C.VERDE,78621,66974,11647,40186,36800,3386,95.64276116
17/03/2016 11:32,2015,105,ATLANTIC OCEAN ISLANDS,CAPE VERDE ISLANDS,1,GATWICK,SAN PEDRO (CAPE VERDE),191,0,191,0,0,0,0
17/03/2016 11:32,2015,105,ATLANTIC OCEAN ISLANDS,CAPE VERDE ISLANDS,1,LUTON,ILHA DO SAL C.VERDE,0,0,0,61,0,61,0
17/03/2016 11:32,2015,105,ATLANTIC OCEAN ISLANDS,CAPE VERDE ISLANDS,2,BIRMINGHAM,BOA VISTA (RABIL),21002,21002,0,21771,21771,0,-3.532221763
17/03/2016 11:32,2015,105,ATLANTIC OCEAN ISLANDS,CAPE VERDE ISLANDS,2,BIRMINGHAM,ILHA DO SAL C.VERDE,20889,20889,0,10253,10253,0,103.7354921
17/03/2016 11:32,2015,105,ATLANTIC OCEAN ISLANDS,CAPE VERDE ISLANDS,2,BRISTOL,ILHA DO SAL C.VERDE,2976,2976,0,0,0,0,0
17/03/2016 11:32,2015,105,ATLANTIC OCEAN ISLANDS,CAPE VERDE ISLANDS,2,MANCHESTER,BOA VISTA (RABIL),43559,43559,0,43661,43661,0,-0.233618103
17/03/2016 11:32,2015,105,ATLANTIC OCEAN ISLANDS,CAPE VERDE ISLANDS,2,MANCHESTER,ILHA DO SAL C.VERDE,35525,35525,0,25464,25464,0,39.51068175
17/03/2016 11:32,2015,105,ATLANTIC OCEAN ISLANDS,FALKLAND ISLANDS,1,GATWICK,MOUNT PLEASANT,426,0,426,0,0,0,0
17/03/2016 11:32,2015,115,OIL RIGS,OIL RIGS,2,ABERDEEN,OIL RIGS,510962,0,510962,564930,0,564930,-9.55304197
17/03/2016 11:32,2015,115,OIL RIGS,OIL RIGS,2,BLACKPOOL,OIL RIGS,23155,0,23155,19971,0,19971,15.94311752
17/03/2016 11:32,2015,115,OIL RIGS,OIL RIGS,2,HUMBERSIDE,OIL RIGS,46631,0,46631,52294,0,52294,-10.82915822
17/03/2016 11:32,2015,115,OIL RIGS,OIL RIGS,2,INVERNESS,OIL RIGS,325,0,325,100,0,100,225
17/03/2016 11:32,2015,115,OIL RIGS,OIL RIGS,2,KIRKWALL,OIL RIGS,1,0,1,71,0,71,-98.5915493
17/03/2016 11:32,2015,115,OIL RIGS,OIL RIGS,2,LERWICK (TINGWALL),OIL RIGS,3,0,3,1,0,1,200
17/03/2016 11:32,2015,115,OIL RIGS,OIL RIGS,2,NORWICH,OIL RIGS,102945,0,102945,102217,0,102217,0.712210298
17/03/2016 11:32,2015,115,OIL RIGS,OIL RIGS,2,SCATSTA,OIL RIGS,114434,0,114434,128828,0,128828,-11.17303692
17/03/2016 11:32,2015,115,OIL RIGS,OIL RIGS,2,SUMBURGH,OIL RIGS,25887,0,25887,15378,0,15378,68.33788529
17/03/2016 11:32,2015,115,OIL RIGS,OIL RIGS,2,WICK JOHN O GROATS,OIL RIGS,895,0,895,2417,0,2417,-62.97062474
