rundate,report_period,region_num,foreign_region,foreign_country,uk_group,uk_apt,foreign_apt,ty_t_pax,ty_s_pax,ty_c_pax,ly_t_pax,ly_s_pax,ly_c_pax,pc_change
17/03/2020 10:48,2019,,Unknown,Unknown,2,MANCHESTER,Unknown,116,116,0,10,10,0,1060
17/03/2020 10:48,2019,1,WESTERN EUROPE-EU,AUSTRIA,1,GATWICK,INNSBRUCK,189034,161407,27627,200652,176646,24006,-5.79012
17/03/2020 10:48,2019,1,WESTERN EUROPE-EU,AUSTRIA,1,GATWICK,KLAGENFURT,8938,8938,0,5758,5758,0,55.22751
17/03/2020 10:48,2019,1,WESTERN EUROPE-EU,AUSTRIA,1,GATWICK,LINZ,698,0,698,172,172,0,305.81395
17/03/2020 10:48,2019,1,WESTERN EUROPE-EU,AUSTRIA,1,GATWICK,SALZBURG,130724,113882,16842,137514,118512,19002,-4.93768
17/03/2020 10:48,2019,1,WESTERN EUROPE-EU,AUSTRIA,1,GATWICK,VIENNA,286944,286944,0,336097,336097,0,-14.62465
17/03/2020 10:48,2019,1,WESTERN EUROPE-EU,AUSTRIA,1,HEATHROW,INNSBRUCK,47564,47564,0,54962,54962,0,-13.46021
17/03/2020 10:48,2019,1,WESTERN EUROPE-EU,AUSTRIA,1,HEATHROW,SALZBURG,15474,15474,0,33855,33855,0,-54.29331
17/03/2020 10:48,2019,1,WESTERN EUROPE-EU,AUSTRIA,1,HEATHROW,VIENNA,835503,835503,0,840882,840882,0,-0.63969
17/03/2020 10:48,2019,1,WESTERN EUROPE-EU,AUSTRIA,1,LUTON,GRAZ,655,0,655,401,0,401,63.34165
17/03/2020 10:48,2019,1,WESTERN EUROPE-EU,AUSTRIA,1,LUTON,INNSBRUCK,11716,11716,0,13975,13975,0,-16.16458
17/03/2020 10:48,2019,1,WESTERN EUROPE-EU,AUSTRIA,1,LUTON,LINZ,810,0,810,218,218,0,271.55963
17/03/2020 10:48,2019,1,WESTERN EUROPE-EU,AUSTRIA,1,LUTON,SALZBURG,11769,8741,3028,11521,8215,3306,2.15259
17/03/2020 10:48,2019,1,WESTERN EUROPE-EU,AUSTRIA,1,LUTON,VIENNA,60324,60324,0,63564,63564,0,-5.09722
17/03/2020 10:48,2019,1,WESTERN EUROPE-EU,AUSTRIA,1,SOUTHEND,VIENNA,0,0,0,16884,16884,0,-100
17/03/2020 10:48,2019,1,WESTERN EUROPE-EU,AUSTRIA,1,STANSTED,GRAZ,167,167,0,0,0,0,0
17/03/2020 10:48,2019,1,WESTERN EUROPE-EU,AUSTRIA,1,STANSTED,INNSBRUCK,9879,3375,6504,8794,946,7848,12.33796
17/03/2020 10:48,2019,1,WESTERN EUROPE-EU,AUSTRIA,1,STANSTED,LINZ,238,0,238,26776,26776,0,-99.11114
17/03/2020 10:48,2019,1,WESTERN EUROPE-EU,AUSTRIA,1,STANSTED,SALZBURG,91881,87923,3958,150737,146304,4433,-39.04549
17/03/2020 10:48,2019,1,WESTERN EUROPE-EU,AUSTRIA,1,STANSTED,VIENNA,231848,231744,104,104876,104876,0,121.06869
17/03/2020 10:48,2019,1,WESTERN EUROPE-EU,AUSTRIA,2,BELFAST CITY (GEORGE BEST),SALZBURG,1529,0,1529,1975,0,1975,-22.58228
17/03/2020 10:48,2019,1,WESTERN EUROPE-EU,AUSTRIA,2,BELFAST INTERNATIONAL,SALZBURG,10938,8091,2847,5098,1584,3514,114.55473
17/03/2020 10:48,2019,1,WESTERN EUROPE-EU,AUSTRIA,2,BELFAST INTERNATIONAL,VIENNA,279,279,0,562,296,266,-50.35587
17/03/2020 10:48,2019,1,WESTERN EUROPE-EU,AUSTRIA,2,BIGGIN HILL,INNSBRUCK,0,0,0,18,0,18,-100
17/03/2020 10:48,2019,1,WESTERN EUROPE-EU,AUSTRIA,2,BIGGIN HILL,VIENNA,12,0,12,0,0,0,0
17/03/2020 10:48,2019,1,WESTERN EUROPE-EU,AUSTRIA,2,BIRMINGHAM,GRAZ,0,0,0,1859,1344,515,-100
17/03/2020 10:48,2019,1,WESTERN EUROPE-EU,AUSTRIA,2,BIRMINGHAM,INNSBRUCK,14779,538,14241,15687,0,15687,-5.78823
17/03/2020 10:48,2019,1,WESTERN EUROPE-EU,AUSTRIA,2,BIRMINGHAM,LINZ,468,0,468,0,0,0,0
17/03/2020 10:48,2019,1,WESTERN EUROPE-EU,AUSTRIA,2,BIRMINGHAM,SALZBURG,14741,5331,9410,16343,5555,10788,-9.80236
17/03/2020 10:48,2019,1,WESTERN EUROPE-EU,AUSTRIA,2,BIRMINGHAM,VIENNA,43584,43584,0,37621,37621,0,15.85019
17/03/2020 10:48,2019,1,WESTERN EUROPE-EU,AUSTRIA,2,BRISTOL,INNSBRUCK,22017,10805,11212,22801,10334,12467,-3.43845
17/03/2020 10:48,2019,1,WESTERN EUROPE-EU,AUSTRIA,2,BRISTOL,SALZBURG,14521,10373,4148,13240,8678,4562,9.67523
17/03/2020 10:48,2019,1,WESTERN EUROPE-EU,AUSTRIA,2,BRISTOL,VIENNA,33715,33715,0,31024,31024,0,8.67393
17/03/2020 10:48,2019,1,WESTERN EUROPE-EU,AUSTRIA,2,CARDIFF WALES,SALZBURG,0,0,0,39,0,39,-100
17/03/2020 10:48,2019,1,WESTERN EUROPE-EU,AUSTRIA,2,EAST MIDLANDS INTERNATIONAL,LINZ,78,0,78,0,0,0,0
17/03/2020 10:48,2019,1,WESTERN EUROPE-EU,AUSTRIA,2,EAST MIDLANDS INTERNATIONAL,SALZBURG,6322,3303,3019,6670,3314,3356,-5.21739
17/03/2020 10:48,2019,1,WESTERN EUROPE-EU,AUSTRIA,2,EDINBURGH,INNSBRUCK,10406,0,10406,10976,0,10976,-5.19315
17/03/2020 10:48,2019,1,WESTERN EUROPE-EU,AUSTRIA,2,EDINBURGH,LINZ,0,0,0,296,0,296,-100
17/03/2020 10:48,2019,1,WESTERN EUROPE-EU,AUSTRIA,2,EDINBURGH,SALZBURG,7447,5135,2312,6818,4138,2680,9.22558
17/03/2020 10:48,2019,1,WESTERN EUROPE-EU,AUSTRIA,2,EDINBURGH,VIENNA,56760,56760,0,66234,66234,0,-14.30383
17/03/2020 10:48,2019,1,WESTERN EUROPE-EU,AUSTRIA,2,GLASGOW,GRAZ,56,0,56,106,0,106,-47.16981
17/03/2020 10:48,2019,1,WESTERN EUROPE-EU,AUSTRIA,2,GLASGOW,INNSBRUCK,284,0,284,0,0,0,0
17/03/2020 10:48,2019,1,WESTERN EUROPE-EU,AUSTRIA,2,GLASGOW,LINZ,706,0,706,243,0,243,190.53498
17/03/2020 10:48,2019,1,WESTERN EUROPE-EU,AUSTRIA,2,GLASGOW,SALZBURG,5477,0,5477,7592,0,7592,-27.85827
17/03/2020 10:48,2019,1,WESTERN EUROPE-EU,AUSTRIA,2,GLASGOW,VIENNA,317,0,317,2933,716,2217,-89.19195
17/03/2020 10:48,2019,1,WESTERN EUROPE-EU,AUSTRIA,2,HUMBERSIDE,VIENNA,0,0,0,92,0,92,-100
17/03/2020 10:48,2019,1,WESTERN EUROPE-EU,AUSTRIA,2,INVERNESS,GRAZ,0,0,0,104,0,104,-100
17/03/2020 10:48,2019,1,WESTERN EUROPE-EU,AUSTRIA,2,INVERNESS,LINZ,0,0,0,103,0,103,-100
17/03/2020 10:48,2019,1,WESTERN EUROPE-EU,AUSTRIA,2,INVERNESS,SALZBURG,0,0,0,64,0,64,-100
17/03/2020 10:48,2019,1,WESTERN EUROPE-EU,AUSTRIA,2,INVERNESS,VIENNA,0,0,0,419,0,419,-100
17/03/2020 10:48,2019,1,WESTERN EUROPE-EU,AUSTRIA,2,ISLE OF MAN,SALZBURG,140,0,140,0,0,0,0
17/03/2020 10:48,2019,1,WESTERN EUROPE-EU,AUSTRIA,2,JERSEY,VIENNA,742,0,742,696,0,696,6.6092
17/03/2020 10:48,2019,1,WESTERN EUROPE-EU,AUSTRIA,2,LEEDS BRADFORD,INNSBRUCK,2329,0,2329,2536,0,2536,-8.16246
17/03/2020 10:48,2019,1,WESTERN EUROPE-EU,AUSTRIA,2,LEEDS BRADFORD,SALZBURG,4764,4687,77,4019,4019,0,18.53695
17/03/2020 10:48,2019,1,WESTERN EUROPE-EU,AUSTRIA,2,LEEDS BRADFORD,VIENNA,3030,3030,0,360,360,0,741.66667
17/03/2020 10:48,2019,1,WESTERN EUROPE-EU,AUSTRIA,2,LIVERPOOL (JOHN LENNON),GRAZ,0,0,0,121,0,121,-100
17/03/2020 10:48,2019,1,WESTERN EUROPE-EU,AUSTRIA,2,LIVERPOOL (JOHN LENNON),LINZ,1491,0,1491,0,0,0,0
17/03/2020 10:48,2019,1,WESTERN EUROPE-EU,AUSTRIA,2,LIVERPOOL (JOHN LENNON),SALZBURG,6773,5165,1608,4937,4937,0,37.18858
17/03/2020 10:48,2019,1,WESTERN EUROPE-EU,AUSTRIA,2,LIVERPOOL (JOHN LENNON),VIENNA,5926,5926,0,0,0,0,0
17/03/2020 10:48,2019,1,WESTERN EUROPE-EU,AUSTRIA,2,MANCHESTER,INNSBRUCK,37569,16975,20594,41004,17523,23481,-8.37723
17/03/2020 10:48,2019,1,WESTERN EUROPE-EU,AUSTRIA,2,MANCHESTER,LINZ,225,0,225,0,0,0,0
17/03/2020 10:48,2019,1,WESTERN EUROPE-EU,AUSTRIA,2,MANCHESTER,SALZBURG,35326,11772,23554,36254,16147,20107,-2.55972
17/03/2020 10:48,2019,1,WESTERN EUROPE-EU,AUSTRIA,2,MANCHESTER,VIENNA,116477,116477,0,108527,108388,139,7.32537
17/03/2020 10:48,2019,1,WESTERN EUROPE-EU,AUSTRIA,2,NEWCASTLE,INNSBRUCK,4547,4547,0,4200,4168,32,8.2619
17/03/2020 10:48,2019,1,WESTERN EUROPE-EU,AUSTRIA,2,NEWCASTLE,LINZ,134,134,0,0,0,0,0
17/03/2020 10:48,2019,1,WESTERN EUROPE-EU,AUSTRIA,2,NEWCASTLE,SALZBURG,7322,7322,0,7445,7299,146,-1.65212
17/03/2020 10:48,2019,1,WESTERN EUROPE-EU,AUSTRIA,2,NEWCASTLE,VIENNA,1931,1931,0,705,705,0,173.90071
17/03/2020 10:48,2019,1,WESTERN EUROPE-EU,AUSTRIA,2,TEESSIDE INTERNATIONAL AIRPORT,GRAZ,0,0,0,50,0,50,-100
17/03/2020 10:48,2019,1,WESTERN EUROPE-EU,AUSTRIA,2,TEESSIDE INTERNATIONAL AIRPORT,LINZ,0,0,0,36,0,36,-100
17/03/2020 10:48,2019,1,WESTERN EUROPE-EU,BELGIUM,1,GATWICK,BRUSSELS,4111,4111,0,12304,12304,0,-66.5881
17/03/2020 10:48,2019,1,WESTERN EUROPE-EU,BELGIUM,1,HEATHROW,BRUSSELS,675645,675645,0,672319,672319,0,0.49471
17/03/2020 10:48,2019,1,WESTERN EUROPE-EU,BELGIUM,1,LONDON CITY,ANTWERP,14995,14995,0,27525,27525,0,-45.52225
17/03/2020 10:48,2019,1,WESTERN EUROPE-EU,BELGIUM,1,LONDON CITY,BRUSSELS,0,0,0,67,67,0,-100
17/03/2020 10:48,2019,1,WESTERN EUROPE-EU,BELGIUM,1,LUTON,ANTWERP,0,0,0,42,0,42,-100
17/03/2020 10:48,2019,1,WESTERN EUROPE-EU,BELGIUM,1,LUTON,LIEGE,245,0,245,0,0,0,0
17/03/2020 10:48,2019,1,WESTERN EUROPE-EU,BELGIUM,1,LUTON,OSTEND,0,0,0,13,0,13,-100
17/03/2020 10:48,2019,1,WESTERN EUROPE-EU,BELGIUM,1,SOUTHEND,ANTWERP,8121,8121,0,13246,13246,0,-38.69093
17/03/2020 10:48,2019,1,WESTERN EUROPE-EU,BELGIUM,1,STANSTED,BRUSSELS,291,181,110,0,0,0,0
17/03/2020 10:48,2019,1,WESTERN EUROPE-EU,BELGIUM,1,STANSTED,CHARLEROI,178,178,0,0,0,0,0
17/03/2020 10:48,2019,1,WESTERN EUROPE-EU,BELGIUM,2,ABERDEEN,ANTWERP,0,0,0,1279,1279,0,-100
17/03/2020 10:48,2019,1,WESTERN EUROPE-EU,BELGIUM,2,ABERDEEN,BRUSSELS,437,437,0,0,0,0,0
17/03/2020 10:48,2019,1,WESTERN EUROPE-EU,BELGIUM,2,BELFAST CITY (GEORGE BEST),BRUSSELS,39,0,39,0,0,0,0
17/03/2020 10:48,2019,1,WESTERN EUROPE-EU,BELGIUM,2,BIGGIN HILL,BRUSSELS,0,0,0,15,0,15,-100
17/03/2020 10:48,2019,1,WESTERN EUROPE-EU,BELGIUM,2,BIRMINGHAM,ANTWERP,0,0,0,2179,2179,0,-100
17/03/2020 10:48,2019,1,WESTERN EUROPE-EU,BELGIUM,2,BIRMINGHAM,BRUSSELS,133254,133254,0,141497,141408,89,-5.82557
17/03/2020 10:48,2019,1,WESTERN EUROPE-EU,BELGIUM,2,BRISTOL,BRUSSELS,21424,21424,0,55115,55115,0,-61.12855
17/03/2020 10:48,2019,1,WESTERN EUROPE-EU,BELGIUM,2,BRISTOL,LIEGE,0,0,0,2,2,0,-100
17/03/2020 10:48,2019,1,WESTERN EUROPE-EU,BELGIUM,2,CARDIFF WALES,BRUSSELS,0,0,0,19,19,0,-100
17/03/2020 10:48,2019,1,WESTERN EUROPE-EU,BELGIUM,2,EAST MIDLANDS INTERNATIONAL,BRUSSELS,9345,9293,52,26631,26631,0,-64.90932
17/03/2020 10:48,2019,1,WESTERN EUROPE-EU,BELGIUM,2,EDINBURGH,BRUSSELS,146293,145634,659,137002,136816,186,6.78165
17/03/2020 10:48,2019,1,WESTERN EUROPE-EU,BELGIUM,2,EDINBURGH,CHARLEROI,83586,83586,0,75304,75304,0,10.99809
17/03/2020 10:48,2019,1,WESTERN EUROPE-EU,BELGIUM,2,EDINBURGH,OSTEND,84,0,84,0,0,0,0
17/03/2020 10:48,2019,1,WESTERN EUROPE-EU,BELGIUM,2,GLASGOW,BRUSSELS,362,0,362,132,0,132,174.24242
17/03/2020 10:48,2019,1,WESTERN EUROPE-EU,BELGIUM,2,GLASGOW,CHARLEROI,19347,19347,0,26077,26077,0,-25.80818
17/03/2020 10:48,2019,1,WESTERN EUROPE-EU,BELGIUM,2,GLASGOW,LIEGE,0,0,0,88,0,88,-100
17/03/2020 10:48,2019,1,WESTERN EUROPE-EU,BELGIUM,2,LEEDS BRADFORD,ANTWERP,196,0,196,0,0,0,0
17/03/2020 10:48,2019,1,WESTERN EUROPE-EU,BELGIUM,2,LEEDS BRADFORD,CHARLEROI,144,144,0,0,0,0,0
17/03/2020 10:48,2019,1,WESTERN EUROPE-EU,BELGIUM,2,LIVERPOOL (JOHN LENNON),BRUSSELS,0,0,0,186,0,186,-100
17/03/2020 10:48,2019,1,WESTERN EUROPE-EU,BELGIUM,2,MANCHESTER,ANTWERP,0,0,0,173,0,173,-100
17/03/2020 10:48,2019,1,WESTERN EUROPE-EU,BELGIUM,2,MANCHESTER,BRUSSELS,241179,240949,230,232161,232113,48,3.88437
17/03/2020 10:48,2019,1,WESTERN EUROPE-EU,BELGIUM,2,MANCHESTER,CHARLEROI,181171,180998,173,174343,174343,0,3.91642
17/03/2020 10:48,2019,1,WESTERN EUROPE-EU,BELGIUM,2,MANCHESTER,LIEGE,252,0,252,0,0,0,0
17/03/2020 10:48,2019,1,WESTERN EUROPE-EU,BELGIUM,2,MANCHESTER,OSTEND,122,0,122,0,0,0,0
17/03/2020 10:48,2019,1,WESTERN EUROPE-EU,BELGIUM,2,NEWCASTLE,BRUSSELS,17900,17900,0,28248,28248,0,-36.63268
17/03/2020 10:48,2019,1,WESTERN EUROPE-EU,BELGIUM,2,SOUTHAMPTON,LIEGE,0,0,0,61,0,61,-100
17/03/2020 10:48,2019,1,WESTERN EUROPE-EU,CROATIA,1,GATWICK,DUBROVNIK,237386,237386,0,219074,218779,295,8.35882
17/03/2020 10:48,2019,1,WESTERN EUROPE-EU,CROATIA,1,GATWICK,PULA,51339,25906,25433,43821,20112,23709,17.15616
17/03/2020 10:48,2019,1,WESTERN EUROPE-EU,CROATIA,1,GATWICK,RIJEKA,6045,0,6045,0,0,0,0
17/03/2020 10:48,2019,1,WESTERN EUROPE-EU,CROATIA,1,GATWICK,SPLIT,178494,162597,15897,177874,161290,16584,0.34856
17/03/2020 10:48,2019,1,WESTERN EUROPE-EU,CROATIA,1,GATWICK,ZADAR,13897,13897,0,0,0,0,0
17/03/2020 10:48,2019,1,WESTERN EUROPE-EU,CROATIA,1,GATWICK,ZAGREB,217,217,0,374,374,0,-41.97861
17/03/2020 10:48,2019,1,WESTERN EUROPE-EU,CROATIA,1,HEATHROW,PULA,9114,9034,80,7245,7245,0,25.7971
17/03/2020 10:48,2019,1,WESTERN EUROPE-EU,CROATIA,1,HEATHROW,SPLIT,49946,49946,0,31201,31201,0,60.0782
17/03/2020 10:48,2019,1,WESTERN EUROPE-EU,CROATIA,1,HEATHROW,ZAGREB,141232,141232,0,140534,140534,0,0.49668
17/03/2020 10:48,2019,1,WESTERN EUROPE-EU,CROATIA,1,LONDON CITY,SPLIT,5159,5159,0,0,0,0,0
17/03/2020 10:48,2019,1,WESTERN EUROPE-EU,CROATIA,1,LUTON,DUBROVNIK,24244,24244,0,21951,21951,0,10.44599
17/03/2020 10:48,2019,1,WESTERN EUROPE-EU,CROATIA,1,LUTON,PULA,175,0,175,0,0,0,0
17/03/2020 10:48,2019,1,WESTERN EUROPE-EU,CROATIA,1,LUTON,SPLIT,89263,89136,127,87825,87825,0,1.63735
17/03/2020 10:48,2019,1,WESTERN EUROPE-EU,CROATIA,1,LUTON,ZADAR,14630,14630,0,14770,14770,0,-0.94787
17/03/2020 10:48,2019,1,WESTERN EUROPE-EU,CROATIA,1,SOUTHEND,DUBROVNIK,17251,17251,0,15553,15553,0,10.91751
17/03/2020 10:48,2019,1,WESTERN EUROPE-EU,CROATIA,1,SOUTHEND,PULA,15970,15970,0,7209,7209,0,121.52864
17/03/2020 10:48,2019,1,WESTERN EUROPE-EU,CROATIA,1,SOUTHEND,ZADAR,0,0,0,3894,3894,0,-100
17/03/2020 10:48,2019,1,WESTERN EUROPE-EU,CROATIA,1,STANSTED,DUBROVNIK,96119,96119,0,84188,84188,0,14.17185
17/03/2020 10:48,2019,1,WESTERN EUROPE-EU,CROATIA,1,STANSTED,PULA,36735,36735,0,34895,34895,0,5.27296
17/03/2020 10:48,2019,1,WESTERN EUROPE-EU,CROATIA,1,STANSTED,RIJEKA,11503,11503,0,6042,6042,0,90.38398
17/03/2020 10:48,2019,1,WESTERN EUROPE-EU,CROATIA,1,STANSTED,SPLIT,50038,49666,372,44179,44179,0,13.26196
17/03/2020 10:48,2019,1,WESTERN EUROPE-EU,CROATIA,1,STANSTED,ZADAR,42155,36170,5985,37323,32364,4959,12.94644
17/03/2020 10:48,2019,1,WESTERN EUROPE-EU,CROATIA,2,ABERDEEN,RIJEKA,330,0,330,0,0,0,0
17/03/2020 10:48,2019,1,WESTERN EUROPE-EU,CROATIA,2,BELFAST INTERNATIONAL,DUBROVNIK,24219,23856,363,18559,18469,90,30.49733
17/03/2020 10:48,2019,1,WESTERN EUROPE-EU,CROATIA,2,BELFAST INTERNATIONAL,SPLIT,13655,13655,0,13386,13386,0,2.00956
17/03/2020 10:48,2019,1,WESTERN EUROPE-EU,CROATIA,2,BIGGIN HILL,SPLIT,7,0,7,7,0,7,0
17/03/2020 10:48,2019,1,WESTERN EUROPE-EU,CROATIA,2,BIRMINGHAM,DUBROVNIK,40108,40108,0,35371,35371,0,13.39233
17/03/2020 10:48,2019,1,WESTERN EUROPE-EU,CROATIA,2,BIRMINGHAM,PULA,22041,7008,15033,15530,0,15530,41.92531
17/03/2020 10:48,2019,1,WESTERN EUROPE-EU,CROATIA,2,BIRMINGHAM,SPLIT,11500,11328,172,14753,14753,0,-22.04975
17/03/2020 10:48,2019,1,WESTERN EUROPE-EU,CROATIA,2,BRISTOL,DUBROVNIK,46657,43376,3281,36870,36870,0,26.54462
17/03/2020 10:48,2019,1,WESTERN EUROPE-EU,CROATIA,2,BRISTOL,PULA,30462,14977,15485,29427,14827,14600,3.51718
17/03/2020 10:48,2019,1,WESTERN EUROPE-EU,CROATIA,2,BRISTOL,SPLIT,41021,41021,0,37659,37659,0,8.92748
17/03/2020 10:48,2019,1,WESTERN EUROPE-EU,CROATIA,2,CARDIFF WALES,DUBROVNIK,8784,0,8784,0,0,0,0
17/03/2020 10:48,2019,1,WESTERN EUROPE-EU,CROATIA,2,CARDIFF WALES,SPLIT,104,0,104,0,0,0,0
17/03/2020 10:48,2019,1,WESTERN EUROPE-EU,CROATIA,2,CARDIFF WALES,ZAGREB,94,0,94,0,0,0,0
17/03/2020 10:48,2019,1,WESTERN EUROPE-EU,CROATIA,2,DONCASTER SHEFFIELD,DUBROVNIK,9347,7856,1491,8790,5707,3083,6.33675
17/03/2020 10:48,2019,1,WESTERN EUROPE-EU,CROATIA,2,DONCASTER SHEFFIELD,PULA,8277,0,8277,0,0,0,0
17/03/2020 10:48,2019,1,WESTERN EUROPE-EU,CROATIA,2,EAST MIDLANDS INTERNATIONAL,DUBROVNIK,26127,26127,0,23743,22852,891,10.04085
17/03/2020 10:48,2019,1,WESTERN EUROPE-EU,CROATIA,2,EAST MIDLANDS INTERNATIONAL,PULA,7400,0,7400,6293,0,6293,17.59097
17/03/2020 10:48,2019,1,WESTERN EUROPE-EU,CROATIA,2,EAST MIDLANDS INTERNATIONAL,SPLIT,6521,6521,0,11696,11696,0,-44.2459
17/03/2020 10:48,2019,1,WESTERN EUROPE-EU,CROATIA,2,EDINBURGH,DUBROVNIK,39666,39666,0,37937,37937,0,4.55756
17/03/2020 10:48,2019,1,WESTERN EUROPE-EU,CROATIA,2,EDINBURGH,PULA,6164,6164,0,17532,10736,6796,-64.84143
17/03/2020 10:48,2019,1,WESTERN EUROPE-EU,CROATIA,2,EDINBURGH,SPLIT,7652,7652,0,11111,11111,0,-31.13131
17/03/2020 10:48,2019,1,WESTERN EUROPE-EU,CROATIA,2,GLASGOW,DUBROVNIK,17905,14810,3095,18636,8635,10001,-3.92252
17/03/2020 10:48,2019,1,WESTERN EUROPE-EU,CROATIA,2,GLASGOW,OSIJEK,0,0,0,315,0,315,-100
17/03/2020 10:48,2019,1,WESTERN EUROPE-EU,CROATIA,2,GLASGOW,SPLIT,16386,16386,0,17126,17126,0,-4.32092
17/03/2020 10:48,2019,1,WESTERN EUROPE-EU,CROATIA,2,HUMBERSIDE,DUBROVNIK,78,0,78,92,0,92,-15.21739
17/03/2020 10:48,2019,1,WESTERN EUROPE-EU,CROATIA,2,LEEDS BRADFORD,DUBROVNIK,19586,19586,0,19300,19300,0,1.48187
17/03/2020 10:48,2019,1,WESTERN EUROPE-EU,CROATIA,2,LEEDS BRADFORD,PULA,10427,10427,0,11439,11439,0,-8.84693
17/03/2020 10:48,2019,1,WESTERN EUROPE-EU,CROATIA,2,LEEDS BRADFORD,SPLIT,16496,16496,0,11770,11770,0,40.15293
17/03/2020 10:48,2019,1,WESTERN EUROPE-EU,CROATIA,2,LIVERPOOL (JOHN LENNON),OSIJEK,59,0,59,0,0,0,0
17/03/2020 10:48,2019,1,WESTERN EUROPE-EU,CROATIA,2,LIVERPOOL (JOHN LENNON),PULA,12701,12701,0,5704,5661,43,122.6683
17/03/2020 10:48,2019,1,WESTERN EUROPE-EU,CROATIA,2,LIVERPOOL (JOHN LENNON),RIJEKA,0,0,0,43,0,43,-100
17/03/2020 10:48,2019,1,WESTERN EUROPE-EU,CROATIA,2,LIVERPOOL (JOHN LENNON),ZAGREB,0,0,0,501,0,501,-100
17/03/2020 10:48,2019,1,WESTERN EUROPE-EU,CROATIA,2,MANCHESTER,DUBROVNIK,111830,111830,0,100707,100519,188,11.04491
17/03/2020 10:48,2019,1,WESTERN EUROPE-EU,CROATIA,2,MANCHESTER,PULA,34184,20178,14006,36967,20535,16432,-7.52834
17/03/2020 10:48,2019,1,WESTERN EUROPE-EU,CROATIA,2,MANCHESTER,SPLIT,88828,76467,12361,90853,75154,15699,-2.22888
17/03/2020 10:48,2019,1,WESTERN EUROPE-EU,CROATIA,2,MANCHESTER,ZADAR,25429,20085,5344,25366,20891,4475,0.24836
17/03/2020 10:48,2019,1,WESTERN EUROPE-EU,CROATIA,2,MANCHESTER,ZAGREB,873,0,873,0,0,0,0
17/03/2020 10:48,2019,1,WESTERN EUROPE-EU,CROATIA,2,NEWCASTLE,DUBROVNIK,17571,17571,0,23702,23702,0,-25.86702
17/03/2020 10:48,2019,1,WESTERN EUROPE-EU,CROATIA,2,NEWCASTLE,SPLIT,5168,5168,0,5619,5619,0,-8.02634
17/03/2020 10:48,2019,1,WESTERN EUROPE-EU,CROATIA,2,SOUTHAMPTON,SPLIT,33,33,0,0,0,0,0
17/03/2020 10:48,2019,1,WESTERN EUROPE-EU,CYPRUS,1,GATWICK,LARNACA,242838,191167,51671,320533,265973,54560,-24.23931
17/03/2020 10:48,2019,1,WESTERN EUROPE-EU,CYPRUS,1,GATWICK,PAPHOS,372265,285582,86683,378912,283680,95232,-1.75423
17/03/2020 10:48,2019,1,WESTERN EUROPE-EU,CYPRUS,1,HEATHROW,LARNACA,234665,234665,0,273464,273464,0,-14.18797
17/03/2020 10:48,2019,1,WESTERN EUROPE-EU,CYPRUS,1,LUTON,LARNACA,255945,255945,0,160499,152254,8245,59.46828
17/03/2020 10:48,2019,1,WESTERN EUROPE-EU,CYPRUS,1,LUTON,PAPHOS,98097,81648,16449,107456,82473,24983,-8.70961
17/03/2020 10:48,2019,1,WESTERN EUROPE-EU,CYPRUS,1,STANSTED,LARNACA,76769,67751,9018,91852,82363,9489,-16.42098
17/03/2020 10:48,2019,1,WESTERN EUROPE-EU,CYPRUS,1,STANSTED,PAPHOS,238911,212272,26639,228079,197854,30225,4.74923
17/03/2020 10:48,2019,1,WESTERN EUROPE-EU,CYPRUS,2,BELFAST INTERNATIONAL,LARNACA,9126,3465,5661,17581,0,17581,-48.09169
17/03/2020 10:48,2019,1,WESTERN EUROPE-EU,CYPRUS,2,BELFAST INTERNATIONAL,PAPHOS,11215,11215,0,8455,8455,0,32.64341
17/03/2020 10:48,2019,1,WESTERN EUROPE-EU,CYPRUS,2,BIGGIN HILL,LARNACA,6,0,6,5,0,5,20
17/03/2020 10:48,2019,1,WESTERN EUROPE-EU,CYPRUS,2,BIGGIN HILL,PAPHOS,7,0,7,0,0,0,0
17/03/2020 10:48,2019,1,WESTERN EUROPE-EU,CYPRUS,2,BIRMINGHAM,LARNACA,129519,97811,31708,130075,96785,33290,-0.42745
17/03/2020 10:48,2019,1,WESTERN EUROPE-EU,CYPRUS,2,BIRMINGHAM,PAPHOS,106402,58864,47538,99193,46212,52981,7.26765
17/03/2020 10:48,2019,1,WESTERN EUROPE-EU,CYPRUS,2,BOURNEMOUTH,LARNACA,0,0,0,186,0,186,-100
17/03/2020 10:48,2019,1,WESTERN EUROPE-EU,CYPRUS,2,BOURNEMOUTH,PAPHOS,42775,28556,14219,19109,5698,13411,123.8474
17/03/2020 10:48,2019,1,WESTERN EUROPE-EU,CYPRUS,2,BRISTOL,LARNACA,76840,50434,26406,47660,25012,22648,61.22535
17/03/2020 10:48,2019,1,WESTERN EUROPE-EU,CYPRUS,2,BRISTOL,PAPHOS,89252,60549,28703,92219,63605,28614,-3.21734
17/03/2020 10:48,2019,1,WESTERN EUROPE-EU,CYPRUS,2,CARDIFF WALES,LARNACA,18865,0,18865,17474,0,17474,7.9604
17/03/2020 10:48,2019,1,WESTERN EUROPE-EU,CYPRUS,2,CARDIFF WALES,PAPHOS,24015,0,24015,13716,0,13716,75.08749
17/03/2020 10:48,2019,1,WESTERN EUROPE-EU,CYPRUS,2,DONCASTER SHEFFIELD,LARNACA,9813,0,9813,9806,0,9806,0.07138
17/03/2020 10:48,2019,1,WESTERN EUROPE-EU,CYPRUS,2,DONCASTER SHEFFIELD,PAPHOS,24528,0,24528,22412,0,22412,9.44137
17/03/2020 10:48,2019,1,WESTERN EUROPE-EU,CYPRUS,2,EAST MIDLANDS INTERNATIONAL,LARNACA,38821,29609,9212,39610,30961,8649,-1.99192
17/03/2020 10:48,2019,1,WESTERN EUROPE-EU,CYPRUS,2,EAST MIDLANDS INTERNATIONAL,PAPHOS,65755,41568,24187,70292,47542,22750,-6.4545
17/03/2020 10:48,2019,1,WESTERN EUROPE-EU,CYPRUS,2,EDINBURGH,LARNACA,20817,11662,9155,21118,10636,10482,-1.42532
17/03/2020 10:48,2019,1,WESTERN EUROPE-EU,CYPRUS,2,EDINBURGH,PAPHOS,75816,60905,14911,73948,59759,14189,2.5261
17/03/2020 10:48,2019,1,WESTERN EUROPE-EU,CYPRUS,2,EXETER,LARNACA,10241,0,10241,10631,0,10631,-3.66852
17/03/2020 10:48,2019,1,WESTERN EUROPE-EU,CYPRUS,2,EXETER,PAPHOS,12249,0,12249,12055,0,12055,1.60929
17/03/2020 10:48,2019,1,WESTERN EUROPE-EU,CYPRUS,2,GLASGOW,LARNACA,39722,28808,10914,45142,33684,11458,-12.00656
17/03/2020 10:48,2019,1,WESTERN EUROPE-EU,CYPRUS,2,GLASGOW,PAPHOS,40308,26713,13595,41289,26261,15028,-2.37594
17/03/2020 10:48,2019,1,WESTERN EUROPE-EU,CYPRUS,2,LEEDS BRADFORD,LARNACA,42334,42334,0,39605,39605,0,6.89054
17/03/2020 10:48,2019,1,WESTERN EUROPE-EU,CYPRUS,2,LEEDS BRADFORD,PAPHOS,47097,47097,0,52106,45211,6895,-9.6131
17/03/2020 10:48,2019,1,WESTERN EUROPE-EU,CYPRUS,2,LIVERPOOL (JOHN LENNON),LARNACA,36760,36760,0,35055,35055,0,4.86379
17/03/2020 10:48,2019,1,WESTERN EUROPE-EU,CYPRUS,2,LIVERPOOL (JOHN LENNON),PAPHOS,33776,33776,0,5491,5491,0,515.11564
17/03/2020 10:48,2019,1,WESTERN EUROPE-EU,CYPRUS,2,MANCHESTER,LARNACA,130174,83811,46363,146322,96557,49765,-11.03593
17/03/2020 10:48,2019,1,WESTERN EUROPE-EU,CYPRUS,2,MANCHESTER,PAPHOS,328428,234926,93502,318068,222270,95798,3.25717
17/03/2020 10:48,2019,1,WESTERN EUROPE-EU,CYPRUS,2,NEWCASTLE,LARNACA,54064,54064,0,57810,57810,0,-6.47985
17/03/2020 10:48,2019,1,WESTERN EUROPE-EU,CYPRUS,2,NEWCASTLE,PAPHOS,54300,54300,0,52480,52480,0,3.46799
17/03/2020 10:48,2019,1,WESTERN EUROPE-EU,CYPRUS,2,NORWICH,PAPHOS,7265,0,7265,7099,0,7099,2.33836
17/03/2020 10:48,2019,1,WESTERN EUROPE-EU,DENMARK,1,GATWICK,AALBORG,0,0,0,31405,31405,0,-100
17/03/2020 10:48,2019,1,WESTERN EUROPE-EU,DENMARK,1,GATWICK,AARHUS (TIRSTRUP),8753,8753,0,3452,3452,0,153.56315
17/03/2020 10:48,2019,1,WESTERN EUROPE-EU,DENMARK,1,GATWICK,COPENHAGEN,770577,770527,50,798591,798464,127,-3.50793
17/03/2020 10:48,2019,1,WESTERN EUROPE-EU,DENMARK,1,GATWICK,RONNE,0,0,0,7,0,7,-100
17/03/2020 10:48,2019,1,WESTERN EUROPE-EU,DENMARK,1,HEATHROW,BILLUND,91019,91019,0,125046,125046,0,-27.21159
17/03/2020 10:48,2019,1,WESTERN EUROPE-EU,DENMARK,1,HEATHROW,COPENHAGEN,947501,947501,0,1012730,1012730,0,-6.44091
17/03/2020 10:48,2019,1,WESTERN EUROPE-EU,DENMARK,1,LONDON CITY,BILLUND,21087,21087,0,18730,18730,0,12.58409
17/03/2020 10:48,2019,1,WESTERN EUROPE-EU,DENMARK,1,LUTON,BILLUND,0,0,0,168,168,0,-100
17/03/2020 10:48,2019,1,WESTERN EUROPE-EU,DENMARK,1,LUTON,COPENHAGEN,110981,110981,0,123412,123412,0,-10.07276
17/03/2020 10:48,2019,1,WESTERN EUROPE-EU,DENMARK,1,LUTON,KARUP,0,0,0,84,0,84,-100
17/03/2020 10:48,2019,1,WESTERN EUROPE-EU,DENMARK,1,SOUTHEND,BILLUND,0,0,0,24,24,0,-100
17/03/2020 10:48,2019,1,WESTERN EUROPE-EU,DENMARK,1,SOUTHEND,COPENHAGEN,25170,25170,0,0,0,0,0
17/03/2020 10:48,2019,1,WESTERN EUROPE-EU,DENMARK,1,SOUTHEND,KARUP,125,0,125,0,0,0,0
17/03/2020 10:48,2019,1,WESTERN EUROPE-EU,DENMARK,1,STANSTED,AALBORG,52411,52411,0,54734,54734,0,-4.24416
17/03/2020 10:48,2019,1,WESTERN EUROPE-EU,DENMARK,1,STANSTED,AARHUS (TIRSTRUP),102796,102796,0,103089,103089,0,-0.28422
17/03/2020 10:48,2019,1,WESTERN EUROPE-EU,DENMARK,1,STANSTED,BILLUND,208715,208715,0,212578,212375,203,-1.81722
17/03/2020 10:48,2019,1,WESTERN EUROPE-EU,DENMARK,1,STANSTED,COPENHAGEN,384873,384873,0,339888,339606,282,13.23524
17/03/2020 10:48,2019,1,WESTERN EUROPE-EU,DENMARK,1,STANSTED,KARUP,277,0,277,0,0,0,0
17/03/2020 10:48,2019,1,WESTERN EUROPE-EU,DENMARK,2,ABERDEEN,BILLUND,36,36,0,0,0,0,0
17/03/2020 10:48,2019,1,WESTERN EUROPE-EU,DENMARK,2,ABERDEEN,COPENHAGEN,30317,30317,0,25331,25331,0,19.68339
17/03/2020 10:48,2019,1,WESTERN EUROPE-EU,DENMARK,2,ABERDEEN,ESBJERG,18110,18110,0,11274,11274,0,60.63509
17/03/2020 10:48,2019,1,WESTERN EUROPE-EU,DENMARK,2,BELFAST INTERNATIONAL,COPENHAGEN,384,0,384,0,0,0,0
17/03/2020 10:48,2019,1,WESTERN EUROPE-EU,DENMARK,2,BELFAST INTERNATIONAL,ROSKILDE,0,0,0,79,0,79,-100
17/03/2020 10:48,2019,1,WESTERN EUROPE-EU,DENMARK,2,BIGGIN HILL,BILLUND,0,0,0,58,0,58,-100
17/03/2020 10:48,2019,1,WESTERN EUROPE-EU,DENMARK,2,BIGGIN HILL,COPENHAGEN,0,0,0,8,0,8,-100
17/03/2020 10:48,2019,1,WESTERN EUROPE-EU,DENMARK,2,BIRMINGHAM,BILLUND,0,0,0,11,11,0,-100
17/03/2020 10:48,2019,1,WESTERN EUROPE-EU,DENMARK,2,BIRMINGHAM,COPENHAGEN,79600,79600,0,78149,78149,0,1.85671
17/03/2020 10:48,2019,1,WESTERN EUROPE-EU,DENMARK,2,BRISTOL,COPENHAGEN,49083,49083,0,44603,44603,0,10.04417
17/03/2020 10:48,2019,1,WESTERN EUROPE-EU,DENMARK,2,BRISTOL,KARUP,0,0,0,445,0,445,-100
17/03/2020 10:48,2019,1,WESTERN EUROPE-EU,DENMARK,2,BRISTOL,ODENSE,28,0,28,0,0,0,0
17/03/2020 10:48,2019,1,WESTERN EUROPE-EU,DENMARK,2,CARDIFF WALES,AARHUS (TIRSTRUP),0,0,0,152,0,152,-100
17/03/2020 10:48,2019,1,WESTERN EUROPE-EU,DENMARK,2,CARDIFF WALES,BILLUND,0,0,0,65,0,65,-100
17/03/2020 10:48,2019,1,WESTERN EUROPE-EU,DENMARK,2,DUNDEE,BILLUND,0,0,0,48,0,48,-100
17/03/2020 10:48,2019,1,WESTERN EUROPE-EU,DENMARK,2,DUNDEE,KARUP,0,0,0,458,0,458,-100
17/03/2020 10:48,2019,1,WESTERN EUROPE-EU,DENMARK,2,DUNDEE,ROSKILDE,0,0,0,16,0,16,-100
17/03/2020 10:48,2019,1,WESTERN EUROPE-EU,DENMARK,2,EAST MIDLANDS INTERNATIONAL,COPENHAGEN,370,370,0,0,0,0,0
17/03/2020 10:48,2019,1,WESTERN EUROPE-EU,DENMARK,2,EDINBURGH,AALBORG,2157,2157,0,0,0,0,0
17/03/2020 10:48,2019,1,WESTERN EUROPE-EU,DENMARK,2,EDINBURGH,BILLUND,19648,19648,0,266,159,107,7286.46617
17/03/2020 10:48,2019,1,WESTERN EUROPE-EU,DENMARK,2,EDINBURGH,COPENHAGEN,219462,219462,0,241852,241565,287,-9.25773
17/03/2020 10:48,2019,1,WESTERN EUROPE-EU,DENMARK,2,EDINBURGH,ODENSE,532,0,532,442,0,442,20.36199
17/03/2020 10:48,2019,1,WESTERN EUROPE-EU,DENMARK,2,GLASGOW,BILLUND,445,0,445,0,0,0,0
17/03/2020 10:48,2019,1,WESTERN EUROPE-EU,DENMARK,2,GLASGOW,COPENHAGEN,3,3,0,0,0,0,0
17/03/2020 10:48,2019,1,WESTERN EUROPE-EU,DENMARK,2,GLASGOW,KARUP,172,0,172,0,0,0,0
17/03/2020 10:48,2019,1,WESTERN EUROPE-EU,DENMARK,2,INVERNESS,BILLUND,0,0,0,37,0,37,-100
17/03/2020 10:48,2019,1,WESTERN EUROPE-EU,DENMARK,2,INVERNESS,COPENHAGEN,236,0,236,0,0,0,0
17/03/2020 10:48,2019,1,WESTERN EUROPE-EU,DENMARK,2,JERSEY,SONDERBORG,0,0,0,200,0,200,-100
17/03/2020 10:48,2019,1,WESTERN EUROPE-EU,DENMARK,2,LEEDS BRADFORD,BILLUND,26,26,0,0,0,0,0
17/03/2020 10:48,2019,1,WESTERN EUROPE-EU,DENMARK,2,LEEDS BRADFORD,COPENHAGEN,372,372,0,371,371,0,0.26954
17/03/2020 10:48,2019,1,WESTERN EUROPE-EU,DENMARK,2,LIVERPOOL (JOHN LENNON),BILLUND,0,0,0,64,0,64,-100
17/03/2020 10:48,2019,1,WESTERN EUROPE-EU,DENMARK,2,LIVERPOOL (JOHN LENNON),COPENHAGEN,24391,23668,723,0,0,0,0
17/03/2020 10:48,2019,1,WESTERN EUROPE-EU,DENMARK,2,LIVERPOOL (JOHN LENNON),KARUP,0,0,0,128,0,128,-100
17/03/2020 10:48,2019,1,WESTERN EUROPE-EU,DENMARK,2,LIVERPOOL (JOHN LENNON),ODENSE,0,0,0,283,0,283,-100
17/03/2020 10:48,2019,1,WESTERN EUROPE-EU,DENMARK,2,LIVERPOOL (JOHN LENNON),ROSKILDE,0,0,0,111,0,111,-100
17/03/2020 10:48,2019,1,WESTERN EUROPE-EU,DENMARK,2,LIVERPOOL (JOHN LENNON),SONDERBORG,111,0,111,0,0,0,0
17/03/2020 10:48,2019,1,WESTERN EUROPE-EU,DENMARK,2,MANCHESTER,AALBORG,0,0,0,211,211,0,-100
17/03/2020 10:48,2019,1,WESTERN EUROPE-EU,DENMARK,2,MANCHESTER,AARHUS (TIRSTRUP),4663,4663,0,33,0,33,14030.30303
17/03/2020 10:48,2019,1,WESTERN EUROPE-EU,DENMARK,2,MANCHESTER,BILLUND,60973,60882,91,23686,23686,0,157.42211
17/03/2020 10:48,2019,1,WESTERN EUROPE-EU,DENMARK,2,MANCHESTER,COPENHAGEN,328023,327898,125,340293,340293,0,-3.60572
17/03/2020 10:48,2019,1,WESTERN EUROPE-EU,DENMARK,2,NEWCASTLE,COPENHAGEN,431,431,0,374,374,0,15.24064
17/03/2020 10:48,2019,1,WESTERN EUROPE-EU,DENMARK,2,NEWCASTLE,ESBJERG,0,0,0,295,0,295,-100
17/03/2020 10:48,2019,1,WESTERN EUROPE-EU,DENMARK,2,NEWQUAY,COPENHAGEN,2521,2521,0,0,0,0,0
17/03/2020 10:48,2019,1,WESTERN EUROPE-EU,DENMARK,2,SUMBURGH,AALBORG,0,0,0,177,0,177,-100
17/03/2020 10:48,2019,1,WESTERN EUROPE-EU,DENMARK,2,SUMBURGH,BILLUND,0,0,0,143,0,143,-100
17/03/2020 10:48,2019,1,WESTERN EUROPE-EU,DENMARK,2,SUMBURGH,KARUP,0,0,0,51,0,51,-100
17/03/2020 10:48,2019,1,WESTERN EUROPE-EU,DENMARK,2,TEESSIDE INTERNATIONAL AIRPORT,KARUP,84,0,84,0,0,0,0
17/03/2020 10:48,2019,1,WESTERN EUROPE-EU,FINLAND,1,GATWICK,ENONTEKIO,2979,0,2979,3676,0,3676,-18.96083
17/03/2020 10:48,2019,1,WESTERN EUROPE-EU,FINLAND,1,GATWICK,HELSINKI,228891,228891,0,230541,230541,0,-0.71571
17/03/2020 10:48,2019,1,WESTERN EUROPE-EU,FINLAND,1,GATWICK,IVALO,13723,6608,7115,15817,6035,9782,-13.23892
17/03/2020 10:48,2019,1,WESTERN EUROPE-EU,FINLAND,1,GATWICK,KITTILA,22153,2657,19496,23486,4828,18658,-5.67572
17/03/2020 10:48,2019,1,WESTERN EUROPE-EU,FINLAND,1,GATWICK,KUUSAMO,5861,0,5861,5708,0,5708,2.68045
17/03/2020 10:48,2019,1,WESTERN EUROPE-EU,FINLAND,1,GATWICK,ROVANIEMI,41057,29891,11166,39418,27792,11626,4.158
17/03/2020 10:48,2019,1,WESTERN EUROPE-EU,FINLAND,1,HEATHROW,HELSINKI,817869,817869,0,774505,774505,0,5.59893
17/03/2020 10:48,2019,1,WESTERN EUROPE-EU,FINLAND,1,LUTON,IVALO,722,0,722,1337,715,622,-45.9985
17/03/2020 10:48,2019,1,WESTERN EUROPE-EU,FINLAND,1,LUTON,TURKU,11349,11349,0,0,0,0,0
17/03/2020 10:48,2019,1,WESTERN EUROPE-EU,FINLAND,1,STANSTED,ENONTEKIO,3313,0,3313,1454,0,1454,127.8542
17/03/2020 10:48,2019,1,WESTERN EUROPE-EU,FINLAND,1,STANSTED,IVALO,2348,0,2348,2016,0,2016,16.46825
17/03/2020 10:48,2019,1,WESTERN EUROPE-EU,FINLAND,1,STANSTED,KITTILA,375,0,375,964,0,964,-61.09959
17/03/2020 10:48,2019,1,WESTERN EUROPE-EU,FINLAND,1,STANSTED,ROVANIEMI,377,0,377,362,0,362,4.14365
17/03/2020 10:48,2019,1,WESTERN EUROPE-EU,FINLAND,2,ABERDEEN,ENONTEKIO,743,0,743,748,0,748,-0.66845
17/03/2020 10:48,2019,1,WESTERN EUROPE-EU,FINLAND,2,ABERDEEN,IVALO,252,0,252,270,0,270,-6.66667
17/03/2020 10:48,2019,1,WESTERN EUROPE-EU,FINLAND,2,ABERDEEN,ROVANIEMI,156,0,156,0,0,0,0
17/03/2020 10:48,2019,1,WESTERN EUROPE-EU,FINLAND,2,BELFAST INTERNATIONAL,ENONTEKIO,810,0,810,370,0,370,118.91892
17/03/2020 10:48,2019,1,WESTERN EUROPE-EU,FINLAND,2,BELFAST INTERNATIONAL,IVALO,402,0,402,360,0,360,11.66667
17/03/2020 10:48,2019,1,WESTERN EUROPE-EU,FINLAND,2,BELFAST INTERNATIONAL,ROVANIEMI,0,0,0,1728,0,1728,-100
17/03/2020 10:48,2019,1,WESTERN EUROPE-EU,FINLAND,2,BIGGIN HILL,HELSINKI,12,0,12,0,0,0,0
17/03/2020 10:48,2019,1,WESTERN EUROPE-EU,FINLAND,2,BIGGIN HILL,TURKU,7,0,7,0,0,0,0
17/03/2020 10:48,2019,1,WESTERN EUROPE-EU,FINLAND,2,BIRMINGHAM,ENONTEKIO,2434,0,2434,2643,0,2643,-7.90768
17/03/2020 10:48,2019,1,WESTERN EUROPE-EU,FINLAND,2,BIRMINGHAM,IVALO,3711,0,3711,5429,0,5429,-31.64487
17/03/2020 10:48,2019,1,WESTERN EUROPE-EU,FINLAND,2,BIRMINGHAM,KITTILA,626,0,626,442,0,442,41.62896
17/03/2020 10:48,2019,1,WESTERN EUROPE-EU,FINLAND,2,BIRMINGHAM,KUUSAMO,2348,0,2348,727,0,727,222.97111
17/03/2020 10:48,2019,1,WESTERN EUROPE-EU,FINLAND,2,BIRMINGHAM,ROVANIEMI,4073,0,4073,6105,1992,4113,-33.28419
17/03/2020 10:48,2019,1,WESTERN EUROPE-EU,FINLAND,2,BOURNEMOUTH,ENONTEKIO,726,0,726,956,0,956,-24.05858
17/03/2020 10:48,2019,1,WESTERN EUROPE-EU,FINLAND,2,BOURNEMOUTH,IVALO,820,0,820,598,0,598,37.12375
17/03/2020 10:48,2019,1,WESTERN EUROPE-EU,FINLAND,2,BOURNEMOUTH,KITTILA,378,0,378,371,0,371,1.88679
17/03/2020 10:48,2019,1,WESTERN EUROPE-EU,FINLAND,2,BRISTOL,ENONTEKIO,2069,0,2069,1730,171,1559,19.59538
17/03/2020 10:48,2019,1,WESTERN EUROPE-EU,FINLAND,2,BRISTOL,IVALO,960,0,960,1250,0,1250,-23.2
17/03/2020 10:48,2019,1,WESTERN EUROPE-EU,FINLAND,2,BRISTOL,KITTILA,9292,1293,7999,10601,0,10601,-12.34789
17/03/2020 10:48,2019,1,WESTERN EUROPE-EU,FINLAND,2,BRISTOL,ROVANIEMI,742,0,742,1620,0,1620,-54.19753
17/03/2020 10:48,2019,1,WESTERN EUROPE-EU,FINLAND,2,CARDIFF WALES,ENONTEKIO,378,0,378,375,0,375,0.8
17/03/2020 10:48,2019,1,WESTERN EUROPE-EU,FINLAND,2,CARDIFF WALES,IVALO,354,0,354,512,0,512,-30.85938
17/03/2020 10:48,2019,1,WESTERN EUROPE-EU,FINLAND,2,DONCASTER SHEFFIELD,ENONTEKIO,1377,0,1377,1352,0,1352,1.84911
17/03/2020 10:48,2019,1,WESTERN EUROPE-EU,FINLAND,2,DONCASTER SHEFFIELD,KITTILA,2471,0,2471,2290,0,2290,7.90393
17/03/2020 10:48,2019,1,WESTERN EUROPE-EU,FINLAND,2,EAST MIDLANDS INTERNATIONAL,ENONTEKIO,1214,0,1214,1595,0,1595,-23.88715
17/03/2020 10:48,2019,1,WESTERN EUROPE-EU,FINLAND,2,EAST MIDLANDS INTERNATIONAL,IVALO,1109,0,1109,965,0,965,14.92228
17/03/2020 10:48,2019,1,WESTERN EUROPE-EU,FINLAND,2,EAST MIDLANDS INTERNATIONAL,KITTILA,3222,0,3222,4449,439,4010,-27.57923
17/03/2020 10:48,2019,1,WESTERN EUROPE-EU,FINLAND,2,EAST MIDLANDS INTERNATIONAL,ROVANIEMI,308,0,308,2477,1736,741,-87.5656
17/03/2020 10:48,2019,1,WESTERN EUROPE-EU,FINLAND,2,EDINBURGH,ENONTEKIO,758,0,758,732,0,732,3.55191
17/03/2020 10:48,2019,1,WESTERN EUROPE-EU,FINLAND,2,EDINBURGH,HELSINKI,60531,60531,0,46775,46552,223,29.40887
17/03/2020 10:48,2019,1,WESTERN EUROPE-EU,FINLAND,2,EDINBURGH,IVALO,396,0,396,342,0,342,15.78947
17/03/2020 10:48,2019,1,WESTERN EUROPE-EU,FINLAND,2,EDINBURGH,KITTILA,378,0,378,376,0,376,0.53191
17/03/2020 10:48,2019,1,WESTERN EUROPE-EU,FINLAND,2,EXETER,ENONTEKIO,558,0,558,374,0,374,49.19786
17/03/2020 10:48,2019,1,WESTERN EUROPE-EU,FINLAND,2,EXETER,IVALO,358,0,358,359,0,359,-0.27855
17/03/2020 10:48,2019,1,WESTERN EUROPE-EU,FINLAND,2,EXETER,ROVANIEMI,366,0,366,138,0,138,165.21739
17/03/2020 10:48,2019,1,WESTERN EUROPE-EU,FINLAND,2,GLASGOW,ENONTEKIO,1305,0,1305,1229,359,870,6.18389
17/03/2020 10:48,2019,1,WESTERN EUROPE-EU,FINLAND,2,GLASGOW,IVALO,694,0,694,713,713,0,-2.6648
17/03/2020 10:48,2019,1,WESTERN EUROPE-EU,FINLAND,2,GLASGOW,KITTILA,0,0,0,411,0,411,-100
17/03/2020 10:48,2019,1,WESTERN EUROPE-EU,FINLAND,2,GLASGOW,ROVANIEMI,2734,0,2734,3287,430,2857,-16.82385
17/03/2020 10:48,2019,1,WESTERN EUROPE-EU,FINLAND,2,HUMBERSIDE,ENONTEKIO,1083,0,1083,836,0,836,29.54545
17/03/2020 10:48,2019,1,WESTERN EUROPE-EU,FINLAND,2,HUMBERSIDE,IVALO,338,0,338,356,0,356,-5.05618
17/03/2020 10:48,2019,1,WESTERN EUROPE-EU,FINLAND,2,LEEDS BRADFORD,ENONTEKIO,2067,0,2067,894,0,894,131.20805
17/03/2020 10:48,2019,1,WESTERN EUROPE-EU,FINLAND,2,LEEDS BRADFORD,IVALO,1089,0,1089,1065,0,1065,2.25352
17/03/2020 10:48,2019,1,WESTERN EUROPE-EU,FINLAND,2,LIVERPOOL (JOHN LENNON),ENONTEKIO,746,0,746,375,0,375,98.93333
17/03/2020 10:48,2019,1,WESTERN EUROPE-EU,FINLAND,2,LIVERPOOL (JOHN LENNON),IVALO,814,0,814,936,0,936,-13.03419
17/03/2020 10:48,2019,1,WESTERN EUROPE-EU,FINLAND,2,MANCHESTER,ENONTEKIO,3872,0,3872,3835,0,3835,0.9648
17/03/2020 10:48,2019,1,WESTERN EUROPE-EU,FINLAND,2,MANCHESTER,HELSINKI,170640,170640,0,145975,145975,0,16.89673
17/03/2020 10:48,2019,1,WESTERN EUROPE-EU,FINLAND,2,MANCHESTER,IVALO,7674,0,7674,8750,0,8750,-12.29714
17/03/2020 10:48,2019,1,WESTERN EUROPE-EU,FINLAND,2,MANCHESTER,KITTILA,17848,0,17848,18449,1721,16728,-3.25763
17/03/2020 10:48,2019,1,WESTERN EUROPE-EU,FINLAND,2,MANCHESTER,KUUSAMO,5636,0,5636,5724,0,5724,-1.53739
17/03/2020 10:48,2019,1,WESTERN EUROPE-EU,FINLAND,2,MANCHESTER,ROVANIEMI,10451,3958,6493,12311,5998,6313,-15.10844
17/03/2020 10:48,2019,1,WESTERN EUROPE-EU,FINLAND,2,NEWCASTLE,ENONTEKIO,1243,1117,126,373,315,58,233.24397
17/03/2020 10:48,2019,1,WESTERN EUROPE-EU,FINLAND,2,NEWCASTLE,IVALO,702,702,0,624,624,0,12.5
17/03/2020 10:48,2019,1,WESTERN EUROPE-EU,FINLAND,2,NEWCASTLE,KITTILA,2674,2674,0,2879,2879,0,-7.12053
17/03/2020 10:48,2019,1,WESTERN EUROPE-EU,FINLAND,2,NEWCASTLE,ROVANIEMI,372,372,0,1236,1236,0,-69.90291
17/03/2020 10:48,2019,1,WESTERN EUROPE-EU,FINLAND,2,NORWICH,ENONTEKIO,372,0,372,0,0,0,0
17/03/2020 10:48,2019,1,WESTERN EUROPE-EU,FINLAND,2,NORWICH,IVALO,360,0,360,356,0,356,1.1236
17/03/2020 10:48,2019,1,WESTERN EUROPE-EU,FINLAND,2,PRESTWICK,ROVANIEMI,346,0,346,0,0,0,0
17/03/2020 10:48,2019,1,WESTERN EUROPE-EU,FINLAND,2,TEESSIDE INTERNATIONAL AIRPORT,ENONTEKIO,377,0,377,374,0,374,0.80214
17/03/2020 10:48,2019,1,WESTERN EUROPE-EU,FRANCE,1,GATWICK,AJACCIO,3443,3443,0,6418,6418,0,-46.354
17/03/2020 10:48,2019,1,WESTERN EUROPE-EU,FRANCE,1,GATWICK,BASTIA,6750,6750,0,10653,10653,0,-36.63757
17/03/2020 10:48,2019,1,WESTERN EUROPE-EU,FRANCE,1,GATWICK,BIARRITZ,23492,23492,0,29728,29728,0,-20.97686
17/03/2020 10:48,2019,1,WESTERN EUROPE-EU,FRANCE,1,GATWICK,BORDEAUX,325293,325293,0,311909,311858,51,4.291
17/03/2020 10:48,2019,1,WESTERN EUROPE-EU,FRANCE,1,GATWICK,CHAMBERY,48899,0,48899,46837,186,46651,4.4025
17/03/2020 10:48,2019,1,WESTERN EUROPE-EU,FRANCE,1,GATWICK,FIGARI,6162,6162,0,7704,7704,0,-20.01558
17/03/2020 10:48,2019,1,WESTERN EUROPE-EU,FRANCE,1,GATWICK,GRENOBLE,111622,42822,68800,129111,43165,85946,-13.54571
17/03/2020 10:48,2019,1,WESTERN EUROPE-EU,FRANCE,1,GATWICK,LA ROCHELLE,23253,23253,0,28868,28868,0,-19.4506
17/03/2020 10:48,2019,1,WESTERN EUROPE-EU,FRANCE,1,GATWICK,LILLE,164,0,164,0,0,0,0
17/03/2020 10:48,2019,1,WESTERN EUROPE-EU,FRANCE,1,GATWICK,LIMOGES,13199,13199,0,11695,11695,0,12.8602
17/03/2020 10:48,2019,1,WESTERN EUROPE-EU,FRANCE,1,GATWICK,LYON,247110,228667,18443,227985,212654,15331,8.38871
17/03/2020 10:48,2019,1,WESTERN EUROPE-EU,FRANCE,1,GATWICK,MARSEILLE,154318,154218,100,149228,148880,348,3.41089
17/03/2020 10:48,2019,1,WESTERN EUROPE-EU,FRANCE,1,GATWICK,MONTPELLIER,142629,142478,151,145756,145756,0,-2.14537
17/03/2020 10:48,2019,1,WESTERN EUROPE-EU,FRANCE,1,GATWICK,NANTES,164566,164566,0,167694,167656,38,-1.8653
17/03/2020 10:48,2019,1,WESTERN EUROPE-EU,FRANCE,1,GATWICK,NICE,620607,617704,2903,620834,619189,1645,-0.03656
17/03/2020 10:48,2019,1,WESTERN EUROPE-EU,FRANCE,1,GATWICK,PARIS (CHARLES DE GAULLE),580354,580354,0,486072,486072,0,19.39671
17/03/2020 10:48,2019,1,WESTERN EUROPE-EU,FRANCE,1,GATWICK,PARIS (ORLY),0,0,0,105,105,0,-100
17/03/2020 10:48,2019,1,WESTERN EUROPE-EU,FRANCE,1,GATWICK,PAU,718,718,0,0,0,0,0
17/03/2020 10:48,2019,1,WESTERN EUROPE-EU,FRANCE,1,GATWICK,RENNES,182,0,182,782,782,0,-76.72634
17/03/2020 10:48,2019,1,WESTERN EUROPE-EU,FRANCE,1,GATWICK,TOULON / HYERES,78,0,78,0,0,0,0
17/03/2020 10:48,2019,1,WESTERN EUROPE-EU,FRANCE,1,GATWICK,TOULOUSE (BLAGNAC),230131,224137,5994,271680,265592,6088,-15.29336
17/03/2020 10:48,2019,1,WESTERN EUROPE-EU,FRANCE,1,HEATHROW,BASTIA,4711,4711,0,4385,0,4385,7.43444
17/03/2020 10:48,2019,1,WESTERN EUROPE-EU,FRANCE,1,HEATHROW,FIGARI,4307,4307,0,8858,4134,4724,-51.37729
17/03/2020 10:48,2019,1,WESTERN EUROPE-EU,FRANCE,1,HEATHROW,GRENOBLE,3779,3779,0,8156,4209,3947,-53.66601
17/03/2020 10:48,2019,1,WESTERN EUROPE-EU,FRANCE,1,HEATHROW,LYON,273848,273848,0,267813,267813,0,2.25344
17/03/2020 10:48,2019,1,WESTERN EUROPE-EU,FRANCE,1,HEATHROW,MARSEILLE,293354,293354,0,263324,263324,0,11.4042
17/03/2020 10:48,2019,1,WESTERN EUROPE-EU,FRANCE,1,HEATHROW,MONTPELLIER,9157,9157,0,0,0,0,0
17/03/2020 10:48,2019,1,WESTERN EUROPE-EU,FRANCE,1,HEATHROW,NANTES,14404,14404,0,9153,9153,0,57.36917
17/03/2020 10:48,2019,1,WESTERN EUROPE-EU,FRANCE,1,HEATHROW,NICE,511494,511494,0,553540,553540,0,-7.59584
17/03/2020 10:48,2019,1,WESTERN EUROPE-EU,FRANCE,1,HEATHROW,PARIS (CHARLES DE GAULLE),1260985,1260985,0,1250771,1250771,0,0.81662
17/03/2020 10:48,2019,1,WESTERN EUROPE-EU,FRANCE,1,HEATHROW,PARIS (ORLY),0,0,0,176,176,0,-100
17/03/2020 10:48,2019,1,WESTERN EUROPE-EU,FRANCE,1,HEATHROW,TOULOUSE (BLAGNAC),269462,269462,0,249444,249444,0,8.02505
17/03/2020 10:48,2019,1,WESTERN EUROPE-EU,FRANCE,1,LONDON CITY,BERGERAC,9747,9747,0,10015,10015,0,-2.67599
17/03/2020 10:48,2019,1,WESTERN EUROPE-EU,FRANCE,1,LONDON CITY,CHAMBERY,4838,4838,0,5382,5382,0,-10.10777
17/03/2020 10:48,2019,1,WESTERN EUROPE-EU,FRANCE,1,LONDON CITY,DINARD,135,0,135,159,0,159,-15.09434
17/03/2020 10:48,2019,1,WESTERN EUROPE-EU,FRANCE,1,LONDON CITY,NICE,40136,40136,0,39797,39797,0,0.85182
17/03/2020 10:48,2019,1,WESTERN EUROPE-EU,FRANCE,1,LONDON CITY,PARIS (ORLY),41221,41221,0,95447,95447,0,-56.81268
17/03/2020 10:48,2019,1,WESTERN EUROPE-EU,FRANCE,1,LONDON CITY,QUIMPER,6014,6014,0,6846,6846,0,-12.15308
17/03/2020 10:48,2019,1,WESTERN EUROPE-EU,FRANCE,1,LONDON CITY,RENNES,2726,2726,0,2590,2590,0,5.25097
17/03/2020 10:48,2019,1,WESTERN EUROPE-EU,FRANCE,1,LUTON,BEZIERS,39403,39403,0,40534,40534,0,-2.79025
17/03/2020 10:48,2019,1,WESTERN EUROPE-EU,FRANCE,1,LUTON,BIARRITZ,4811,4811,0,5101,5101,0,-5.68516
17/03/2020 10:48,2019,1,WESTERN EUROPE-EU,FRANCE,1,LUTON,BORDEAUX,89542,89542,0,89352,89352,0,0.21264
17/03/2020 10:48,2019,1,WESTERN EUROPE-EU,FRANCE,1,LUTON,CHAMBERY,2625,0,2625,4320,0,4320,-39.23611
17/03/2020 10:48,2019,1,WESTERN EUROPE-EU,FRANCE,1,LUTON,GRENOBLE,16335,15897,438,10969,10685,284,48.91968
17/03/2020 10:48,2019,1,WESTERN EUROPE-EU,FRANCE,1,LUTON,LA ROCHELLE,168,168,0,92,92,0,82.6087
17/03/2020 10:48,2019,1,WESTERN EUROPE-EU,FRANCE,1,LUTON,LYON,104615,104238,377,96452,96159,293,8.46328
17/03/2020 10:48,2019,1,WESTERN EUROPE-EU,FRANCE,1,LUTON,MARSEILLE,43789,43789,0,43327,43327,0,1.06631
17/03/2020 10:48,2019,1,WESTERN EUROPE-EU,FRANCE,1,LUTON,MONTPELLIER,11461,11461,0,11595,11595,0,-1.15567
17/03/2020 10:48,2019,1,WESTERN EUROPE-EU,FRANCE,1,LUTON,NANTES,49380,49380,0,51757,51757,0,-4.59262
17/03/2020 10:48,2019,1,WESTERN EUROPE-EU,FRANCE,1,LUTON,NICE,165727,164990,737,168171,167440,731,-1.45328
17/03/2020 10:48,2019,1,WESTERN EUROPE-EU,FRANCE,1,LUTON,NIMES,25947,25947,0,35318,35318,0,-26.53321
17/03/2020 10:48,2019,1,WESTERN EUROPE-EU,FRANCE,1,LUTON,PARIS (CHARLES DE GAULLE),286380,286380,0,291331,291331,0,-1.69944
17/03/2020 10:48,2019,1,WESTERN EUROPE-EU,FRANCE,1,LUTON,PARIS (ORLY),1284,0,1284,0,0,0,0
17/03/2020 10:48,2019,1,WESTERN EUROPE-EU,FRANCE,1,LUTON,PAU,193,193,0,0,0,0,0
17/03/2020 10:48,2019,1,WESTERN EUROPE-EU,FRANCE,1,LUTON,PERPIGNAN,0,0,0,579,152,427,-100
17/03/2020 10:48,2019,1,WESTERN EUROPE-EU,FRANCE,1,LUTON,RENNES,146,0,146,0,0,0,0
17/03/2020 10:48,2019,1,WESTERN EUROPE-EU,FRANCE,1,LUTON,TARBES-LOURDES INTERNATIONAL,0,0,0,278,0,278,-100
17/03/2020 10:48,2019,1,WESTERN EUROPE-EU,FRANCE,1,LUTON,TOULOUSE (BLAGNAC),49742,49742,0,55351,55351,0,-10.13351
17/03/2020 10:48,2019,1,WESTERN EUROPE-EU,FRANCE,1,SOUTHEND,BORDEAUX,18367,18367,0,8256,8256,0,122.46851
17/03/2020 10:48,2019,1,WESTERN EUROPE-EU,FRANCE,1,SOUTHEND,BREST,20268,20268,0,0,0,0,0
17/03/2020 10:48,2019,1,WESTERN EUROPE-EU,FRANCE,1,SOUTHEND,CAEN,17530,17530,0,13420,13420,0,30.62593
17/03/2020 10:48,2019,1,WESTERN EUROPE-EU,FRANCE,1,SOUTHEND,CHATEAUROUX DEOLS,0,0,0,1022,1022,0,-100
17/03/2020 10:48,2019,1,WESTERN EUROPE-EU,FRANCE,1,SOUTHEND,LYON,6312,6312,0,31409,31409,0,-79.90385
17/03/2020 10:48,2019,1,WESTERN EUROPE-EU,FRANCE,1,SOUTHEND,PARIS (CHARLES DE GAULLE),54556,54556,0,51862,51862,0,5.19455
17/03/2020 10:48,2019,1,WESTERN EUROPE-EU,FRANCE,1,SOUTHEND,PARIS (ORLY),0,0,0,44,44,0,-100
17/03/2020 10:48,2019,1,WESTERN EUROPE-EU,FRANCE,1,SOUTHEND,RENNES,42727,42727,0,46046,46046,0,-7.20801
17/03/2020 10:48,2019,1,WESTERN EUROPE-EU,FRANCE,1,SOUTHEND,TARBES-LOURDES INTERNATIONAL,1421,1421,0,0,0,0,0
17/03/2020 10:48,2019,1,WESTERN EUROPE-EU,FRANCE,1,STANSTED,AJACCIO,16748,16748,0,20232,20232,0,-17.22025
17/03/2020 10:48,2019,1,WESTERN EUROPE-EU,FRANCE,1,STANSTED,BASTIA,18400,18400,0,20860,20860,0,-11.79291
17/03/2020 10:48,2019,1,WESTERN EUROPE-EU,FRANCE,1,STANSTED,BERGERAC,93297,93297,0,92068,92068,0,1.33488
17/03/2020 10:48,2019,1,WESTERN EUROPE-EU,FRANCE,1,STANSTED,BEZIERS,28245,28245,0,28922,28922,0,-2.34078
17/03/2020 10:48,2019,1,WESTERN EUROPE-EU,FRANCE,1,STANSTED,BIARRITZ,105069,105069,0,107321,107321,0,-2.09838
17/03/2020 10:48,2019,1,WESTERN EUROPE-EU,FRANCE,1,STANSTED,BORDEAUX,97419,97419,0,94623,94623,0,2.95488
17/03/2020 10:48,2019,1,WESTERN EUROPE-EU,FRANCE,1,STANSTED,BREST,169,169,0,193,193,0,-12.43523
17/03/2020 10:48,2019,1,WESTERN EUROPE-EU,FRANCE,1,STANSTED,BRIVE-LA-GAILLARDE,17122,17122,0,17833,17833,0,-3.98699
17/03/2020 10:48,2019,1,WESTERN EUROPE-EU,FRANCE,1,STANSTED,CALVI,6656,6656,0,3471,0,3471,91.7603
17/03/2020 10:48,2019,1,WESTERN EUROPE-EU,FRANCE,1,STANSTED,CARCASSONNE,85823,85823,0,89186,89186,0,-3.77077
17/03/2020 10:48,2019,1,WESTERN EUROPE-EU,FRANCE,1,STANSTED,CHAMBERY,18257,5202,13055,20513,5309,15204,-10.9979
17/03/2020 10:48,2019,1,WESTERN EUROPE-EU,FRANCE,1,STANSTED,CLERMONT FERRAND,20020,20020,0,20208,20208,0,-0.93032
17/03/2020 10:48,2019,1,WESTERN EUROPE-EU,FRANCE,1,STANSTED,DINARD,77815,77815,0,76245,76245,0,2.05915
17/03/2020 10:48,2019,1,WESTERN EUROPE-EU,FRANCE,1,STANSTED,DOLE,2768,2768,0,703,703,0,293.74111
17/03/2020 10:48,2019,1,WESTERN EUROPE-EU,FRANCE,1,STANSTED,FIGARI,7772,7772,0,5857,5857,0,32.69592
17/03/2020 10:48,2019,1,WESTERN EUROPE-EU,FRANCE,1,STANSTED,GRENOBLE,32717,30357,2360,53467,52071,1396,-38.80898
17/03/2020 10:48,2019,1,WESTERN EUROPE-EU,FRANCE,1,STANSTED,LA ROCHELLE,55325,55325,0,62254,62254,0,-11.13021
17/03/2020 10:48,2019,1,WESTERN EUROPE-EU,FRANCE,1,STANSTED,LIMOGES,101735,101735,0,99761,99761,0,1.97873
17/03/2020 10:48,2019,1,WESTERN EUROPE-EU,FRANCE,1,STANSTED,LYON,10832,9938,894,8041,6159,1882,34.70961
17/03/2020 10:48,2019,1,WESTERN EUROPE-EU,FRANCE,1,STANSTED,MARSEILLE,168675,168675,0,158505,158505,0,6.4162
17/03/2020 10:48,2019,1,WESTERN EUROPE-EU,FRANCE,1,STANSTED,MONTPELLIER,88,88,0,0,0,0,0
17/03/2020 10:48,2019,1,WESTERN EUROPE-EU,FRANCE,1,STANSTED,NANTES,74068,74068,0,14946,14946,0,395.57072
17/03/2020 10:48,2019,1,WESTERN EUROPE-EU,FRANCE,1,STANSTED,NICE,186784,186784,0,223418,223418,0,-16.39707
17/03/2020 10:48,2019,1,WESTERN EUROPE-EU,FRANCE,1,STANSTED,NIMES,39857,39857,0,44731,44731,0,-10.89625
17/03/2020 10:48,2019,1,WESTERN EUROPE-EU,FRANCE,1,STANSTED,PARIS (CHARLES DE GAULLE),39685,39685,0,0,0,0,0
17/03/2020 10:48,2019,1,WESTERN EUROPE-EU,FRANCE,1,STANSTED,PARIS (ORLY),150,150,0,257,257,0,-41.63424
17/03/2020 10:48,2019,1,WESTERN EUROPE-EU,FRANCE,1,STANSTED,PAU,367,367,0,167,167,0,119.76048
17/03/2020 10:48,2019,1,WESTERN EUROPE-EU,FRANCE,1,STANSTED,PERPIGNAN,45858,45858,0,48240,48240,0,-4.93781
17/03/2020 10:48,2019,1,WESTERN EUROPE-EU,FRANCE,1,STANSTED,POITIERS,55874,55874,0,56925,56925,0,-1.84629
17/03/2020 10:48,2019,1,WESTERN EUROPE-EU,FRANCE,1,STANSTED,RENNES,564,189,375,180,180,0,213.33333
17/03/2020 10:48,2019,1,WESTERN EUROPE-EU,FRANCE,1,STANSTED,RODEZ,9765,9765,0,0,0,0,0
17/03/2020 10:48,2019,1,WESTERN EUROPE-EU,FRANCE,1,STANSTED,STRASBOURG,18423,18423,0,18618,18618,0,-1.04737
17/03/2020 10:48,2019,1,WESTERN EUROPE-EU,FRANCE,1,STANSTED,TARBES-LOURDES INTERNATIONAL,60108,55237,4871,63057,55625,7432,-4.67672
17/03/2020 10:48,2019,1,WESTERN EUROPE-EU,FRANCE,1,STANSTED,TOULON / HYERES,294,0,294,245,0,245,20
17/03/2020 10:48,2019,1,WESTERN EUROPE-EU,FRANCE,1,STANSTED,TOULOUSE (BLAGNAC),211212,210844,368,201713,201713,0,4.70917
17/03/2020 10:48,2019,1,WESTERN EUROPE-EU,FRANCE,1,STANSTED,TOURS,50608,50608,0,50037,50037,0,1.14116
17/03/2020 10:48,2019,1,WESTERN EUROPE-EU,FRANCE,2,ABERDEEN,BIARRITZ,118,0,118,0,0,0,0
17/03/2020 10:48,2019,1,WESTERN EUROPE-EU,FRANCE,2,ABERDEEN,PARIS (CHARLES DE GAULLE),91680,91680,0,90518,90455,63,1.28372
17/03/2020 10:48,2019,1,WESTERN EUROPE-EU,FRANCE,2,BELFAST CITY (GEORGE BEST),PARIS (CHARLES DE GAULLE),125,125,0,0,0,0,0
17/03/2020 10:48,2019,1,WESTERN EUROPE-EU,FRANCE,2,BELFAST INTERNATIONAL,BORDEAUX,13609,13609,0,12469,12469,0,9.14267
17/03/2020 10:48,2019,1,WESTERN EUROPE-EU,FRANCE,2,BELFAST INTERNATIONAL,CLERMONT FERRAND,84,0,84,0,0,0,0
17/03/2020 10:48,2019,1,WESTERN EUROPE-EU,FRANCE,2,BELFAST INTERNATIONAL,LA ROCHELLE,0,0,0,292,0,292,-100
17/03/2020 10:48,2019,1,WESTERN EUROPE-EU,FRANCE,2,BELFAST INTERNATIONAL,LYON,3721,3721,0,4422,4422,0,-15.85256
17/03/2020 10:48,2019,1,WESTERN EUROPE-EU,FRANCE,2,BELFAST INTERNATIONAL,NICE,21497,21497,0,20133,20133,0,6.77495
17/03/2020 10:48,2019,1,WESTERN EUROPE-EU,FRANCE,2,BELFAST INTERNATIONAL,PARIS (CHARLES DE GAULLE),89835,89548,287,89175,88943,232,0.74012
17/03/2020 10:48,2019,1,WESTERN EUROPE-EU,FRANCE,2,BELFAST INTERNATIONAL,TARBES-LOURDES INTERNATIONAL,6050,0,6050,6218,0,6218,-2.70183
17/03/2020 10:48,2019,1,WESTERN EUROPE-EU,FRANCE,2,BIGGIN HILL,AVIGNON,13,0,13,0,0,0,0
17/03/2020 10:48,2019,1,WESTERN EUROPE-EU,FRANCE,2,BIGGIN HILL,BERGERAC,0,0,0,7,0,7,-100
17/03/2020 10:48,2019,1,WESTERN EUROPE-EU,FRANCE,2,BIGGIN HILL,BIARRITZ,3,0,3,0,0,0,0
17/03/2020 10:48,2019,1,WESTERN EUROPE-EU,FRANCE,2,BIGGIN HILL,BORDEAUX,9,0,9,0,0,0,0
17/03/2020 10:48,2019,1,WESTERN EUROPE-EU,FRANCE,2,BIGGIN HILL,CANNES,15,0,15,46,0,46,-67.3913
17/03/2020 10:48,2019,1,WESTERN EUROPE-EU,FRANCE,2,BIGGIN HILL,CHAMBERY,39,0,39,33,0,33,18.18182
17/03/2020 10:48,2019,1,WESTERN EUROPE-EU,FRANCE,2,BIGGIN HILL,GRENOBLE,0,0,0,10,0,10,-100
17/03/2020 10:48,2019,1,WESTERN EUROPE-EU,FRANCE,2,BIGGIN HILL,LE TOUQUET,0,0,0,60,0,60,-100
17/03/2020 10:48,2019,1,WESTERN EUROPE-EU,FRANCE,2,BIGGIN HILL,LYON(BRON),0,0,0,4,0,4,-100
17/03/2020 10:48,2019,1,WESTERN EUROPE-EU,FRANCE,2,BIGGIN HILL,NANTES,0,0,0,48,0,48,-100
17/03/2020 10:48,2019,1,WESTERN EUROPE-EU,FRANCE,2,BIGGIN HILL,NICE,102,0,102,119,0,119,-14.28571
17/03/2020 10:48,2019,1,WESTERN EUROPE-EU,FRANCE,2,BIGGIN HILL,PARIS (LE BOURGET),12,0,12,57,0,57,-78.94737
17/03/2020 10:48,2019,1,WESTERN EUROPE-EU,FRANCE,2,BIGGIN HILL,TOULON / HYERES,26,0,26,3,0,3,766.66667
17/03/2020 10:48,2019,1,WESTERN EUROPE-EU,FRANCE,2,BIGGIN HILL,TOULOUSE (BLAGNAC),2,0,2,66,0,66,-96.9697
17/03/2020 10:48,2019,1,WESTERN EUROPE-EU,FRANCE,2,BIRMINGHAM,AVIGNON,1735,1735,0,2628,2628,0,-33.98021
17/03/2020 10:48,2019,1,WESTERN EUROPE-EU,FRANCE,2,BIRMINGHAM,BASTIA,1873,1873,0,1852,1852,0,1.13391
17/03/2020 10:48,2019,1,WESTERN EUROPE-EU,FRANCE,2,BIRMINGHAM,BERGERAC,17976,17976,0,16127,16127,0,11.46524
17/03/2020 10:48,2019,1,WESTERN EUROPE-EU,FRANCE,2,BIRMINGHAM,BIARRITZ,4783,4783,0,5477,5477,0,-12.67117
17/03/2020 10:48,2019,1,WESTERN EUROPE-EU,FRANCE,2,BIRMINGHAM,BORDEAUX,16855,16561,294,19072,19072,0,-11.62437
17/03/2020 10:48,2019,1,WESTERN EUROPE-EU,FRANCE,2,BIRMINGHAM,BREST,1144,1144,0,1237,1237,0,-7.51819
17/03/2020 10:48,2019,1,WESTERN EUROPE-EU,FRANCE,2,BIRMINGHAM,CARCASSONNE,0,0,0,111,111,0,-100
17/03/2020 10:48,2019,1,WESTERN EUROPE-EU,FRANCE,2,BIRMINGHAM,CHAMBERY,12932,2913,10019,16104,2984,13120,-19.69697
17/03/2020 10:48,2019,1,WESTERN EUROPE-EU,FRANCE,2,BIRMINGHAM,CLERMONT FERRAND,515,0,515,0,0,0,0
17/03/2020 10:48,2019,1,WESTERN EUROPE-EU,FRANCE,2,BIRMINGHAM,FIGARI,0,0,0,38,0,38,-100
17/03/2020 10:48,2019,1,WESTERN EUROPE-EU,FRANCE,2,BIRMINGHAM,GRENOBLE,14809,10594,4215,18198,12220,5978,-18.62293
17/03/2020 10:48,2019,1,WESTERN EUROPE-EU,FRANCE,2,BIRMINGHAM,LA ROCHELLE,3439,3439,0,3867,3867,0,-11.06801
17/03/2020 10:48,2019,1,WESTERN EUROPE-EU,FRANCE,2,BIRMINGHAM,LYON,35843,35548,295,44390,44050,340,-19.25434
17/03/2020 10:48,2019,1,WESTERN EUROPE-EU,FRANCE,2,BIRMINGHAM,MARSEILLE,0,0,0,94,58,36,-100
17/03/2020 10:48,2019,1,WESTERN EUROPE-EU,FRANCE,2,BIRMINGHAM,MONTPELLIER,325,0,325,270,0,270,20.37037
17/03/2020 10:48,2019,1,WESTERN EUROPE-EU,FRANCE,2,BIRMINGHAM,NANTES,13033,13033,0,17622,17622,0,-26.04131
17/03/2020 10:48,2019,1,WESTERN EUROPE-EU,FRANCE,2,BIRMINGHAM,NICE,395,0,395,416,0,416,-5.04808
17/03/2020 10:48,2019,1,WESTERN EUROPE-EU,FRANCE,2,BIRMINGHAM,PARIS (CHARLES DE GAULLE),403416,403127,289,412305,411543,762,-2.15593
17/03/2020 10:48,2019,1,WESTERN EUROPE-EU,FRANCE,2,BIRMINGHAM,PARIS (ORLY),0,0,0,293,293,0,-100
17/03/2020 10:48,2019,1,WESTERN EUROPE-EU,FRANCE,2,BIRMINGHAM,PAU,0,0,0,90,0,90,-100
17/03/2020 10:48,2019,1,WESTERN EUROPE-EU,FRANCE,2,BIRMINGHAM,PERPIGNAN,19189,19189,0,19390,19390,0,-1.03662
17/03/2020 10:48,2019,1,WESTERN EUROPE-EU,FRANCE,2,BIRMINGHAM,RENNES,0,0,0,67,67,0,-100
17/03/2020 10:48,2019,1,WESTERN EUROPE-EU,FRANCE,2,BIRMINGHAM,TARBES-LOURDES INTERNATIONAL,1158,0,1158,1214,0,1214,-4.61285
17/03/2020 10:48,2019,1,WESTERN EUROPE-EU,FRANCE,2,BIRMINGHAM,TOULOUSE (BLAGNAC),3512,0,3512,9307,5405,3902,-62.26496
17/03/2020 10:48,2019,1,WESTERN EUROPE-EU,FRANCE,2,BOURNEMOUTH,NANTES,104,0,104,0,0,0,0
17/03/2020 10:48,2019,1,WESTERN EUROPE-EU,FRANCE,2,BOURNEMOUTH,RODEZ,0,0,0,43,43,0,-100
17/03/2020 10:48,2019,1,WESTERN EUROPE-EU,FRANCE,2,BRISTOL,BERGERAC,5981,5981,0,5921,5921,0,1.01334
17/03/2020 10:48,2019,1,WESTERN EUROPE-EU,FRANCE,2,BRISTOL,BEZIERS,28416,28416,0,29605,29605,0,-4.01621
17/03/2020 10:48,2019,1,WESTERN EUROPE-EU,FRANCE,2,BRISTOL,BIARRITZ,7247,7247,0,0,0,0,0
17/03/2020 10:48,2019,1,WESTERN EUROPE-EU,FRANCE,2,BRISTOL,BORDEAUX,68365,68365,0,58514,58514,0,16.83529
17/03/2020 10:48,2019,1,WESTERN EUROPE-EU,FRANCE,2,BRISTOL,BRIVE-LA-GAILLARDE,53,0,53,0,0,0,0
17/03/2020 10:48,2019,1,WESTERN EUROPE-EU,FRANCE,2,BRISTOL,CHAMBERY,11196,0,11196,11317,0,11317,-1.06919
17/03/2020 10:48,2019,1,WESTERN EUROPE-EU,FRANCE,2,BRISTOL,CLERMONT FERRAND,871,82,789,0,0,0,0
17/03/2020 10:48,2019,1,WESTERN EUROPE-EU,FRANCE,2,BRISTOL,GRENOBLE,14861,14408,453,12640,12467,173,17.5712
17/03/2020 10:48,2019,1,WESTERN EUROPE-EU,FRANCE,2,BRISTOL,LA ROCHELLE,6534,6534,0,6867,6615,252,-4.84928
17/03/2020 10:48,2019,1,WESTERN EUROPE-EU,FRANCE,2,BRISTOL,LIMOGES,27287,27287,0,25836,25836,0,5.61619
17/03/2020 10:48,2019,1,WESTERN EUROPE-EU,FRANCE,2,BRISTOL,LYON,14918,14765,153,5265,4794,471,183.34283
17/03/2020 10:48,2019,1,WESTERN EUROPE-EU,FRANCE,2,BRISTOL,MARSEILLE,20597,20597,0,17688,17688,0,16.44618
17/03/2020 10:48,2019,1,WESTERN EUROPE-EU,FRANCE,2,BRISTOL,MONTPELLIER,9486,9486,0,41,0,41,23036.58537
17/03/2020 10:48,2019,1,WESTERN EUROPE-EU,FRANCE,2,BRISTOL,NANTES,8866,8866,0,10637,10637,0,-16.64943
17/03/2020 10:48,2019,1,WESTERN EUROPE-EU,FRANCE,2,BRISTOL,NICE,101057,101057,0,96317,96317,0,4.92125
17/03/2020 10:48,2019,1,WESTERN EUROPE-EU,FRANCE,2,BRISTOL,PARIS (CHARLES DE GAULLE),170698,170698,0,154657,154589,68,10.37198
17/03/2020 10:48,2019,1,WESTERN EUROPE-EU,FRANCE,2,BRISTOL,TARBES-LOURDES INTERNATIONAL,468,0,468,370,0,370,26.48649
17/03/2020 10:48,2019,1,WESTERN EUROPE-EU,FRANCE,2,BRISTOL,TOULOUSE (BLAGNAC),105280,95481,9799,110419,97526,12893,-4.65409
17/03/2020 10:48,2019,1,WESTERN EUROPE-EU,FRANCE,2,CARDIFF WALES,BIARRITZ,176,0,176,0,0,0,0
17/03/2020 10:48,2019,1,WESTERN EUROPE-EU,FRANCE,2,CARDIFF WALES,BORDEAUX,0,0,0,1511,0,1511,-100
17/03/2020 10:48,2019,1,WESTERN EUROPE-EU,FRANCE,2,CARDIFF WALES,CHAMBERY,2708,2708,0,2709,2709,0,-0.03691
17/03/2020 10:48,2019,1,WESTERN EUROPE-EU,FRANCE,2,CARDIFF WALES,CLERMONT FERRAND,0,0,0,125,0,125,-100
17/03/2020 10:48,2019,1,WESTERN EUROPE-EU,FRANCE,2,CARDIFF WALES,GRENOBLE,0,0,0,918,0,918,-100
17/03/2020 10:48,2019,1,WESTERN EUROPE-EU,FRANCE,2,CARDIFF WALES,LA ROCHELLE,0,0,0,453,0,453,-100
17/03/2020 10:48,2019,1,WESTERN EUROPE-EU,FRANCE,2,CARDIFF WALES,LE HAVRE,36,0,36,0,0,0,0
17/03/2020 10:48,2019,1,WESTERN EUROPE-EU,FRANCE,2,CARDIFF WALES,LYON,78,0,78,2515,187,2328,-96.89861
17/03/2020 10:48,2019,1,WESTERN EUROPE-EU,FRANCE,2,CARDIFF WALES,LYON(BRON),0,0,0,38,0,38,-100
17/03/2020 10:48,2019,1,WESTERN EUROPE-EU,FRANCE,2,CARDIFF WALES,MARSEILLE,0,0,0,377,0,377,-100
17/03/2020 10:48,2019,1,WESTERN EUROPE-EU,FRANCE,2,CARDIFF WALES,NANTES,0,0,0,581,0,581,-100
17/03/2020 10:48,2019,1,WESTERN EUROPE-EU,FRANCE,2,CARDIFF WALES,NICE,40,0,40,0,0,0,0
17/03/2020 10:48,2019,1,WESTERN EUROPE-EU,FRANCE,2,CARDIFF WALES,PARIS (CHARLES DE GAULLE),71574,71574,0,77676,75402,2274,-7.85571
17/03/2020 10:48,2019,1,WESTERN EUROPE-EU,FRANCE,2,CARDIFF WALES,PARIS (LE BOURGET),58,0,58,81,0,81,-28.39506
17/03/2020 10:48,2019,1,WESTERN EUROPE-EU,FRANCE,2,CARDIFF WALES,PARIS (ORLY),0,0,0,819,0,819,-100
17/03/2020 10:48,2019,1,WESTERN EUROPE-EU,FRANCE,2,CARDIFF WALES,PAU,325,0,325,231,0,231,40.69264
17/03/2020 10:48,2019,1,WESTERN EUROPE-EU,FRANCE,2,CARDIFF WALES,TARBES-LOURDES INTERNATIONAL,280,0,280,460,0,460,-39.13043
17/03/2020 10:48,2019,1,WESTERN EUROPE-EU,FRANCE,2,CARDIFF WALES,TOULON / HYERES,0,0,0,208,0,208,-100
17/03/2020 10:48,2019,1,WESTERN EUROPE-EU,FRANCE,2,CARDIFF WALES,TOULOUSE (BLAGNAC),89,89,0,2141,83,2058,-95.84306
17/03/2020 10:48,2019,1,WESTERN EUROPE-EU,FRANCE,2,CARDIFF WALES,VILLACOUBLAY,84,0,84,0,0,0,0
17/03/2020 10:48,2019,1,WESTERN EUROPE-EU,FRANCE,2,CITY OF DERRY (EGLINTON),PARIS (LE BOURGET),0,0,0,50,0,50,-100
17/03/2020 10:48,2019,1,WESTERN EUROPE-EU,FRANCE,2,DONCASTER SHEFFIELD,BIARRITZ,0,0,0,5,0,5,-100
17/03/2020 10:48,2019,1,WESTERN EUROPE-EU,FRANCE,2,DONCASTER SHEFFIELD,CHALONS (VATRY),86,0,86,0,0,0,0
17/03/2020 10:48,2019,1,WESTERN EUROPE-EU,FRANCE,2,DONCASTER SHEFFIELD,CHAMBERY,27,0,27,3925,0,3925,-99.3121
17/03/2020 10:48,2019,1,WESTERN EUROPE-EU,FRANCE,2,DONCASTER SHEFFIELD,NANTES,0,0,0,111,0,111,-100
17/03/2020 10:48,2019,1,WESTERN EUROPE-EU,FRANCE,2,DONCASTER SHEFFIELD,NICE,123,0,123,163,0,163,-24.53988
17/03/2020 10:48,2019,1,WESTERN EUROPE-EU,FRANCE,2,DONCASTER SHEFFIELD,PARIS (CHARLES DE GAULLE),17572,17572,0,36181,36181,0,-51.43307
17/03/2020 10:48,2019,1,WESTERN EUROPE-EU,FRANCE,2,DONCASTER SHEFFIELD,TARBES-LOURDES INTERNATIONAL,382,0,382,494,0,494,-22.67206
17/03/2020 10:48,2019,1,WESTERN EUROPE-EU,FRANCE,2,DUNDEE,PARIS (LE BOURGET),3,0,3,0,0,0,0
17/03/2020 10:48,2019,1,WESTERN EUROPE-EU,FRANCE,2,EAST MIDLANDS INTERNATIONAL,ALBERT - PICARDIE,48,0,48,0,0,0,0
17/03/2020 10:48,2019,1,WESTERN EUROPE-EU,FRANCE,2,EAST MIDLANDS INTERNATIONAL,BERGERAC,15890,15890,0,19345,19345,0,-17.85991
17/03/2020 10:48,2019,1,WESTERN EUROPE-EU,FRANCE,2,EAST MIDLANDS INTERNATIONAL,CARCASSONNE,19966,19966,0,20931,20931,0,-4.61039
17/03/2020 10:48,2019,1,WESTERN EUROPE-EU,FRANCE,2,EAST MIDLANDS INTERNATIONAL,CHAMBERY,6446,0,6446,3723,0,3723,73.13994
17/03/2020 10:48,2019,1,WESTERN EUROPE-EU,FRANCE,2,EAST MIDLANDS INTERNATIONAL,DINARD,17498,17498,0,29110,29110,0,-39.89007
17/03/2020 10:48,2019,1,WESTERN EUROPE-EU,FRANCE,2,EAST MIDLANDS INTERNATIONAL,GRENOBLE,131,131,0,0,0,0,0
17/03/2020 10:48,2019,1,WESTERN EUROPE-EU,FRANCE,2,EAST MIDLANDS INTERNATIONAL,LA ROCHELLE,0,0,0,58,0,58,-100
17/03/2020 10:48,2019,1,WESTERN EUROPE-EU,FRANCE,2,EAST MIDLANDS INTERNATIONAL,LIMOGES,46354,46354,0,45171,45171,0,2.61894
17/03/2020 10:48,2019,1,WESTERN EUROPE-EU,FRANCE,2,EAST MIDLANDS INTERNATIONAL,LYON,0,0,0,472,0,472,-100
17/03/2020 10:48,2019,1,WESTERN EUROPE-EU,FRANCE,2,EAST MIDLANDS INTERNATIONAL,NANTES,7012,7012,0,0,0,0,0
17/03/2020 10:48,2019,1,WESTERN EUROPE-EU,FRANCE,2,EAST MIDLANDS INTERNATIONAL,PARIS (CHARLES DE GAULLE),168,168,0,784,0,784,-78.57143
17/03/2020 10:48,2019,1,WESTERN EUROPE-EU,FRANCE,2,EAST MIDLANDS INTERNATIONAL,PARIS (LE BOURGET),50,0,50,93,0,93,-46.23656
17/03/2020 10:48,2019,1,WESTERN EUROPE-EU,FRANCE,2,EAST MIDLANDS INTERNATIONAL,PAU,45,0,45,0,0,0,0
17/03/2020 10:48,2019,1,WESTERN EUROPE-EU,FRANCE,2,EAST MIDLANDS INTERNATIONAL,RENNES,0,0,0,139,139,0,-100
17/03/2020 10:48,2019,1,WESTERN EUROPE-EU,FRANCE,2,EAST MIDLANDS INTERNATIONAL,TARBES-LOURDES INTERNATIONAL,140,0,140,308,0,308,-54.54545
17/03/2020 10:48,2019,1,WESTERN EUROPE-EU,FRANCE,2,EAST MIDLANDS INTERNATIONAL,TOULOUSE (BLAGNAC),0,0,0,176,0,176,-100
17/03/2020 10:48,2019,1,WESTERN EUROPE-EU,FRANCE,2,EDINBURGH,AJACCIO,0,0,0,340,0,340,-100
17/03/2020 10:48,2019,1,WESTERN EUROPE-EU,FRANCE,2,EDINBURGH,BASTIA,596,0,596,0,0,0,0
17/03/2020 10:48,2019,1,WESTERN EUROPE-EU,FRANCE,2,EDINBURGH,BERGERAC,2036,2036,0,2117,2117,0,-3.82617
17/03/2020 10:48,2019,1,WESTERN EUROPE-EU,FRANCE,2,EDINBURGH,BEZIERS,19879,19879,0,20418,20418,0,-2.63983
17/03/2020 10:48,2019,1,WESTERN EUROPE-EU,FRANCE,2,EDINBURGH,BORDEAUX,31460,31362,98,33415,32407,1008,-5.85067
17/03/2020 10:48,2019,1,WESTERN EUROPE-EU,FRANCE,2,EDINBURGH,CAEN,0,0,0,40,0,40,-100
17/03/2020 10:48,2019,1,WESTERN EUROPE-EU,FRANCE,2,EDINBURGH,CARCASSONNE,20071,20071,0,25395,25395,0,-20.96476
17/03/2020 10:48,2019,1,WESTERN EUROPE-EU,FRANCE,2,EDINBURGH,CHAMBERY,6657,0,6657,5770,0,5770,15.37262
17/03/2020 10:48,2019,1,WESTERN EUROPE-EU,FRANCE,2,EDINBURGH,DOLE,0,0,0,318,0,318,-100
17/03/2020 10:48,2019,1,WESTERN EUROPE-EU,FRANCE,2,EDINBURGH,GRENOBLE,6126,6126,0,5528,5150,378,10.81766
17/03/2020 10:48,2019,1,WESTERN EUROPE-EU,FRANCE,2,EDINBURGH,LYON,23546,23546,0,23862,22558,1304,-1.32428
17/03/2020 10:48,2019,1,WESTERN EUROPE-EU,FRANCE,2,EDINBURGH,MARSEILLE,36873,36626,247,34919,34212,707,5.59581
17/03/2020 10:48,2019,1,WESTERN EUROPE-EU,FRANCE,2,EDINBURGH,MONTPELLIER,194,0,194,321,172,149,-39.56386
17/03/2020 10:48,2019,1,WESTERN EUROPE-EU,FRANCE,2,EDINBURGH,NANTES,47212,47212,0,35689,34968,721,32.28726
17/03/2020 10:48,2019,1,WESTERN EUROPE-EU,FRANCE,2,EDINBURGH,NICE,47370,47133,237,47631,47631,0,-0.54796
17/03/2020 10:48,2019,1,WESTERN EUROPE-EU,FRANCE,2,EDINBURGH,PARIS (CHARLES DE GAULLE),364306,363684,622,396635,393649,2986,-8.15082
17/03/2020 10:48,2019,1,WESTERN EUROPE-EU,FRANCE,2,EDINBURGH,PARIS (ORLY),27705,27705,0,46775,46135,640,-40.76964
17/03/2020 10:48,2019,1,WESTERN EUROPE-EU,FRANCE,2,EDINBURGH,POITIERS,0,0,0,6026,6026,0,-100
17/03/2020 10:48,2019,1,WESTERN EUROPE-EU,FRANCE,2,EDINBURGH,TARBES-LOURDES INTERNATIONAL,1625,0,1625,1608,0,1608,1.05721
17/03/2020 10:48,2019,1,WESTERN EUROPE-EU,FRANCE,2,EDINBURGH,TOULON / HYERES,0,0,0,140,0,140,-100
17/03/2020 10:48,2019,1,WESTERN EUROPE-EU,FRANCE,2,EDINBURGH,TOULOUSE (BLAGNAC),36439,34404,2035,35560,32406,3154,2.47188
17/03/2020 10:48,2019,1,WESTERN EUROPE-EU,FRANCE,2,EXETER,BERGERAC,5336,5336,0,3451,3451,0,54.62185
17/03/2020 10:48,2019,1,WESTERN EUROPE-EU,FRANCE,2,EXETER,CARCASSONNE,0,0,0,156,0,156,-100
17/03/2020 10:48,2019,1,WESTERN EUROPE-EU,FRANCE,2,EXETER,CHAMBERY,6887,2619,4268,6726,2319,4407,2.3937
17/03/2020 10:48,2019,1,WESTERN EUROPE-EU,FRANCE,2,EXETER,GUYANCOURT,0,0,0,109,109,0,-100
17/03/2020 10:48,2019,1,WESTERN EUROPE-EU,FRANCE,2,EXETER,LA ROCHELLE,156,0,156,0,0,0,0
17/03/2020 10:48,2019,1,WESTERN EUROPE-EU,FRANCE,2,EXETER,LYON,176,0,176,441,0,441,-60.0907
17/03/2020 10:48,2019,1,WESTERN EUROPE-EU,FRANCE,2,EXETER,MONTPELLIER,0,0,0,40,0,40,-100
17/03/2020 10:48,2019,1,WESTERN EUROPE-EU,FRANCE,2,EXETER,PARIS (CHARLES DE GAULLE),76660,76660,0,50016,50016,0,53.27095
17/03/2020 10:48,2019,1,WESTERN EUROPE-EU,FRANCE,2,EXETER,RENNES,1529,1529,0,1644,1644,0,-6.99513
17/03/2020 10:48,2019,1,WESTERN EUROPE-EU,FRANCE,2,EXETER,TARBES-LOURDES INTERNATIONAL,292,0,292,300,0,300,-2.66667
17/03/2020 10:48,2019,1,WESTERN EUROPE-EU,FRANCE,2,EXETER,TOULOUSE (BLAGNAC),81,81,0,24,24,0,237.5
17/03/2020 10:48,2019,1,WESTERN EUROPE-EU,FRANCE,2,GLASGOW,BORDEAUX,10434,10434,0,9903,9903,0,5.36201
17/03/2020 10:48,2019,1,WESTERN EUROPE-EU,FRANCE,2,GLASGOW,CARCASSONNE,0,0,0,16912,16912,0,-100
17/03/2020 10:48,2019,1,WESTERN EUROPE-EU,FRANCE,2,GLASGOW,CHAMBERY,5837,0,5837,5927,0,5927,-1.51847
17/03/2020 10:48,2019,1,WESTERN EUROPE-EU,FRANCE,2,GLASGOW,DINARD,92,0,92,0,0,0,0
17/03/2020 10:48,2019,1,WESTERN EUROPE-EU,FRANCE,2,GLASGOW,GRENOBLE,5167,5167,0,4278,4278,0,20.78074
17/03/2020 10:48,2019,1,WESTERN EUROPE-EU,FRANCE,2,GLASGOW,LA ROCHELLE,470,0,470,0,0,0,0
17/03/2020 10:48,2019,1,WESTERN EUROPE-EU,FRANCE,2,GLASGOW,LYON,370,0,370,1479,0,1479,-74.9831
17/03/2020 10:48,2019,1,WESTERN EUROPE-EU,FRANCE,2,GLASGOW,MARSEILLE,5967,5923,44,5522,5522,0,8.05867
17/03/2020 10:48,2019,1,WESTERN EUROPE-EU,FRANCE,2,GLASGOW,NICE,0,0,0,170,0,170,-100
17/03/2020 10:48,2019,1,WESTERN EUROPE-EU,FRANCE,2,GLASGOW,PARIS (CHARLES DE GAULLE),129455,129063,392,128746,128746,0,0.5507
17/03/2020 10:48,2019,1,WESTERN EUROPE-EU,FRANCE,2,GLASGOW,RENNES,1013,0,1013,0,0,0,0
17/03/2020 10:48,2019,1,WESTERN EUROPE-EU,FRANCE,2,GLASGOW,STRASBOURG,41,0,41,0,0,0,0
17/03/2020 10:48,2019,1,WESTERN EUROPE-EU,FRANCE,2,GLASGOW,TARBES-LOURDES INTERNATIONAL,645,0,645,1443,0,1443,-55.30146
17/03/2020 10:48,2019,1,WESTERN EUROPE-EU,FRANCE,2,GLASGOW,TOULON / HYERES,0,0,0,140,0,140,-100
17/03/2020 10:48,2019,1,WESTERN EUROPE-EU,FRANCE,2,GUERNSEY,BORDEAUX,0,0,0,140,140,0,-100
17/03/2020 10:48,2019,1,WESTERN EUROPE-EU,FRANCE,2,GUERNSEY,DINARD,27,27,0,1640,1581,59,-98.35366
17/03/2020 10:48,2019,1,WESTERN EUROPE-EU,FRANCE,2,GUERNSEY,GRENOBLE,1000,841,159,1155,893,262,-13.41991
17/03/2020 10:48,2019,1,WESTERN EUROPE-EU,FRANCE,2,GUERNSEY,PARIS (LE BOURGET),167,0,167,0,0,0,0
17/03/2020 10:48,2019,1,WESTERN EUROPE-EU,FRANCE,2,GUERNSEY,TOULOUSE (BLAGNAC),48,0,48,0,0,0,0
17/03/2020 10:48,2019,1,WESTERN EUROPE-EU,FRANCE,2,HUMBERSIDE,PERPIGNAN,140,0,140,264,0,264,-46.9697
17/03/2020 10:48,2019,1,WESTERN EUROPE-EU,FRANCE,2,INVERNESS,STRASBOURG,42,0,42,0,0,0,0
17/03/2020 10:48,2019,1,WESTERN EUROPE-EU,FRANCE,2,ISLE OF MAN,PARIS (CHARLES DE GAULLE),75,0,75,78,0,78,-3.84615
17/03/2020 10:48,2019,1,WESTERN EUROPE-EU,FRANCE,2,JERSEY,BEAUVAIS,134,0,134,0,0,0,0
17/03/2020 10:48,2019,1,WESTERN EUROPE-EU,FRANCE,2,JERSEY,CAEN,0,0,0,2,2,0,-100
17/03/2020 10:48,2019,1,WESTERN EUROPE-EU,FRANCE,2,JERSEY,GRENOBLE,314,0,314,302,302,0,3.97351
17/03/2020 10:48,2019,1,WESTERN EUROPE-EU,FRANCE,2,JERSEY,NANTES,0,0,0,73,73,0,-100
17/03/2020 10:48,2019,1,WESTERN EUROPE-EU,FRANCE,2,KIRKWALL,PARIS (LE BOURGET),0,0,0,22,0,22,-100
17/03/2020 10:48,2019,1,WESTERN EUROPE-EU,FRANCE,2,LEEDS BRADFORD,BERGERAC,7312,7312,0,4924,4924,0,48.49716
17/03/2020 10:48,2019,1,WESTERN EUROPE-EU,FRANCE,2,LEEDS BRADFORD,GRENOBLE,3887,3887,0,4107,4107,0,-5.35671
17/03/2020 10:48,2019,1,WESTERN EUROPE-EU,FRANCE,2,LEEDS BRADFORD,LA ROCHELLE,4400,4400,0,4547,4547,0,-3.2329
17/03/2020 10:48,2019,1,WESTERN EUROPE-EU,FRANCE,2,LEEDS BRADFORD,LIMOGES,19376,19376,0,24090,24090,0,-19.56829
17/03/2020 10:48,2019,1,WESTERN EUROPE-EU,FRANCE,2,LEEDS BRADFORD,NICE,23546,23546,0,23337,23337,0,0.89557
17/03/2020 10:48,2019,1,WESTERN EUROPE-EU,FRANCE,2,LEEDS BRADFORD,PARIS (CHARLES DE GAULLE),53288,53288,0,52011,52011,0,2.45525
17/03/2020 10:48,2019,1,WESTERN EUROPE-EU,FRANCE,2,LEEDS BRADFORD,PERPIGNAN,118,0,118,373,0,373,-68.36461
17/03/2020 10:48,2019,1,WESTERN EUROPE-EU,FRANCE,2,LEEDS BRADFORD,TARBES-LOURDES INTERNATIONAL,580,0,580,680,0,680,-14.70588
17/03/2020 10:48,2019,1,WESTERN EUROPE-EU,FRANCE,2,LIVERPOOL (JOHN LENNON),BERGERAC,20442,20442,0,21079,21079,0,-3.02196
17/03/2020 10:48,2019,1,WESTERN EUROPE-EU,FRANCE,2,LIVERPOOL (JOHN LENNON),BORDEAUX,20757,20757,0,22132,22132,0,-6.21272
17/03/2020 10:48,2019,1,WESTERN EUROPE-EU,FRANCE,2,LIVERPOOL (JOHN LENNON),CHAMBERY,0,0,0,109,0,109,-100
17/03/2020 10:48,2019,1,WESTERN EUROPE-EU,FRANCE,2,LIVERPOOL (JOHN LENNON),GRENOBLE,4344,4344,0,4424,4424,0,-1.80832
17/03/2020 10:48,2019,1,WESTERN EUROPE-EU,FRANCE,2,LIVERPOOL (JOHN LENNON),NANTES,8299,8299,0,8241,8241,0,0.7038
17/03/2020 10:48,2019,1,WESTERN EUROPE-EU,FRANCE,2,LIVERPOOL (JOHN LENNON),NICE,102565,102565,0,94964,94964,0,8.00409
17/03/2020 10:48,2019,1,WESTERN EUROPE-EU,FRANCE,2,LIVERPOOL (JOHN LENNON),PARIS (CHARLES DE GAULLE),87663,87663,0,87697,87178,519,-0.03877
17/03/2020 10:48,2019,1,WESTERN EUROPE-EU,FRANCE,2,LIVERPOOL (JOHN LENNON),PARIS (ORLY),0,0,0,130,0,130,-100
17/03/2020 10:48,2019,1,WESTERN EUROPE-EU,FRANCE,2,LIVERPOOL (JOHN LENNON),PERPIGNAN,146,0,146,540,0,540,-72.96296
17/03/2020 10:48,2019,1,WESTERN EUROPE-EU,FRANCE,2,LIVERPOOL (JOHN LENNON),RENNES,0,0,0,106,0,106,-100
17/03/2020 10:48,2019,1,WESTERN EUROPE-EU,FRANCE,2,LIVERPOOL (JOHN LENNON),TARBES-LOURDES INTERNATIONAL,1212,0,1212,787,0,787,54.00254
17/03/2020 10:48,2019,1,WESTERN EUROPE-EU,FRANCE,2,LIVERPOOL (JOHN LENNON),TOULOUSE (BLAGNAC),6418,6418,0,5818,5818,0,10.31282
17/03/2020 10:48,2019,1,WESTERN EUROPE-EU,FRANCE,2,MANCHESTER,BASTIA,7121,7121,0,7087,7087,0,0.47975
17/03/2020 10:48,2019,1,WESTERN EUROPE-EU,FRANCE,2,MANCHESTER,BERGERAC,5490,5490,0,5848,5848,0,-6.12175
17/03/2020 10:48,2019,1,WESTERN EUROPE-EU,FRANCE,2,MANCHESTER,BEZIERS,25719,25719,0,20825,20825,0,23.5006
17/03/2020 10:48,2019,1,WESTERN EUROPE-EU,FRANCE,2,MANCHESTER,BIARRITZ,170,170,0,0,0,0,0
17/03/2020 10:48,2019,1,WESTERN EUROPE-EU,FRANCE,2,MANCHESTER,BORDEAUX,51539,51539,0,4509,4427,82,1043.02506
17/03/2020 10:48,2019,1,WESTERN EUROPE-EU,FRANCE,2,MANCHESTER,CALVI,2570,0,2570,2466,0,2466,4.21736
17/03/2020 10:48,2019,1,WESTERN EUROPE-EU,FRANCE,2,MANCHESTER,CARCASSONNE,35478,35478,0,40210,40210,0,-11.76822
17/03/2020 10:48,2019,1,WESTERN EUROPE-EU,FRANCE,2,MANCHESTER,CHAMBERY,29500,7142,22358,27294,5020,22274,8.08236
17/03/2020 10:48,2019,1,WESTERN EUROPE-EU,FRANCE,2,MANCHESTER,GRENOBLE,26193,26193,0,27145,20585,6560,-3.50709
17/03/2020 10:48,2019,1,WESTERN EUROPE-EU,FRANCE,2,MANCHESTER,LA ROCHELLE,6100,6006,94,3187,3187,0,91.40257
17/03/2020 10:48,2019,1,WESTERN EUROPE-EU,FRANCE,2,MANCHESTER,LILLE,1086,0,1086,0,0,0,0
17/03/2020 10:48,2019,1,WESTERN EUROPE-EU,FRANCE,2,MANCHESTER,LIMOGES,47831,47831,0,46397,46397,0,3.09072
17/03/2020 10:48,2019,1,WESTERN EUROPE-EU,FRANCE,2,MANCHESTER,LYON,49711,49152,559,49372,48401,971,0.68662
17/03/2020 10:48,2019,1,WESTERN EUROPE-EU,FRANCE,2,MANCHESTER,LYON(BRON),0,0,0,77,0,77,-100
17/03/2020 10:48,2019,1,WESTERN EUROPE-EU,FRANCE,2,MANCHESTER,MARSEILLE,40775,40775,0,16068,16068,0,153.76525
17/03/2020 10:48,2019,1,WESTERN EUROPE-EU,FRANCE,2,MANCHESTER,MONTPELLIER,0,0,0,78,0,78,-100
17/03/2020 10:48,2019,1,WESTERN EUROPE-EU,FRANCE,2,MANCHESTER,NANTES,27630,27630,0,13845,13845,0,99.56663
17/03/2020 10:48,2019,1,WESTERN EUROPE-EU,FRANCE,2,MANCHESTER,NICE,72155,72155,0,49417,49161,256,46.01251
17/03/2020 10:48,2019,1,WESTERN EUROPE-EU,FRANCE,2,MANCHESTER,PARIS (CHARLES DE GAULLE),683828,683310,518,628020,627770,250,8.88634
17/03/2020 10:48,2019,1,WESTERN EUROPE-EU,FRANCE,2,MANCHESTER,PERPIGNAN,344,0,344,813,0,813,-57.68758
17/03/2020 10:48,2019,1,WESTERN EUROPE-EU,FRANCE,2,MANCHESTER,POITIERS,7064,7064,0,0,0,0,0
17/03/2020 10:48,2019,1,WESTERN EUROPE-EU,FRANCE,2,MANCHESTER,RENNES,3036,3036,0,3540,3540,0,-14.23729
17/03/2020 10:48,2019,1,WESTERN EUROPE-EU,FRANCE,2,MANCHESTER,TARBES-LOURDES INTERNATIONAL,2074,0,2074,2927,0,2927,-29.14247
17/03/2020 10:48,2019,1,WESTERN EUROPE-EU,FRANCE,2,MANCHESTER,TOULOUSE (BLAGNAC),34101,28794,5307,49588,44326,5262,-31.23135
17/03/2020 10:48,2019,1,WESTERN EUROPE-EU,FRANCE,2,NEWCASTLE,BRIVE-LA-GAILLARDE,0,0,0,172,0,172,-100
17/03/2020 10:48,2019,1,WESTERN EUROPE-EU,FRANCE,2,NEWCASTLE,CLERMONT FERRAND,688,0,688,0,0,0,0
17/03/2020 10:48,2019,1,WESTERN EUROPE-EU,FRANCE,2,NEWCASTLE,GRENOBLE,4857,4857,0,4131,4131,0,17.57444
17/03/2020 10:48,2019,1,WESTERN EUROPE-EU,FRANCE,2,NEWCASTLE,LA ROCHELLE,740,0,740,0,0,0,0
17/03/2020 10:48,2019,1,WESTERN EUROPE-EU,FRANCE,2,NEWCASTLE,MARSEILLE,60,0,60,0,0,0,0
17/03/2020 10:48,2019,1,WESTERN EUROPE-EU,FRANCE,2,NEWCASTLE,MONTPELLIER,287,0,287,0,0,0,0
17/03/2020 10:48,2019,1,WESTERN EUROPE-EU,FRANCE,2,NEWCASTLE,NICE,27108,27108,0,23504,23504,0,15.33356
17/03/2020 10:48,2019,1,WESTERN EUROPE-EU,FRANCE,2,NEWCASTLE,PARIS (CHARLES DE GAULLE),165599,165508,91,144374,144374,0,14.7014
17/03/2020 10:48,2019,1,WESTERN EUROPE-EU,FRANCE,2,NEWCASTLE,PERPIGNAN,0,0,0,289,0,289,-100
17/03/2020 10:48,2019,1,WESTERN EUROPE-EU,FRANCE,2,NEWCASTLE,TARBES-LOURDES INTERNATIONAL,912,360,552,868,296,572,5.06912
17/03/2020 10:48,2019,1,WESTERN EUROPE-EU,FRANCE,2,NEWCASTLE,TOULON / HYERES,138,0,138,0,0,0,0
17/03/2020 10:48,2019,1,WESTERN EUROPE-EU,FRANCE,2,NEWQUAY,PARIS (CHARLES DE GAULLE),54,54,0,0,0,0,0
17/03/2020 10:48,2019,1,WESTERN EUROPE-EU,FRANCE,2,NORWICH,TOULOUSE (BLAGNAC),32,0,32,0,0,0,0
17/03/2020 10:48,2019,1,WESTERN EUROPE-EU,FRANCE,2,PRESTWICK,BEZIERS,187,0,187,0,0,0,0
17/03/2020 10:48,2019,1,WESTERN EUROPE-EU,FRANCE,2,PRESTWICK,TARBES-LOURDES INTERNATIONAL,287,0,287,0,0,0,0
17/03/2020 10:48,2019,1,WESTERN EUROPE-EU,FRANCE,2,SOUTHAMPTON,AVIGNON,2192,2192,0,3567,3567,0,-38.5478
17/03/2020 10:48,2019,1,WESTERN EUROPE-EU,FRANCE,2,SOUTHAMPTON,BASTIA,1704,1704,0,1643,1643,0,3.71272
17/03/2020 10:48,2019,1,WESTERN EUROPE-EU,FRANCE,2,SOUTHAMPTON,BERGERAC,32926,32926,0,37772,37772,0,-12.82961
17/03/2020 10:48,2019,1,WESTERN EUROPE-EU,FRANCE,2,SOUTHAMPTON,BIARRITZ,1592,1592,0,1857,1857,0,-14.27033
17/03/2020 10:48,2019,1,WESTERN EUROPE-EU,FRANCE,2,SOUTHAMPTON,BORDEAUX,6432,6432,0,10312,10312,0,-37.62607
17/03/2020 10:48,2019,1,WESTERN EUROPE-EU,FRANCE,2,SOUTHAMPTON,BREST,1099,1099,0,1207,1207,0,-8.9478
17/03/2020 10:48,2019,1,WESTERN EUROPE-EU,FRANCE,2,SOUTHAMPTON,CHAMBERY,8079,4614,3465,9204,6228,2976,-12.22295
17/03/2020 10:48,2019,1,WESTERN EUROPE-EU,FRANCE,2,SOUTHAMPTON,LA ROCHELLE,9537,9537,0,10898,10898,0,-12.48853
17/03/2020 10:48,2019,1,WESTERN EUROPE-EU,FRANCE,2,SOUTHAMPTON,LIMOGES,7366,7366,0,12465,12465,0,-40.90654
17/03/2020 10:48,2019,1,WESTERN EUROPE-EU,FRANCE,2,SOUTHAMPTON,LYON,91,91,0,1268,1268,0,-92.82334
17/03/2020 10:48,2019,1,WESTERN EUROPE-EU,FRANCE,2,SOUTHAMPTON,NANTES,13117,13117,0,15314,15314,0,-14.34635
17/03/2020 10:48,2019,1,WESTERN EUROPE-EU,FRANCE,2,SOUTHAMPTON,NICE,0,0,0,68,68,0,-100
17/03/2020 10:48,2019,1,WESTERN EUROPE-EU,FRANCE,2,SOUTHAMPTON,PARIS (CHARLES DE GAULLE),76925,76925,0,77953,77953,0,-1.31874
17/03/2020 10:48,2019,1,WESTERN EUROPE-EU,FRANCE,2,SOUTHAMPTON,PARIS (LE BOURGET),0,0,0,70,70,0,-100
17/03/2020 10:48,2019,1,WESTERN EUROPE-EU,FRANCE,2,SOUTHAMPTON,PERPIGNAN,1713,1713,0,1938,1938,0,-11.60991
17/03/2020 10:48,2019,1,WESTERN EUROPE-EU,FRANCE,2,SOUTHAMPTON,RENNES,9372,9372,0,12565,12565,0,-25.41186
17/03/2020 10:48,2019,1,WESTERN EUROPE-EU,FRANCE,2,SOUTHAMPTON,RODEZ,0,0,0,2059,2059,0,-100
17/03/2020 10:48,2019,1,WESTERN EUROPE-EU,FRANCE,2,SOUTHAMPTON,TOULON / HYERES,2144,2144,0,3502,3502,0,-38.77784
17/03/2020 10:48,2019,1,WESTERN EUROPE-EU,FRANCE,2,SOUTHAMPTON,TOULOUSE (BLAGNAC),63,63,0,0,0,0,0
17/03/2020 10:48,2019,1,WESTERN EUROPE-EU,FRANCE,2,TEESSIDE INTERNATIONAL AIRPORT,MARSEILLE,0,0,0,3,3,0,-100
17/03/2020 10:48,2019,1,WESTERN EUROPE-EU,FRANCE,2,TEESSIDE INTERNATIONAL AIRPORT,ST ETIENNE,45,0,45,0,0,0,0
17/03/2020 10:48,2019,1,WESTERN EUROPE-EU,FRANCE,2,TEESSIDE INTERNATIONAL AIRPORT,TARBES-LOURDES INTERNATIONAL,747,0,747,742,0,742,0.67385
17/03/2020 10:48,2019,1,WESTERN EUROPE-EU,GERMANY,1,GATWICK,BERLIN (SCHONEFELD),201998,201613,385,290056,290056,0,-30.35897
17/03/2020 10:48,2019,1,WESTERN EUROPE-EU,GERMANY,1,GATWICK,BERLIN (TEGEL),279145,279145,0,173730,173730,0,60.67749
17/03/2020 10:48,2019,1,WESTERN EUROPE-EU,GERMANY,1,GATWICK,BRAUNSCHWEIG,0,0,0,39,0,39,-100
17/03/2020 10:48,2019,1,WESTERN EUROPE-EU,GERMANY,1,GATWICK,COLOGNE BONN,20633,20471,162,6821,6821,0,202.4923
17/03/2020 10:48,2019,1,WESTERN EUROPE-EU,GERMANY,1,GATWICK,DUSSELDORF,129755,129698,57,37,0,37,350589.18919
17/03/2020 10:48,2019,1,WESTERN EUROPE-EU,GERMANY,1,GATWICK,FRANKFURT MAIN,109,0,109,361,172,189,-69.80609
17/03/2020 10:48,2019,1,WESTERN EUROPE-EU,GERMANY,1,GATWICK,FRIEDRICHSHAFEN,25389,14834,10555,23513,14642,8871,7.97857
17/03/2020 10:48,2019,1,WESTERN EUROPE-EU,GERMANY,1,GATWICK,HAMBURG,175124,175118,6,167827,167827,0,4.34793
17/03/2020 10:48,2019,1,WESTERN EUROPE-EU,GERMANY,1,GATWICK,MUNICH,256926,256250,676,250779,250777,2,2.45116
17/03/2020 10:48,2019,1,WESTERN EUROPE-EU,GERMANY,1,GATWICK,NUREMBERG,6219,6219,0,7735,7735,0,-19.59922
17/03/2020 10:48,2019,1,WESTERN EUROPE-EU,GERMANY,1,GATWICK,STUTTGART,124923,124923,0,125629,125629,0,-0.56197
17/03/2020 10:48,2019,1,WESTERN EUROPE-EU,GERMANY,1,HEATHROW,BERLIN (TEGEL),752162,752162,0,817252,817252,0,-7.9645
17/03/2020 10:48,2019,1,WESTERN EUROPE-EU,GERMANY,1,HEATHROW,COLOGNE BONN,189557,189557,0,193790,193790,0,-2.18432
17/03/2020 10:48,2019,1,WESTERN EUROPE-EU,GERMANY,1,HEATHROW,DUSSELDORF,730850,730850,0,737313,737313,0,-0.87656
17/03/2020 10:48,2019,1,WESTERN EUROPE-EU,GERMANY,1,HEATHROW,FRANKFURT MAIN,1548995,1548995,0,1559218,1559218,0,-0.65565
17/03/2020 10:48,2019,1,WESTERN EUROPE-EU,GERMANY,1,HEATHROW,FRIEDRICHSHAFEN,574,0,574,604,0,604,-4.96689
17/03/2020 10:48,2019,1,WESTERN EUROPE-EU,GERMANY,1,HEATHROW,HAMBURG,613188,613188,0,600913,600913,0,2.04272
17/03/2020 10:48,2019,1,WESTERN EUROPE-EU,GERMANY,1,HEATHROW,HANOVER,176409,176409,0,213722,213722,0,-17.45866
17/03/2020 10:48,2019,1,WESTERN EUROPE-EU,GERMANY,1,HEATHROW,MUNICH,1266993,1266993,0,1242063,1242063,0,2.00714
17/03/2020 10:48,2019,1,WESTERN EUROPE-EU,GERMANY,1,HEATHROW,STUTTGART,342408,342408,0,343928,343928,0,-0.44195
17/03/2020 10:48,2019,1,WESTERN EUROPE-EU,GERMANY,1,LONDON CITY,BERLIN (TEGEL),134994,134994,0,122062,122062,0,10.59462
17/03/2020 10:48,2019,1,WESTERN EUROPE-EU,GERMANY,1,LONDON CITY,DUSSELDORF,150598,150598,0,160406,160406,0,-6.11448
17/03/2020 10:48,2019,1,WESTERN EUROPE-EU,GERMANY,1,LONDON CITY,FRANKFURT MAIN,267654,267654,0,249937,249937,0,7.08859
17/03/2020 10:48,2019,1,WESTERN EUROPE-EU,GERMANY,1,LONDON CITY,MUNICH,107983,107864,119,0,0,0,0
17/03/2020 10:48,2019,1,WESTERN EUROPE-EU,GERMANY,1,LONDON CITY,SAARBRUCKEN,0,0,0,67,67,0,-100
17/03/2020 10:48,2019,1,WESTERN EUROPE-EU,GERMANY,1,LUTON,BERLIN (SCHONEFELD),182850,182850,0,179320,179320,0,1.96855
17/03/2020 10:48,2019,1,WESTERN EUROPE-EU,GERMANY,1,LUTON,BERLIN (TEGEL),0,0,0,461,461,0,-100
17/03/2020 10:48,2019,1,WESTERN EUROPE-EU,GERMANY,1,LUTON,COLOGNE BONN,0,0,0,874,874,0,-100
17/03/2020 10:48,2019,1,WESTERN EUROPE-EU,GERMANY,1,LUTON,DORTMUND,106914,106914,0,101750,101750,0,5.07518
17/03/2020 10:48,2019,1,WESTERN EUROPE-EU,GERMANY,1,LUTON,DRESDEN,357,0,357,149,0,149,139.59732
17/03/2020 10:48,2019,1,WESTERN EUROPE-EU,GERMANY,1,LUTON,DUSSELDORF,18,18,0,0,0,0,0
17/03/2020 10:48,2019,1,WESTERN EUROPE-EU,GERMANY,1,LUTON,FRANKFURT MAIN,216,216,0,217,0,217,-0.46083
17/03/2020 10:48,2019,1,WESTERN EUROPE-EU,GERMANY,1,LUTON,HAMBURG,0,0,0,12556,12556,0,-100
17/03/2020 10:48,2019,1,WESTERN EUROPE-EU,GERMANY,1,LUTON,LEIPZIG,0,0,0,193,193,0,-100
17/03/2020 10:48,2019,1,WESTERN EUROPE-EU,GERMANY,1,LUTON,MUNICH,82042,82042,0,80873,80873,0,1.44548
17/03/2020 10:48,2019,1,WESTERN EUROPE-EU,GERMANY,1,LUTON,MUNSTER-OSNABRUCK,0,0,0,223,223,0,-100
17/03/2020 10:48,2019,1,WESTERN EUROPE-EU,GERMANY,1,LUTON,NIEDERRHEIN,0,0,0,175,175,0,-100
17/03/2020 10:48,2019,1,WESTERN EUROPE-EU,GERMANY,1,SOUTHEND,COLOGNE BONN,3988,3988,0,30518,30518,0,-86.9323
17/03/2020 10:48,2019,1,WESTERN EUROPE-EU,GERMANY,1,SOUTHEND,DUSSELDORF,35,35,0,57,57,0,-38.59649
17/03/2020 10:48,2019,1,WESTERN EUROPE-EU,GERMANY,1,SOUTHEND,MUNICH,38,38,0,0,0,0,0
17/03/2020 10:48,2019,1,WESTERN EUROPE-EU,GERMANY,1,SOUTHEND,PADERBORN,26,26,0,247,247,0,-89.47368
17/03/2020 10:48,2019,1,WESTERN EUROPE-EU,GERMANY,1,STANSTED,BERLIN (SCHONEFELD),453874,453874,0,453167,453000,167,0.15601
17/03/2020 10:48,2019,1,WESTERN EUROPE-EU,GERMANY,1,STANSTED,BERLIN (TEGEL),6333,6333,0,7248,7152,96,-12.62417
17/03/2020 10:48,2019,1,WESTERN EUROPE-EU,GERMANY,1,STANSTED,BREMEN,187344,187344,0,186731,186731,0,0.32828
17/03/2020 10:48,2019,1,WESTERN EUROPE-EU,GERMANY,1,STANSTED,COLOGNE BONN,380648,380292,356,438037,437498,539,-13.1014
17/03/2020 10:48,2019,1,WESTERN EUROPE-EU,GERMANY,1,STANSTED,DORTMUND,117708,117443,265,118369,118302,67,-0.55842
17/03/2020 10:48,2019,1,WESTERN EUROPE-EU,GERMANY,1,STANSTED,DRESDEN,8578,8433,145,0,0,0,0
17/03/2020 10:48,2019,1,WESTERN EUROPE-EU,GERMANY,1,STANSTED,FRANKFURT MAIN,254807,254345,462,229780,229780,0,10.89172
17/03/2020 10:48,2019,1,WESTERN EUROPE-EU,GERMANY,1,STANSTED,FRIEDRICHSHAFEN,486,486,0,160,160,0,203.75
17/03/2020 10:48,2019,1,WESTERN EUROPE-EU,GERMANY,1,STANSTED,HAHN,18936,18857,79,106260,106260,0,-82.17956
17/03/2020 10:48,2019,1,WESTERN EUROPE-EU,GERMANY,1,STANSTED,HAMBURG,191584,191584,0,199345,199345,0,-3.89325
17/03/2020 10:48,2019,1,WESTERN EUROPE-EU,GERMANY,1,STANSTED,HANOVER,17127,16900,227,74475,74475,0,-77.00302
17/03/2020 10:48,2019,1,WESTERN EUROPE-EU,GERMANY,1,STANSTED,KARLSRUHE/BADEN BADEN,121023,121023,0,127567,127567,0,-5.12985
17/03/2020 10:48,2019,1,WESTERN EUROPE-EU,GERMANY,1,STANSTED,LEIPZIG,11090,11090,0,48006,48006,0,-76.89872
17/03/2020 10:48,2019,1,WESTERN EUROPE-EU,GERMANY,1,STANSTED,MEMMINGEN ALLGAU,79279,79279,0,88960,88960,0,-10.88242
17/03/2020 10:48,2019,1,WESTERN EUROPE-EU,GERMANY,1,STANSTED,MUNICH,122831,121395,1436,169474,168536,938,-27.52222
17/03/2020 10:48,2019,1,WESTERN EUROPE-EU,GERMANY,1,STANSTED,MUNSTER-OSNABRUCK,333,0,333,0,0,0,0
17/03/2020 10:48,2019,1,WESTERN EUROPE-EU,GERMANY,1,STANSTED,NIEDERRHEIN,27100,27100,0,42246,42246,0,-35.85191
17/03/2020 10:48,2019,1,WESTERN EUROPE-EU,GERMANY,1,STANSTED,NUREMBERG,192972,192972,0,192367,192367,0,0.3145
17/03/2020 10:48,2019,1,WESTERN EUROPE-EU,GERMANY,1,STANSTED,STUTTGART,187,187,0,16508,16508,0,-98.86722
17/03/2020 10:48,2019,1,WESTERN EUROPE-EU,GERMANY,2,ABERDEEN,FRANKFURT MAIN,0,0,0,18573,18573,0,-100
17/03/2020 10:48,2019,1,WESTERN EUROPE-EU,GERMANY,2,ABERDEEN,HAHN,0,0,0,171,171,0,-100
17/03/2020 10:48,2019,1,WESTERN EUROPE-EU,GERMANY,2,BELFAST CITY (GEORGE BEST),FRANKFURT MAIN,4,0,4,0,0,0,0
17/03/2020 10:48,2019,1,WESTERN EUROPE-EU,GERMANY,2,BELFAST INTERNATIONAL,BERLIN (SCHONEFELD),29609,29609,0,34305,34305,0,-13.68897
17/03/2020 10:48,2019,1,WESTERN EUROPE-EU,GERMANY,2,BELFAST INTERNATIONAL,COLOGNE BONN,345,292,53,0,0,0,0
17/03/2020 10:48,2019,1,WESTERN EUROPE-EU,GERMANY,2,BELFAST INTERNATIONAL,FRANKFURT MAIN,186,0,186,0,0,0,0
17/03/2020 10:48,2019,1,WESTERN EUROPE-EU,GERMANY,2,BELFAST INTERNATIONAL,HAHN,98,0,98,0,0,0,0
17/03/2020 10:48,2019,1,WESTERN EUROPE-EU,GERMANY,2,BELFAST INTERNATIONAL,HAMBURG,42,0,42,0,0,0,0
17/03/2020 10:48,2019,1,WESTERN EUROPE-EU,GERMANY,2,BELFAST INTERNATIONAL,INGOLSTADT-MANCHING,41,0,41,0,0,0,0
17/03/2020 10:48,2019,1,WESTERN EUROPE-EU,GERMANY,2,BELFAST INTERNATIONAL,MEMMINGEN ALLGAU,50,0,50,0,0,0,0
17/03/2020 10:48,2019,1,WESTERN EUROPE-EU,GERMANY,2,BELFAST INTERNATIONAL,MUNICH,128,0,128,0,0,0,0
17/03/2020 10:48,2019,1,WESTERN EUROPE-EU,GERMANY,2,BIGGIN HILL,BERLIN (SCHONEFELD),7,0,7,4,0,4,75
17/03/2020 10:48,2019,1,WESTERN EUROPE-EU,GERMANY,2,BIGGIN HILL,BERLIN (TEGEL),0,0,0,3,0,3,-100
17/03/2020 10:48,2019,1,WESTERN EUROPE-EU,GERMANY,2,BIGGIN HILL,DUSSELDORF,0,0,0,12,0,12,-100
17/03/2020 10:48,2019,1,WESTERN EUROPE-EU,GERMANY,2,BIGGIN HILL,FRANKFURT MAIN,0,0,0,9,0,9,-100
17/03/2020 10:48,2019,1,WESTERN EUROPE-EU,GERMANY,2,BIGGIN HILL,HANOVER,0,0,0,31,0,31,-100
17/03/2020 10:48,2019,1,WESTERN EUROPE-EU,GERMANY,2,BIGGIN HILL,KARLSRUHE/BADEN BADEN,0,0,0,4,0,4,-100
17/03/2020 10:48,2019,1,WESTERN EUROPE-EU,GERMANY,2,BIGGIN HILL,MUNICH,0,0,0,7,0,7,-100
17/03/2020 10:48,2019,1,WESTERN EUROPE-EU,GERMANY,2,BIRMINGHAM,BERLIN (SCHONEFELD),23,0,23,360,360,0,-93.61111
17/03/2020 10:48,2019,1,WESTERN EUROPE-EU,GERMANY,2,BIRMINGHAM,BERLIN (TEGEL),44041,44041,0,62211,62087,124,-29.20705
17/03/2020 10:48,2019,1,WESTERN EUROPE-EU,GERMANY,2,BIRMINGHAM,COLOGNE BONN,35,35,0,463,206,257,-92.4406
17/03/2020 10:48,2019,1,WESTERN EUROPE-EU,GERMANY,2,BIRMINGHAM,DORTMUND,92,0,92,79,0,79,16.4557
17/03/2020 10:48,2019,1,WESTERN EUROPE-EU,GERMANY,2,BIRMINGHAM,DRESDEN,381,0,381,0,0,0,0
17/03/2020 10:48,2019,1,WESTERN EUROPE-EU,GERMANY,2,BIRMINGHAM,DUSSELDORF,278882,278882,0,270446,270446,0,3.11929
17/03/2020 10:48,2019,1,WESTERN EUROPE-EU,GERMANY,2,BIRMINGHAM,FRANKFURT MAIN,317192,317192,0,321985,321985,0,-1.48858
17/03/2020 10:48,2019,1,WESTERN EUROPE-EU,GERMANY,2,BIRMINGHAM,HAHN,0,0,0,539,183,356,-100
17/03/2020 10:48,2019,1,WESTERN EUROPE-EU,GERMANY,2,BIRMINGHAM,HAMBURG,24139,24139,0,33936,33936,0,-28.86905
17/03/2020 10:48,2019,1,WESTERN EUROPE-EU,GERMANY,2,BIRMINGHAM,HANOVER,21327,20995,332,34513,34396,117,-38.20589
17/03/2020 10:48,2019,1,WESTERN EUROPE-EU,GERMANY,2,BIRMINGHAM,MUNICH,210545,209360,1185,209484,208630,854,0.50648
17/03/2020 10:48,2019,1,WESTERN EUROPE-EU,GERMANY,2,BIRMINGHAM,NIEDERRHEIN,8,8,0,0,0,0,0
17/03/2020 10:48,2019,1,WESTERN EUROPE-EU,GERMANY,2,BIRMINGHAM,PADERBORN,0,0,0,741,741,0,-100
17/03/2020 10:48,2019,1,WESTERN EUROPE-EU,GERMANY,2,BIRMINGHAM,STUTTGART,67177,67177,0,67465,67465,0,-0.42689
17/03/2020 10:48,2019,1,WESTERN EUROPE-EU,GERMANY,2,BOURNEMOUTH,DUSSELDORF,88,0,88,0,0,0,0
17/03/2020 10:48,2019,1,WESTERN EUROPE-EU,GERMANY,2,BRISTOL,BERLIN (SCHONEFELD),98583,98583,0,94480,94480,0,4.34272
17/03/2020 10:48,2019,1,WESTERN EUROPE-EU,GERMANY,2,BRISTOL,BERLIN (TEGEL),0,0,0,2,2,0,-100
17/03/2020 10:48,2019,1,WESTERN EUROPE-EU,GERMANY,2,BRISTOL,COLOGNE BONN,61792,61792,0,59549,59549,0,3.76665
17/03/2020 10:48,2019,1,WESTERN EUROPE-EU,GERMANY,2,BRISTOL,DUSSELDORF,1686,1686,0,12807,12807,0,-86.83532
17/03/2020 10:48,2019,1,WESTERN EUROPE-EU,GERMANY,2,BRISTOL,FRANKFURT MAIN,5453,5453,0,53277,53277,0,-89.76481
17/03/2020 10:48,2019,1,WESTERN EUROPE-EU,GERMANY,2,BRISTOL,HAMBURG,1070,1070,0,13071,13071,0,-91.81394
17/03/2020 10:48,2019,1,WESTERN EUROPE-EU,GERMANY,2,BRISTOL,MUNICH,4561,4483,78,47994,47994,0,-90.49673
17/03/2020 10:48,2019,1,WESTERN EUROPE-EU,GERMANY,2,BRISTOL,ROSTOCK-LAAGE,0,0,0,29,29,0,-100
17/03/2020 10:48,2019,1,WESTERN EUROPE-EU,GERMANY,2,CARDIFF WALES,BERLIN (SCHONEFELD),155,155,0,144,144,0,7.63889
17/03/2020 10:48,2019,1,WESTERN EUROPE-EU,GERMANY,2,CARDIFF WALES,BERLIN (TEGEL),1829,1829,0,14894,14801,93,-87.71989
17/03/2020 10:48,2019,1,WESTERN EUROPE-EU,GERMANY,2,CARDIFF WALES,BRAUNSCHWEIG,0,0,0,45,0,45,-100
17/03/2020 10:48,2019,1,WESTERN EUROPE-EU,GERMANY,2,CARDIFF WALES,DUSSELDORF,30,30,0,3235,3235,0,-99.07264
17/03/2020 10:48,2019,1,WESTERN EUROPE-EU,GERMANY,2,CARDIFF WALES,FRANKFURT MAIN,0,0,0,66,66,0,-100
17/03/2020 10:48,2019,1,WESTERN EUROPE-EU,GERMANY,2,CARDIFF WALES,HAMBURG,0,0,0,12,12,0,-100
17/03/2020 10:48,2019,1,WESTERN EUROPE-EU,GERMANY,2,CARDIFF WALES,MUNICH,9578,9541,37,15783,15739,44,-39.31445
17/03/2020 10:48,2019,1,WESTERN EUROPE-EU,GERMANY,2,DONCASTER SHEFFIELD,BERLIN (TEGEL),0,0,0,3487,3487,0,-100
17/03/2020 10:48,2019,1,WESTERN EUROPE-EU,GERMANY,2,DONCASTER SHEFFIELD,DUSSELDORF,59,59,0,0,0,0,0
17/03/2020 10:48,2019,1,WESTERN EUROPE-EU,GERMANY,2,DUNDEE,HAMBURG,0,0,0,12,0,12,-100
17/03/2020 10:48,2019,1,WESTERN EUROPE-EU,GERMANY,2,EAST MIDLANDS INTERNATIONAL,BERLIN (SCHONEFELD),36651,36482,169,48429,48429,0,-24.32014
17/03/2020 10:48,2019,1,WESTERN EUROPE-EU,GERMANY,2,EAST MIDLANDS INTERNATIONAL,BREMEN,0,0,0,110,110,0,-100
17/03/2020 10:48,2019,1,WESTERN EUROPE-EU,GERMANY,2,EAST MIDLANDS INTERNATIONAL,COLOGNE BONN,159,0,159,585,175,410,-72.82051
17/03/2020 10:48,2019,1,WESTERN EUROPE-EU,GERMANY,2,EAST MIDLANDS INTERNATIONAL,DUSSELDORF,7,7,0,33,0,33,-78.78788
17/03/2020 10:48,2019,1,WESTERN EUROPE-EU,GERMANY,2,EAST MIDLANDS INTERNATIONAL,HAMBURG,0,0,0,122,122,0,-100
17/03/2020 10:48,2019,1,WESTERN EUROPE-EU,GERMANY,2,EAST MIDLANDS INTERNATIONAL,MUNICH,112,0,112,0,0,0,0
17/03/2020 10:48,2019,1,WESTERN EUROPE-EU,GERMANY,2,EDINBURGH,BERLIN (SCHONEFELD),102670,102670,0,42968,41834,1134,138.94526
17/03/2020 10:48,2019,1,WESTERN EUROPE-EU,GERMANY,2,EDINBURGH,BERLIN (TEGEL),106054,106054,0,70613,70510,103,50.19047
17/03/2020 10:48,2019,1,WESTERN EUROPE-EU,GERMANY,2,EDINBURGH,COLOGNE BONN,59798,59798,0,59730,59730,0,0.11385
17/03/2020 10:48,2019,1,WESTERN EUROPE-EU,GERMANY,2,EDINBURGH,DUSSELDORF,40447,40447,0,35339,35244,95,14.45429
17/03/2020 10:48,2019,1,WESTERN EUROPE-EU,GERMANY,2,EDINBURGH,FRANKFURT MAIN,196967,196967,0,194227,194077,150,1.41072
17/03/2020 10:48,2019,1,WESTERN EUROPE-EU,GERMANY,2,EDINBURGH,HAHN,0,0,0,30037,30037,0,-100
17/03/2020 10:48,2019,1,WESTERN EUROPE-EU,GERMANY,2,EDINBURGH,HAMBURG,126534,126534,0,111062,111062,0,13.93096
17/03/2020 10:48,2019,1,WESTERN EUROPE-EU,GERMANY,2,EDINBURGH,KARLSRUHE/BADEN BADEN,20939,20939,0,25034,25034,0,-16.35775
17/03/2020 10:48,2019,1,WESTERN EUROPE-EU,GERMANY,2,EDINBURGH,MEMMINGEN ALLGAU,24986,24986,0,4459,4459,0,460.34985
17/03/2020 10:48,2019,1,WESTERN EUROPE-EU,GERMANY,2,EDINBURGH,MUNICH,175005,175005,0,154084,154084,0,13.57766
17/03/2020 10:48,2019,1,WESTERN EUROPE-EU,GERMANY,2,EDINBURGH,NIEDERRHEIN,32602,32602,0,36650,36650,0,-11.04502
17/03/2020 10:48,2019,1,WESTERN EUROPE-EU,GERMANY,2,EDINBURGH,NUREMBERG,349,349,0,0,0,0,0
17/03/2020 10:48,2019,1,WESTERN EUROPE-EU,GERMANY,2,EDINBURGH,STUTTGART,18966,18966,0,29510,29510,0,-35.73026
17/03/2020 10:48,2019,1,WESTERN EUROPE-EU,GERMANY,2,EXETER,HAMBURG,71,71,0,0,0,0,0
17/03/2020 10:48,2019,1,WESTERN EUROPE-EU,GERMANY,2,EXETER,MUNICH,0,0,0,56,56,0,-100
17/03/2020 10:48,2019,1,WESTERN EUROPE-EU,GERMANY,2,GLASGOW,BERLIN (SCHONEFELD),84749,84749,0,179862,179753,109,-52.8811
17/03/2020 10:48,2019,1,WESTERN EUROPE-EU,GERMANY,2,GLASGOW,BERLIN (TEGEL),161,161,0,0,0,0,0
17/03/2020 10:48,2019,1,WESTERN EUROPE-EU,GERMANY,2,GLASGOW,DUSSELDORF,28485,28485,0,41368,41368,0,-31.14243
17/03/2020 10:48,2019,1,WESTERN EUROPE-EU,GERMANY,2,GLASGOW,ERFURT,0,0,0,141,0,141,-100
17/03/2020 10:48,2019,1,WESTERN EUROPE-EU,GERMANY,2,GLASGOW,FRANKFURT MAIN,94124,94124,0,113506,113271,235,-17.07575
17/03/2020 10:48,2019,1,WESTERN EUROPE-EU,GERMANY,2,GLASGOW,HAMBURG,0,0,0,61,0,61,-100
17/03/2020 10:48,2019,1,WESTERN EUROPE-EU,GERMANY,2,GLASGOW,KARLSRUHE/BADEN BADEN,0,0,0,23,0,23,-100
17/03/2020 10:48,2019,1,WESTERN EUROPE-EU,GERMANY,2,GLASGOW,LEIPZIG,0,0,0,1396,0,1396,-100
17/03/2020 10:48,2019,1,WESTERN EUROPE-EU,GERMANY,2,GLASGOW,MUNICH,46694,46694,0,47873,47726,147,-2.46277
17/03/2020 10:48,2019,1,WESTERN EUROPE-EU,GERMANY,2,GUERNSEY,BERLIN (SCHONEFELD),101,0,101,0,0,0,0
17/03/2020 10:48,2019,1,WESTERN EUROPE-EU,GERMANY,2,GUERNSEY,DUSSELDORF,2854,2854,0,2827,2827,0,0.95508
17/03/2020 10:48,2019,1,WESTERN EUROPE-EU,GERMANY,2,HUMBERSIDE,BERLIN (TEGEL),147,0,147,0,0,0,0
17/03/2020 10:48,2019,1,WESTERN EUROPE-EU,GERMANY,2,HUMBERSIDE,BONN (HANGALAR),86,0,86,0,0,0,0
17/03/2020 10:48,2019,1,WESTERN EUROPE-EU,GERMANY,2,INVERNESS,MUNICH,0,0,0,94,0,94,-100
17/03/2020 10:48,2019,1,WESTERN EUROPE-EU,GERMANY,2,ISLE OF MAN,COLOGNE BONN,0,0,0,210,105,105,-100
17/03/2020 10:48,2019,1,WESTERN EUROPE-EU,GERMANY,2,JERSEY,BERLIN (SCHONEFELD),125,50,75,0,0,0,0
17/03/2020 10:48,2019,1,WESTERN EUROPE-EU,GERMANY,2,JERSEY,BERLIN (TEGEL),0,0,0,1567,1567,0,-100
17/03/2020 10:48,2019,1,WESTERN EUROPE-EU,GERMANY,2,JERSEY,BRAUNSCHWEIG,70,19,51,0,0,0,0
17/03/2020 10:48,2019,1,WESTERN EUROPE-EU,GERMANY,2,JERSEY,BREMEN,211,0,211,0,0,0,0
17/03/2020 10:48,2019,1,WESTERN EUROPE-EU,GERMANY,2,JERSEY,COLOGNE BONN,103,0,103,0,0,0,0
17/03/2020 10:48,2019,1,WESTERN EUROPE-EU,GERMANY,2,JERSEY,DORTMUND,87,0,87,0,0,0,0
17/03/2020 10:48,2019,1,WESTERN EUROPE-EU,GERMANY,2,JERSEY,DRESDEN,134,0,134,160,0,160,-16.25
17/03/2020 10:48,2019,1,WESTERN EUROPE-EU,GERMANY,2,JERSEY,DUSSELDORF,5187,4449,738,7306,6252,1054,-29.00356
17/03/2020 10:48,2019,1,WESTERN EUROPE-EU,GERMANY,2,JERSEY,ERFURT,97,0,97,311,0,311,-68.81029
17/03/2020 10:48,2019,1,WESTERN EUROPE-EU,GERMANY,2,JERSEY,FRANKFURT MAIN,197,0,197,143,0,143,37.76224
17/03/2020 10:48,2019,1,WESTERN EUROPE-EU,GERMANY,2,JERSEY,FRIEDRICHSHAFEN,161,0,161,0,0,0,0
17/03/2020 10:48,2019,1,WESTERN EUROPE-EU,GERMANY,2,JERSEY,HAMBURG,130,0,130,572,397,175,-77.27273
17/03/2020 10:48,2019,1,WESTERN EUROPE-EU,GERMANY,2,JERSEY,HANOVER,157,0,157,0,0,0,0
17/03/2020 10:48,2019,1,WESTERN EUROPE-EU,GERMANY,2,JERSEY,KASSEL,79,0,79,160,0,160,-50.625
17/03/2020 10:48,2019,1,WESTERN EUROPE-EU,GERMANY,2,JERSEY,LEIPZIG,119,0,119,0,0,0,0
17/03/2020 10:48,2019,1,WESTERN EUROPE-EU,GERMANY,2,JERSEY,MEMMINGEN ALLGAU,61,0,61,0,0,0,0
17/03/2020 10:48,2019,1,WESTERN EUROPE-EU,GERMANY,2,JERSEY,MUNICH,6645,6556,89,3991,3991,0,66.49962
17/03/2020 10:48,2019,1,WESTERN EUROPE-EU,GERMANY,2,JERSEY,MUNSTER-OSNABRUCK,67,0,67,0,0,0,0
17/03/2020 10:48,2019,1,WESTERN EUROPE-EU,GERMANY,2,JERSEY,PADERBORN,106,30,76,0,0,0,0
17/03/2020 10:48,2019,1,WESTERN EUROPE-EU,GERMANY,2,JERSEY,ROSTOCK-LAAGE,190,0,190,0,0,0,0
17/03/2020 10:48,2019,1,WESTERN EUROPE-EU,GERMANY,2,JERSEY,SAARBRUCKEN,148,0,148,175,0,175,-15.42857
17/03/2020 10:48,2019,1,WESTERN EUROPE-EU,GERMANY,2,JERSEY,STUTTGART,126,0,126,377,0,377,-66.57825
17/03/2020 10:48,2019,1,WESTERN EUROPE-EU,GERMANY,2,LEEDS BRADFORD,BERLIN (SCHONEFELD),575,575,0,21227,21227,0,-97.29119
17/03/2020 10:48,2019,1,WESTERN EUROPE-EU,GERMANY,2,LEEDS BRADFORD,COLOGNE BONN,375,375,0,373,373,0,0.53619
17/03/2020 10:48,2019,1,WESTERN EUROPE-EU,GERMANY,2,LEEDS BRADFORD,DUSSELDORF,26161,26161,0,32844,32844,0,-20.3477
17/03/2020 10:48,2019,1,WESTERN EUROPE-EU,GERMANY,2,LEEDS BRADFORD,FRANKFURT MAIN,0,0,0,47,47,0,-100
17/03/2020 10:48,2019,1,WESTERN EUROPE-EU,GERMANY,2,LEEDS BRADFORD,NUREMBERG,296,296,0,0,0,0,0
17/03/2020 10:48,2019,1,WESTERN EUROPE-EU,GERMANY,2,LIVERPOOL (JOHN LENNON),BERLIN (SCHONEFELD),61772,61772,0,65258,65258,0,-5.34187
17/03/2020 10:48,2019,1,WESTERN EUROPE-EU,GERMANY,2,LIVERPOOL (JOHN LENNON),BREMEN,96,0,96,0,0,0,0
17/03/2020 10:48,2019,1,WESTERN EUROPE-EU,GERMANY,2,LIVERPOOL (JOHN LENNON),FRANKFURT MAIN,122,0,122,0,0,0,0
17/03/2020 10:48,2019,1,WESTERN EUROPE-EU,GERMANY,2,LIVERPOOL (JOHN LENNON),MUNICH,1020,0,1020,0,0,0,0
17/03/2020 10:48,2019,1,WESTERN EUROPE-EU,GERMANY,2,MANCHESTER,BADEN BADEN,0,0,0,287,0,287,-100
17/03/2020 10:48,2019,1,WESTERN EUROPE-EU,GERMANY,2,MANCHESTER,BERLIN (SCHONEFELD),182670,182670,0,332579,332447,132,-45.0747
17/03/2020 10:48,2019,1,WESTERN EUROPE-EU,GERMANY,2,MANCHESTER,BERLIN (TEGEL),161604,161604,0,0,0,0,0
17/03/2020 10:48,2019,1,WESTERN EUROPE-EU,GERMANY,2,MANCHESTER,BRAUNSCHWEIG,0,0,0,336,0,336,-100
17/03/2020 10:48,2019,1,WESTERN EUROPE-EU,GERMANY,2,MANCHESTER,BREMEN,88,88,0,0,0,0,0
17/03/2020 10:48,2019,1,WESTERN EUROPE-EU,GERMANY,2,MANCHESTER,COLOGNE BONN,101310,100555,755,130116,130116,0,-22.13871
17/03/2020 10:48,2019,1,WESTERN EUROPE-EU,GERMANY,2,MANCHESTER,DRESDEN,691,0,691,0,0,0,0
17/03/2020 10:48,2019,1,WESTERN EUROPE-EU,GERMANY,2,MANCHESTER,DUSSELDORF,319719,319568,151,271722,271722,0,17.66401
17/03/2020 10:48,2019,1,WESTERN EUROPE-EU,GERMANY,2,MANCHESTER,FRANKFURT MAIN,509892,509892,0,526188,525942,246,-3.09699
17/03/2020 10:48,2019,1,WESTERN EUROPE-EU,GERMANY,2,MANCHESTER,HAHN,40,40,0,293,0,293,-86.34812
17/03/2020 10:48,2019,1,WESTERN EUROPE-EU,GERMANY,2,MANCHESTER,HAMBURG,201402,201402,0,226171,226171,0,-10.95145
17/03/2020 10:48,2019,1,WESTERN EUROPE-EU,GERMANY,2,MANCHESTER,HANOVER,27790,27543,247,36737,36641,96,-24.35419
17/03/2020 10:48,2019,1,WESTERN EUROPE-EU,GERMANY,2,MANCHESTER,LEIPZIG,45,0,45,0,0,0,0
17/03/2020 10:48,2019,1,WESTERN EUROPE-EU,GERMANY,2,MANCHESTER,MUNICH,357216,354898,2318,344957,344270,687,3.55378
17/03/2020 10:48,2019,1,WESTERN EUROPE-EU,GERMANY,2,MANCHESTER,MUNSTER-OSNABRUCK,360,0,360,0,0,0,0
17/03/2020 10:48,2019,1,WESTERN EUROPE-EU,GERMANY,2,MANCHESTER,NUREMBERG,18806,18806,0,86181,86181,0,-78.17848
17/03/2020 10:48,2019,1,WESTERN EUROPE-EU,GERMANY,2,MANCHESTER,STUTTGART,15389,15389,0,78791,78791,0,-80.46858
17/03/2020 10:48,2019,1,WESTERN EUROPE-EU,GERMANY,2,NEWCASTLE,AUGSBURG/MUELHAUSEN,0,0,0,32,0,32,-100
17/03/2020 10:48,2019,1,WESTERN EUROPE-EU,GERMANY,2,NEWCASTLE,BERLIN (SCHONEFELD),7414,7414,0,40155,40155,0,-81.53655
17/03/2020 10:48,2019,1,WESTERN EUROPE-EU,GERMANY,2,NEWCASTLE,COLOGNE BONN,362,362,0,20,0,20,1710
17/03/2020 10:48,2019,1,WESTERN EUROPE-EU,GERMANY,2,NEWCASTLE,DUSSELDORF,42254,42254,0,38259,38259,0,10.44199
17/03/2020 10:48,2019,1,WESTERN EUROPE-EU,GERMANY,2,NEWCASTLE,MEMMINGEN ALLGAU,328,0,328,0,0,0,0
17/03/2020 10:48,2019,1,WESTERN EUROPE-EU,GERMANY,2,NEWCASTLE,MUNICH,0,0,0,283,283,0,-100
17/03/2020 10:48,2019,1,WESTERN EUROPE-EU,GERMANY,2,NEWCASTLE,NUREMBERG,369,369,0,0,0,0,0
17/03/2020 10:48,2019,1,WESTERN EUROPE-EU,GERMANY,2,NEWQUAY,BERLIN (TEGEL),0,0,0,1135,1135,0,-100
17/03/2020 10:48,2019,1,WESTERN EUROPE-EU,GERMANY,2,NEWQUAY,DUSSELDORF,4244,4244,0,2678,2678,0,58.47647
17/03/2020 10:48,2019,1,WESTERN EUROPE-EU,GERMANY,2,NEWQUAY,HAHN,0,0,0,17617,17617,0,-100
17/03/2020 10:48,2019,1,WESTERN EUROPE-EU,GERMANY,2,NEWQUAY,STUTTGART,1979,1979,0,2007,2007,0,-1.39512
17/03/2020 10:48,2019,1,WESTERN EUROPE-EU,GERMANY,2,NORWICH,DORTMUND,62,0,62,105,0,105,-40.95238
17/03/2020 10:48,2019,1,WESTERN EUROPE-EU,GERMANY,2,PRESTWICK,DUSSELDORF,15,0,15,0,0,0,0
17/03/2020 10:48,2019,1,WESTERN EUROPE-EU,GERMANY,2,PRESTWICK,FRANKFURT MAIN,0,0,0,135,0,135,-100
17/03/2020 10:48,2019,1,WESTERN EUROPE-EU,GERMANY,2,SOUTHAMPTON,BREMEN,0,0,0,134,134,0,-100
17/03/2020 10:48,2019,1,WESTERN EUROPE-EU,GERMANY,2,SOUTHAMPTON,DUSSELDORF,24716,24716,0,30856,30762,94,-19.89889
17/03/2020 10:48,2019,1,WESTERN EUROPE-EU,GERMANY,2,SOUTHAMPTON,FRIEDRICHSHAFEN,0,0,0,20,0,20,-100
17/03/2020 10:48,2019,1,WESTERN EUROPE-EU,GERMANY,2,SOUTHAMPTON,HAMBURG,26,26,0,129,0,129,-79.84496
17/03/2020 10:48,2019,1,WESTERN EUROPE-EU,GERMANY,2,SOUTHAMPTON,MUNICH,65,65,0,4878,4878,0,-98.66749
17/03/2020 10:48,2019,1,WESTERN EUROPE-EU,GERMANY,2,TEESSIDE INTERNATIONAL AIRPORT,STUTTGART,60,0,60,0,0,0,0
17/03/2020 10:48,2019,1,WESTERN EUROPE-EU,GIBRALTAR,1,GATWICK,GIBRALTAR,193394,193394,0,188144,187989,155,2.79042
17/03/2020 10:48,2019,1,WESTERN EUROPE-EU,GIBRALTAR,1,HEATHROW,GIBRALTAR,162975,162975,0,152710,152710,0,6.72189
17/03/2020 10:48,2019,1,WESTERN EUROPE-EU,GIBRALTAR,1,LUTON,GIBRALTAR,25609,25609,0,2120,2120,0,1107.9717
17/03/2020 10:48,2019,1,WESTERN EUROPE-EU,GIBRALTAR,1,STANSTED,GIBRALTAR,72,0,72,0,0,0,0
17/03/2020 10:48,2019,1,WESTERN EUROPE-EU,GIBRALTAR,2,BIRMINGHAM,GIBRALTAR,0,0,0,303,135,168,-100
17/03/2020 10:48,2019,1,WESTERN EUROPE-EU,GIBRALTAR,2,BRISTOL,GIBRALTAR,49986,49986,0,48081,48081,0,3.96206
17/03/2020 10:48,2019,1,WESTERN EUROPE-EU,GIBRALTAR,2,CARDIFF WALES,GIBRALTAR,58,0,58,0,0,0,0
17/03/2020 10:48,2019,1,WESTERN EUROPE-EU,GIBRALTAR,2,GLASGOW,GIBRALTAR,172,0,172,0,0,0,0
17/03/2020 10:48,2019,1,WESTERN EUROPE-EU,GIBRALTAR,2,GUERNSEY,GIBRALTAR,309,0,309,0,0,0,0
17/03/2020 10:48,2019,1,WESTERN EUROPE-EU,GIBRALTAR,2,JERSEY,GIBRALTAR,411,0,411,0,0,0,0
17/03/2020 10:48,2019,1,WESTERN EUROPE-EU,GIBRALTAR,2,MANCHESTER,GIBRALTAR,51046,51046,0,43837,43837,0,16.44501
17/03/2020 10:48,2019,1,WESTERN EUROPE-EU,GREECE,1,GATWICK,ATHENS,225636,225571,65,202016,202016,0,11.69214
17/03/2020 10:48,2019,1,WESTERN EUROPE-EU,GREECE,1,GATWICK,CHANIA,122304,89771,32533,126705,87312,39393,-3.47342
17/03/2020 10:48,2019,1,WESTERN EUROPE-EU,GREECE,1,GATWICK,CORFU,217565,165292,52273,233799,172869,60930,-6.94357
17/03/2020 10:48,2019,1,WESTERN EUROPE-EU,GREECE,1,GATWICK,HERAKLION,270599,222315,48284,274029,224006,50023,-1.25169
17/03/2020 10:48,2019,1,WESTERN EUROPE-EU,GREECE,1,GATWICK,KALAMATA,35092,35028,64,37857,37857,0,-7.3038
17/03/2020 10:48,2019,1,WESTERN EUROPE-EU,GREECE,1,GATWICK,KAVALA,20559,7125,13434,32898,19431,13467,-37.50684
17/03/2020 10:48,2019,1,WESTERN EUROPE-EU,GREECE,1,GATWICK,KEFALLINIA,121342,93428,27914,126441,95723,30718,-4.03271
17/03/2020 10:48,2019,1,WESTERN EUROPE-EU,GREECE,1,GATWICK,KOS,135315,73434,61881,124297,58784,65513,8.86425
17/03/2020 10:48,2019,1,WESTERN EUROPE-EU,GREECE,1,GATWICK,LEMNOS,2955,2819,136,1065,0,1065,177.46479
17/03/2020 10:48,2019,1,WESTERN EUROPE-EU,GREECE,1,GATWICK,MIKONOS,96128,95778,350,87815,87815,0,9.46649
17/03/2020 10:48,2019,1,WESTERN EUROPE-EU,GREECE,1,GATWICK,MYTILINI,8838,8838,0,9244,9244,0,-4.39204
17/03/2020 10:48,2019,1,WESTERN EUROPE-EU,GREECE,1,GATWICK,PREVEZA,83669,53227,30442,74887,39219,35668,11.727
17/03/2020 10:48,2019,1,WESTERN EUROPE-EU,GREECE,1,GATWICK,RHODES,194289,133767,60522,192095,132033,60062,1.14214
17/03/2020 10:48,2019,1,WESTERN EUROPE-EU,GREECE,1,GATWICK,SALONIKA,186533,168858,17675,165304,146739,18565,12.8424
17/03/2020 10:48,2019,1,WESTERN EUROPE-EU,GREECE,1,GATWICK,SAMOS,8553,1512,7041,10219,0,10219,-16.30297
17/03/2020 10:48,2019,1,WESTERN EUROPE-EU,GREECE,1,GATWICK,SKIATHOS,42396,24114,18282,46281,26139,20142,-8.39437
17/03/2020 10:48,2019,1,WESTERN EUROPE-EU,GREECE,1,GATWICK,THIRA (SANTORINI),115333,107261,8072,118106,108306,9800,-2.34789
17/03/2020 10:48,2019,1,WESTERN EUROPE-EU,GREECE,1,GATWICK,VOLOS NEA ANCHILOS,13585,10306,3279,7806,6237,1569,74.0328
17/03/2020 10:48,2019,1,WESTERN EUROPE-EU,GREECE,1,GATWICK,ZAKINTHOS,137263,96639,40624,145669,102997,42672,-5.77062
17/03/2020 10:48,2019,1,WESTERN EUROPE-EU,GREECE,1,HEATHROW,ATHENS,748688,748688,0,753589,753589,0,-0.65035
17/03/2020 10:48,2019,1,WESTERN EUROPE-EU,GREECE,1,HEATHROW,CHANIA,21036,21036,0,13449,13449,0,56.41312
17/03/2020 10:48,2019,1,WESTERN EUROPE-EU,GREECE,1,HEATHROW,CORFU,90653,84848,5805,65992,60958,5034,37.36968
17/03/2020 10:48,2019,1,WESTERN EUROPE-EU,GREECE,1,HEATHROW,KALAMATA,25966,17484,8482,23157,13165,9992,12.13024
17/03/2020 10:48,2019,1,WESTERN EUROPE-EU,GREECE,1,HEATHROW,KEFALLINIA,16594,11172,5422,16194,11189,5005,2.47005
17/03/2020 10:48,2019,1,WESTERN EUROPE-EU,GREECE,1,HEATHROW,KOS,0,0,0,2260,0,2260,-100
17/03/2020 10:48,2019,1,WESTERN EUROPE-EU,GREECE,1,HEATHROW,LEMNOS,15521,0,15521,15361,0,15361,1.0416
17/03/2020 10:48,2019,1,WESTERN EUROPE-EU,GREECE,1,HEATHROW,MIKONOS,45918,45918,0,36840,36840,0,24.64169
17/03/2020 10:48,2019,1,WESTERN EUROPE-EU,GREECE,1,HEATHROW,PREVEZA,30261,15007,15254,17354,208,17146,74.37478
17/03/2020 10:48,2019,1,WESTERN EUROPE-EU,GREECE,1,HEATHROW,RHODES,9170,0,9170,11192,0,11192,-18.06648
17/03/2020 10:48,2019,1,WESTERN EUROPE-EU,GREECE,1,HEATHROW,THIRA (SANTORINI),45106,45106,0,35393,35393,0,27.44328
17/03/2020 10:48,2019,1,WESTERN EUROPE-EU,GREECE,1,HEATHROW,ZAKINTHOS,9943,9943,0,10096,10096,0,-1.51545
17/03/2020 10:48,2019,1,WESTERN EUROPE-EU,GREECE,1,LONDON CITY,MIKONOS,14433,14433,0,8314,8314,0,73.59875
17/03/2020 10:48,2019,1,WESTERN EUROPE-EU,GREECE,1,LONDON CITY,SKIATHOS,5889,5889,0,3961,3961,0,48.67458
17/03/2020 10:48,2019,1,WESTERN EUROPE-EU,GREECE,1,LONDON CITY,THIRA (SANTORINI),3256,3256,0,3268,3268,0,-0.3672
17/03/2020 10:48,2019,1,WESTERN EUROPE-EU,GREECE,1,LUTON,ATHENS,244994,244994,0,99859,99859,0,145.33993
17/03/2020 10:48,2019,1,WESTERN EUROPE-EU,GREECE,1,LUTON,CHANIA,0,0,0,169,169,0,-100
17/03/2020 10:48,2019,1,WESTERN EUROPE-EU,GREECE,1,LUTON,CORFU,65949,55944,10005,67662,58139,9523,-2.5317
17/03/2020 10:48,2019,1,WESTERN EUROPE-EU,GREECE,1,LUTON,HERAKLION,33555,31394,2161,32740,32740,0,2.48931
17/03/2020 10:48,2019,1,WESTERN EUROPE-EU,GREECE,1,LUTON,KEFALLINIA,0,0,0,6813,0,6813,-100
17/03/2020 10:48,2019,1,WESTERN EUROPE-EU,GREECE,1,LUTON,MIKONOS,19929,19929,0,17758,17758,0,12.22548
17/03/2020 10:48,2019,1,WESTERN EUROPE-EU,GREECE,1,LUTON,RHODES,42546,20502,22044,37972,18025,19947,12.04572
17/03/2020 10:48,2019,1,WESTERN EUROPE-EU,GREECE,1,LUTON,SALONIKA,48950,40124,8826,9026,9026,0,442.32218
17/03/2020 10:48,2019,1,WESTERN EUROPE-EU,GREECE,1,LUTON,SKIATHOS,6129,0,6129,8018,0,8018,-23.55949
17/03/2020 10:48,2019,1,WESTERN EUROPE-EU,GREECE,1,LUTON,ZAKINTHOS,10381,0,10381,10786,0,10786,-3.75487
17/03/2020 10:48,2019,1,WESTERN EUROPE-EU,GREECE,1,SOUTHEND,CORFU,20793,20793,0,0,0,0,0
17/03/2020 10:48,2019,1,WESTERN EUROPE-EU,GREECE,1,STANSTED,ATHENS,194579,193018,1561,209683,209683,0,-7.20325
17/03/2020 10:48,2019,1,WESTERN EUROPE-EU,GREECE,1,STANSTED,CHANIA,45650,45650,0,31553,31553,0,44.67721
17/03/2020 10:48,2019,1,WESTERN EUROPE-EU,GREECE,1,STANSTED,CORFU,89281,73706,15575,86222,70930,15292,3.54782
17/03/2020 10:48,2019,1,WESTERN EUROPE-EU,GREECE,1,STANSTED,HERAKLION,67734,51087,16647,57580,41609,15971,17.6346
17/03/2020 10:48,2019,1,WESTERN EUROPE-EU,GREECE,1,STANSTED,KALAMATA,5855,5855,0,0,0,0,0
17/03/2020 10:48,2019,1,WESTERN EUROPE-EU,GREECE,1,STANSTED,KAVALA,0,0,0,182,182,0,-100
17/03/2020 10:48,2019,1,WESTERN EUROPE-EU,GREECE,1,STANSTED,KEFALLINIA,38229,30514,7715,48874,40405,8469,-21.7805
17/03/2020 10:48,2019,1,WESTERN EUROPE-EU,GREECE,1,STANSTED,KOS,41632,33279,8353,42626,33848,8778,-2.33191
17/03/2020 10:48,2019,1,WESTERN EUROPE-EU,GREECE,1,STANSTED,MIKONOS,2578,2578,0,0,0,0,0
17/03/2020 10:48,2019,1,WESTERN EUROPE-EU,GREECE,1,STANSTED,MYTILINI,73,0,73,0,0,0,0
17/03/2020 10:48,2019,1,WESTERN EUROPE-EU,GREECE,1,STANSTED,PREVEZA,8414,5752,2662,5780,0,5780,45.57093
17/03/2020 10:48,2019,1,WESTERN EUROPE-EU,GREECE,1,STANSTED,RHODES,96246,77505,18741,95025,77542,17483,1.28493
17/03/2020 10:48,2019,1,WESTERN EUROPE-EU,GREECE,1,STANSTED,SALONIKA,136253,136253,0,128837,128837,0,5.75611
17/03/2020 10:48,2019,1,WESTERN EUROPE-EU,GREECE,1,STANSTED,SKIATHOS,7889,7889,0,8477,8477,0,-6.93642
17/03/2020 10:48,2019,1,WESTERN EUROPE-EU,GREECE,1,STANSTED,ZAKINTHOS,73550,66246,7304,78162,70380,7782,-5.90057
17/03/2020 10:48,2019,1,WESTERN EUROPE-EU,GREECE,2,ABERDEEN,CORFU,9053,0,9053,8851,0,8851,2.28223
17/03/2020 10:48,2019,1,WESTERN EUROPE-EU,GREECE,2,ABERDEEN,RHODES,7169,0,7169,0,0,0,0
17/03/2020 10:48,2019,1,WESTERN EUROPE-EU,GREECE,2,BELFAST INTERNATIONAL,CORFU,7341,0,7341,7175,0,7175,2.31359
17/03/2020 10:48,2019,1,WESTERN EUROPE-EU,GREECE,2,BELFAST INTERNATIONAL,HERAKLION,9203,9203,0,8979,8979,0,2.49471
17/03/2020 10:48,2019,1,WESTERN EUROPE-EU,GREECE,2,BELFAST INTERNATIONAL,RHODES,15701,9255,6446,15380,8988,6392,2.08713
17/03/2020 10:48,2019,1,WESTERN EUROPE-EU,GREECE,2,BELFAST INTERNATIONAL,ZAKINTHOS,6406,6406,0,6497,6497,0,-1.40065
17/03/2020 10:48,2019,1,WESTERN EUROPE-EU,GREECE,2,BIGGIN HILL,ATHENS,24,0,24,6,0,6,300
17/03/2020 10:48,2019,1,WESTERN EUROPE-EU,GREECE,2,BIGGIN HILL,CORFU,19,0,19,0,0,0,0
17/03/2020 10:48,2019,1,WESTERN EUROPE-EU,GREECE,2,BIGGIN HILL,KALAMATA,0,0,0,4,0,4,-100
17/03/2020 10:48,2019,1,WESTERN EUROPE-EU,GREECE,2,BIGGIN HILL,SALONIKA,3,0,3,8,0,8,-62.5
17/03/2020 10:48,2019,1,WESTERN EUROPE-EU,GREECE,2,BIRMINGHAM,ATHENS,675,0,675,0,0,0,0
17/03/2020 10:48,2019,1,WESTERN EUROPE-EU,GREECE,2,BIRMINGHAM,CHANIA,44892,29624,15268,31162,21874,9288,44.06007
17/03/2020 10:48,2019,1,WESTERN EUROPE-EU,GREECE,2,BIRMINGHAM,CORFU,92846,52988,39858,84382,45799,38583,10.03058
17/03/2020 10:48,2019,1,WESTERN EUROPE-EU,GREECE,2,BIRMINGHAM,HERAKLION,81976,55470,26506,74017,49280,24737,10.75294
17/03/2020 10:48,2019,1,WESTERN EUROPE-EU,GREECE,2,BIRMINGHAM,KALAMATA,7577,7285,292,7938,7938,0,-4.54775
17/03/2020 10:48,2019,1,WESTERN EUROPE-EU,GREECE,2,BIRMINGHAM,KAVALA,6564,0,6564,6678,0,6678,-1.7071
17/03/2020 10:48,2019,1,WESTERN EUROPE-EU,GREECE,2,BIRMINGHAM,KEFALLINIA,25450,6480,18970,28974,8719,20255,-12.16263
17/03/2020 10:48,2019,1,WESTERN EUROPE-EU,GREECE,2,BIRMINGHAM,KOS,52912,34452,18460,53116,35135,17981,-0.38407
17/03/2020 10:48,2019,1,WESTERN EUROPE-EU,GREECE,2,BIRMINGHAM,MYTILINI,8301,8076,225,8479,8479,0,-2.0993
17/03/2020 10:48,2019,1,WESTERN EUROPE-EU,GREECE,2,BIRMINGHAM,PREVEZA,2874,0,2874,2990,0,2990,-3.8796
17/03/2020 10:48,2019,1,WESTERN EUROPE-EU,GREECE,2,BIRMINGHAM,RHODES,86221,50019,36202,83600,46531,37069,3.13517
17/03/2020 10:48,2019,1,WESTERN EUROPE-EU,GREECE,2,BIRMINGHAM,SALONIKA,15529,6801,8728,13543,13543,0,14.6644
17/03/2020 10:48,2019,1,WESTERN EUROPE-EU,GREECE,2,BIRMINGHAM,SKIATHOS,17259,0,17259,17454,0,17454,-1.11722
17/03/2020 10:48,2019,1,WESTERN EUROPE-EU,GREECE,2,BIRMINGHAM,THIRA (SANTORINI),14524,7844,6680,13426,6919,6507,8.17816
17/03/2020 10:48,2019,1,WESTERN EUROPE-EU,GREECE,2,BIRMINGHAM,ZAKINTHOS,82403,54283,28120,90465,63774,26691,-8.91173
17/03/2020 10:48,2019,1,WESTERN EUROPE-EU,GREECE,2,BOURNEMOUTH,CORFU,8903,0,8903,7788,0,7788,14.3169
17/03/2020 10:48,2019,1,WESTERN EUROPE-EU,GREECE,2,BOURNEMOUTH,HERAKLION,7638,0,7638,0,0,0,0
17/03/2020 10:48,2019,1,WESTERN EUROPE-EU,GREECE,2,BOURNEMOUTH,KEFALLINIA,7191,2,7189,0,0,0,0
17/03/2020 10:48,2019,1,WESTERN EUROPE-EU,GREECE,2,BOURNEMOUTH,RHODES,9434,0,9434,8975,188,8787,5.11421
17/03/2020 10:48,2019,1,WESTERN EUROPE-EU,GREECE,2,BRISTOL,ATHENS,38490,38490,0,35199,35199,0,9.3497
17/03/2020 10:48,2019,1,WESTERN EUROPE-EU,GREECE,2,BRISTOL,CHANIA,27411,21030,6381,29161,21021,8140,-6.00117
17/03/2020 10:48,2019,1,WESTERN EUROPE-EU,GREECE,2,BRISTOL,CORFU,65793,43135,22658,73290,46511,26779,-10.22923
17/03/2020 10:48,2019,1,WESTERN EUROPE-EU,GREECE,2,BRISTOL,HERAKLION,46725,27985,18740,47815,29387,18428,-2.27962
17/03/2020 10:48,2019,1,WESTERN EUROPE-EU,GREECE,2,BRISTOL,KEFALLINIA,40927,27922,13005,33178,24655,8523,23.35584
17/03/2020 10:48,2019,1,WESTERN EUROPE-EU,GREECE,2,BRISTOL,KOS,21908,7195,14713,25631,9543,16088,-14.52538
17/03/2020 10:48,2019,1,WESTERN EUROPE-EU,GREECE,2,BRISTOL,PREVEZA,7811,7811,0,6916,6916,0,12.94101
17/03/2020 10:48,2019,1,WESTERN EUROPE-EU,GREECE,2,BRISTOL,RHODES,45685,21216,24469,34990,7512,27478,30.56588
17/03/2020 10:48,2019,1,WESTERN EUROPE-EU,GREECE,2,BRISTOL,SALONIKA,8154,0,8154,0,0,0,0
17/03/2020 10:48,2019,1,WESTERN EUROPE-EU,GREECE,2,BRISTOL,SKIATHOS,13797,7336,6461,13398,8093,5305,2.97806
17/03/2020 10:48,2019,1,WESTERN EUROPE-EU,GREECE,2,BRISTOL,THIRA (SANTORINI),5685,0,5685,7506,0,7506,-24.26059
17/03/2020 10:48,2019,1,WESTERN EUROPE-EU,GREECE,2,BRISTOL,ZAKINTHOS,67861,44307,23554,71948,44435,27513,-5.68049
17/03/2020 10:48,2019,1,WESTERN EUROPE-EU,GREECE,2,CARDIFF WALES,ATHENS,0,0,0,174,174,0,-100
17/03/2020 10:48,2019,1,WESTERN EUROPE-EU,GREECE,2,CARDIFF WALES,CHANIA,0,0,0,184,0,184,-100
17/03/2020 10:48,2019,1,WESTERN EUROPE-EU,GREECE,2,CARDIFF WALES,CORFU,16768,0,16768,9332,0,9332,79.68281
17/03/2020 10:48,2019,1,WESTERN EUROPE-EU,GREECE,2,CARDIFF WALES,HERAKLION,7159,0,7159,9404,0,9404,-23.87282
17/03/2020 10:48,2019,1,WESTERN EUROPE-EU,GREECE,2,CARDIFF WALES,KEFALLINIA,7229,0,7229,7553,0,7553,-4.28969
17/03/2020 10:48,2019,1,WESTERN EUROPE-EU,GREECE,2,CARDIFF WALES,KOS,16637,0,16637,7667,0,7667,116.99491
17/03/2020 10:48,2019,1,WESTERN EUROPE-EU,GREECE,2,CARDIFF WALES,RHODES,26907,0,26907,17438,0,17438,54.30095
17/03/2020 10:48,2019,1,WESTERN EUROPE-EU,GREECE,2,CARDIFF WALES,ZAKINTHOS,30725,0,30725,21638,0,21638,41.99556
17/03/2020 10:48,2019,1,WESTERN EUROPE-EU,GREECE,2,DONCASTER SHEFFIELD,CORFU,16992,0,16992,16614,0,16614,2.27519
17/03/2020 10:48,2019,1,WESTERN EUROPE-EU,GREECE,2,DONCASTER SHEFFIELD,HERAKLION,0,0,0,6690,0,6690,-100
17/03/2020 10:48,2019,1,WESTERN EUROPE-EU,GREECE,2,DONCASTER SHEFFIELD,KEFALLINIA,6953,0,6953,7321,188,7133,-5.02664
17/03/2020 10:48,2019,1,WESTERN EUROPE-EU,GREECE,2,DONCASTER SHEFFIELD,KOS,8841,0,8841,0,0,0,0
17/03/2020 10:48,2019,1,WESTERN EUROPE-EU,GREECE,2,DONCASTER SHEFFIELD,RHODES,18783,0,18783,9576,185,9391,96.14662
17/03/2020 10:48,2019,1,WESTERN EUROPE-EU,GREECE,2,DONCASTER SHEFFIELD,ZAKINTHOS,16832,0,16832,8040,0,8040,109.35323
17/03/2020 10:48,2019,1,WESTERN EUROPE-EU,GREECE,2,EAST MIDLANDS INTERNATIONAL,CHANIA,11025,11025,0,10391,10391,0,6.10143
17/03/2020 10:48,2019,1,WESTERN EUROPE-EU,GREECE,2,EAST MIDLANDS INTERNATIONAL,CORFU,67728,52202,15526,74899,59786,15113,-9.57423
17/03/2020 10:48,2019,1,WESTERN EUROPE-EU,GREECE,2,EAST MIDLANDS INTERNATIONAL,HERAKLION,37153,20092,17061,43250,20815,22435,-14.09711
17/03/2020 10:48,2019,1,WESTERN EUROPE-EU,GREECE,2,EAST MIDLANDS INTERNATIONAL,KAVALA,3031,3031,0,3906,3906,0,-22.40143
17/03/2020 10:48,2019,1,WESTERN EUROPE-EU,GREECE,2,EAST MIDLANDS INTERNATIONAL,KEFALLINIA,12853,6150,6703,12333,5890,6443,4.21633
17/03/2020 10:48,2019,1,WESTERN EUROPE-EU,GREECE,2,EAST MIDLANDS INTERNATIONAL,KOS,27420,9112,18308,24911,8598,16313,10.07186
17/03/2020 10:48,2019,1,WESTERN EUROPE-EU,GREECE,2,EAST MIDLANDS INTERNATIONAL,RHODES,70199,46264,23935,62483,39536,22947,12.34896
17/03/2020 10:48,2019,1,WESTERN EUROPE-EU,GREECE,2,EAST MIDLANDS INTERNATIONAL,SALONIKA,6806,6806,0,13530,6107,7423,-49.69697
17/03/2020 10:48,2019,1,WESTERN EUROPE-EU,GREECE,2,EAST MIDLANDS INTERNATIONAL,SKIATHOS,4200,4200,0,4913,4913,0,-14.51252
17/03/2020 10:48,2019,1,WESTERN EUROPE-EU,GREECE,2,EAST MIDLANDS INTERNATIONAL,THIRA (SANTORINI),7216,374,6842,0,0,0,0
17/03/2020 10:48,2019,1,WESTERN EUROPE-EU,GREECE,2,EAST MIDLANDS INTERNATIONAL,ZAKINTHOS,65945,40946,24999,69936,46262,23674,-5.70665
17/03/2020 10:48,2019,1,WESTERN EUROPE-EU,GREECE,2,EDINBURGH,ATHENS,60079,60079,0,53332,53332,0,12.65094
17/03/2020 10:48,2019,1,WESTERN EUROPE-EU,GREECE,2,EDINBURGH,CORFU,36802,27674,9128,19698,10520,9178,86.83115
17/03/2020 10:48,2019,1,WESTERN EUROPE-EU,GREECE,2,EDINBURGH,HERAKLION,32145,32145,0,37110,37110,0,-13.37914
17/03/2020 10:48,2019,1,WESTERN EUROPE-EU,GREECE,2,EDINBURGH,KALAMATA,0,0,0,56,0,56,-100
17/03/2020 10:48,2019,1,WESTERN EUROPE-EU,GREECE,2,EDINBURGH,KEFALLINIA,6748,6748,0,6086,6086,0,10.87742
17/03/2020 10:48,2019,1,WESTERN EUROPE-EU,GREECE,2,EDINBURGH,KOS,8089,8089,0,8166,8166,0,-0.94293
17/03/2020 10:48,2019,1,WESTERN EUROPE-EU,GREECE,2,EDINBURGH,RHODES,22218,14396,7822,17772,8754,9018,25.01688
17/03/2020 10:48,2019,1,WESTERN EUROPE-EU,GREECE,2,EDINBURGH,SALONIKA,7246,7246,0,6819,6819,0,6.26192
17/03/2020 10:48,2019,1,WESTERN EUROPE-EU,GREECE,2,EDINBURGH,ZAKINTHOS,12728,12728,0,14093,14093,0,-9.68566
17/03/2020 10:48,2019,1,WESTERN EUROPE-EU,GREECE,2,EXETER,CORFU,9028,0,9028,9259,0,9259,-2.49487
17/03/2020 10:48,2019,1,WESTERN EUROPE-EU,GREECE,2,EXETER,HERAKLION,9016,0,9016,0,0,0,0
17/03/2020 10:48,2019,1,WESTERN EUROPE-EU,GREECE,2,EXETER,RHODES,7438,0,7438,7376,0,7376,0.84056
17/03/2020 10:48,2019,1,WESTERN EUROPE-EU,GREECE,2,EXETER,ZAKINTHOS,7681,0,7681,0,0,0,0
17/03/2020 10:48,2019,1,WESTERN EUROPE-EU,GREECE,2,GLASGOW,ATHENS,0,0,0,275,0,275,-100
17/03/2020 10:48,2019,1,WESTERN EUROPE-EU,GREECE,2,GLASGOW,CHANIA,0,0,0,10143,10143,0,-100
17/03/2020 10:48,2019,1,WESTERN EUROPE-EU,GREECE,2,GLASGOW,CORFU,21793,12720,9073,32426,22780,9646,-32.79159
17/03/2020 10:48,2019,1,WESTERN EUROPE-EU,GREECE,2,GLASGOW,HERAKLION,37634,29261,8373,52685,43030,9655,-28.5679
17/03/2020 10:48,2019,1,WESTERN EUROPE-EU,GREECE,2,GLASGOW,KEFALLINIA,6846,6846,0,6777,6777,0,1.01815
17/03/2020 10:48,2019,1,WESTERN EUROPE-EU,GREECE,2,GLASGOW,KOS,25597,25597,0,27846,27846,0,-8.07656
17/03/2020 10:48,2019,1,WESTERN EUROPE-EU,GREECE,2,GLASGOW,RHODES,33819,25051,8768,27479,27479,0,23.07216
17/03/2020 10:48,2019,1,WESTERN EUROPE-EU,GREECE,2,GLASGOW,SALONIKA,0,0,0,5808,5808,0,-100
17/03/2020 10:48,2019,1,WESTERN EUROPE-EU,GREECE,2,GLASGOW,ZAKINTHOS,31869,23063,8806,34685,25855,8830,-8.11878
17/03/2020 10:48,2019,1,WESTERN EUROPE-EU,GREECE,2,LEEDS BRADFORD,CHANIA,28405,28405,0,20472,20472,0,38.75049
17/03/2020 10:48,2019,1,WESTERN EUROPE-EU,GREECE,2,LEEDS BRADFORD,CORFU,40489,32026,8463,41864,29118,12746,-3.28444
17/03/2020 10:48,2019,1,WESTERN EUROPE-EU,GREECE,2,LEEDS BRADFORD,HERAKLION,34865,34865,0,31923,31734,189,9.21593
17/03/2020 10:48,2019,1,WESTERN EUROPE-EU,GREECE,2,LEEDS BRADFORD,KEFALLINIA,15120,15120,0,13092,13092,0,15.49038
17/03/2020 10:48,2019,1,WESTERN EUROPE-EU,GREECE,2,LEEDS BRADFORD,KOS,22755,22755,0,18709,18709,0,21.62596
17/03/2020 10:48,2019,1,WESTERN EUROPE-EU,GREECE,2,LEEDS BRADFORD,RHODES,26647,26647,0,35732,26741,8991,-25.42539
17/03/2020 10:48,2019,1,WESTERN EUROPE-EU,GREECE,2,LEEDS BRADFORD,SALONIKA,10660,10660,0,10220,10220,0,4.30528
17/03/2020 10:48,2019,1,WESTERN EUROPE-EU,GREECE,2,LEEDS BRADFORD,ZAKINTHOS,16976,16976,0,17513,17513,0,-3.06629
17/03/2020 10:48,2019,1,WESTERN EUROPE-EU,GREECE,2,LIVERPOOL (JOHN LENNON),CHANIA,0,0,0,186,186,0,-100
17/03/2020 10:48,2019,1,WESTERN EUROPE-EU,GREECE,2,LIVERPOOL (JOHN LENNON),CORFU,11876,11876,0,0,0,0,0
17/03/2020 10:48,2019,1,WESTERN EUROPE-EU,GREECE,2,LIVERPOOL (JOHN LENNON),MIKONOS,0,0,0,181,181,0,-100
17/03/2020 10:48,2019,1,WESTERN EUROPE-EU,GREECE,2,LIVERPOOL (JOHN LENNON),RHODES,17822,17822,0,17690,17690,0,0.74618
17/03/2020 10:48,2019,1,WESTERN EUROPE-EU,GREECE,2,LIVERPOOL (JOHN LENNON),ZAKINTHOS,16761,16761,0,16583,16583,0,1.07339
17/03/2020 10:48,2019,1,WESTERN EUROPE-EU,GREECE,2,MANCHESTER,ATHENS,110852,110157,695,97573,97274,299,13.6093
17/03/2020 10:48,2019,1,WESTERN EUROPE-EU,GREECE,2,MANCHESTER,CHANIA,70086,46938,23148,55083,29522,25561,27.23708
17/03/2020 10:48,2019,1,WESTERN EUROPE-EU,GREECE,2,MANCHESTER,CORFU,155057,115119,39938,172981,122611,50370,-10.36183
17/03/2020 10:48,2019,1,WESTERN EUROPE-EU,GREECE,2,MANCHESTER,HERAKLION,172434,123666,48768,188327,131298,57029,-8.43904
17/03/2020 10:48,2019,1,WESTERN EUROPE-EU,GREECE,2,MANCHESTER,KALAMATA,27962,27962,0,17938,17938,0,55.88137
17/03/2020 10:48,2019,1,WESTERN EUROPE-EU,GREECE,2,MANCHESTER,KAVALA,13338,6063,7275,21901,13715,8186,-39.09867
17/03/2020 10:48,2019,1,WESTERN EUROPE-EU,GREECE,2,MANCHESTER,KEFALLINIA,86533,54573,31960,93771,56401,37370,-7.7188
17/03/2020 10:48,2019,1,WESTERN EUROPE-EU,GREECE,2,MANCHESTER,KOS,97981,50981,47000,114735,65046,49689,-14.60234
17/03/2020 10:48,2019,1,WESTERN EUROPE-EU,GREECE,2,MANCHESTER,MIKONOS,28149,28149,0,28198,28198,0,-0.17377
17/03/2020 10:48,2019,1,WESTERN EUROPE-EU,GREECE,2,MANCHESTER,MYTILINI,8190,8190,0,8463,8463,0,-3.22581
17/03/2020 10:48,2019,1,WESTERN EUROPE-EU,GREECE,2,MANCHESTER,PREVEZA,43910,31865,12045,50130,34608,15522,-12.40774
17/03/2020 10:48,2019,1,WESTERN EUROPE-EU,GREECE,2,MANCHESTER,RHODES,159866,101801,58065,156904,89316,67588,1.88778
17/03/2020 10:48,2019,1,WESTERN EUROPE-EU,GREECE,2,MANCHESTER,SALONIKA,115869,102133,13736,87744,73750,13994,32.05347
17/03/2020 10:48,2019,1,WESTERN EUROPE-EU,GREECE,2,MANCHESTER,SKIATHOS,42402,24877,17525,49160,25931,23229,-13.74695
17/03/2020 10:48,2019,1,WESTERN EUROPE-EU,GREECE,2,MANCHESTER,THIRA (SANTORINI),70550,54657,15893,71775,55170,16605,-1.70672
17/03/2020 10:48,2019,1,WESTERN EUROPE-EU,GREECE,2,MANCHESTER,ZAKINTHOS,108445,67171,41274,125131,73658,51473,-13.33483
17/03/2020 10:48,2019,1,WESTERN EUROPE-EU,GREECE,2,NEWCASTLE,CORFU,58908,58908,0,51486,51486,0,14.41557
17/03/2020 10:48,2019,1,WESTERN EUROPE-EU,GREECE,2,NEWCASTLE,HERAKLION,33210,33210,0,34276,34276,0,-3.11005
17/03/2020 10:48,2019,1,WESTERN EUROPE-EU,GREECE,2,NEWCASTLE,KAVALA,0,0,0,1614,1614,0,-100
17/03/2020 10:48,2019,1,WESTERN EUROPE-EU,GREECE,2,NEWCASTLE,KEFALLINIA,6100,6100,0,12604,12604,0,-51.60267
17/03/2020 10:48,2019,1,WESTERN EUROPE-EU,GREECE,2,NEWCASTLE,KOS,15398,15398,0,24034,24034,0,-35.93243
17/03/2020 10:48,2019,1,WESTERN EUROPE-EU,GREECE,2,NEWCASTLE,RHODES,45382,45382,0,45365,45365,0,0.03747
17/03/2020 10:48,2019,1,WESTERN EUROPE-EU,GREECE,2,NEWCASTLE,SALONIKA,6672,6672,0,10918,10918,0,-38.88991
17/03/2020 10:48,2019,1,WESTERN EUROPE-EU,GREECE,2,NEWCASTLE,SKIATHOS,8161,8161,0,6891,6891,0,18.42984
17/03/2020 10:48,2019,1,WESTERN EUROPE-EU,GREECE,2,NEWCASTLE,THIRA (SANTORINI),7997,7943,54,8482,8482,0,-5.71799
17/03/2020 10:48,2019,1,WESTERN EUROPE-EU,GREECE,2,NEWCASTLE,ZAKINTHOS,36675,36675,0,41380,41380,0,-11.37023
17/03/2020 10:48,2019,1,WESTERN EUROPE-EU,GREECE,2,NORWICH,CORFU,8827,0,8827,8983,0,8983,-1.73661
17/03/2020 10:48,2019,1,WESTERN EUROPE-EU,GREECE,2,NORWICH,HERAKLION,8872,0,8872,9358,0,9358,-5.19342
17/03/2020 10:48,2019,1,WESTERN EUROPE-EU,GREECE,2,NORWICH,RHODES,9142,0,9142,9183,0,9183,-0.44648
17/03/2020 10:48,2019,1,WESTERN EUROPE-EU,GREECE,2,SOUTHAMPTON,SKIATHOS,0,0,0,1465,0,1465,-100
17/03/2020 10:48,2019,1,WESTERN EUROPE-EU,IRISH REPUBLIC,1,GATWICK,CORK,125833,125833,0,122810,122810,0,2.46153
17/03/2020 10:48,2019,1,WESTERN EUROPE-EU,IRISH REPUBLIC,1,GATWICK,DUBLIN,1347200,1347200,0,1347017,1346905,112,0.01359
17/03/2020 10:48,2019,1,WESTERN EUROPE-EU,IRISH REPUBLIC,1,GATWICK,IRELAND WEST(KNOCK),83361,83361,0,83636,83636,0,-0.32881
17/03/2020 10:48,2019,1,WESTERN EUROPE-EU,IRISH REPUBLIC,1,GATWICK,SHANNON,117088,117088,0,115697,115695,2,1.20228
17/03/2020 10:48,2019,1,WESTERN EUROPE-EU,IRISH REPUBLIC,1,HEATHROW,CORK,379107,379107,0,403542,403542,0,-6.05513
17/03/2020 10:48,2019,1,WESTERN EUROPE-EU,IRISH REPUBLIC,1,HEATHROW,DUBLIN,1855333,1855333,0,1809396,1809396,0,2.5388
17/03/2020 10:48,2019,1,WESTERN EUROPE-EU,IRISH REPUBLIC,1,HEATHROW,SHANNON,268189,268189,0,274143,274143,0,-2.17186
17/03/2020 10:48,2019,1,WESTERN EUROPE-EU,IRISH REPUBLIC,1,LONDON CITY,DUBLIN,462420,462410,10,484467,484406,61,-4.55077
17/03/2020 10:48,2019,1,WESTERN EUROPE-EU,IRISH REPUBLIC,1,LUTON,CORK,97243,97243,0,13253,13253,0,633.7433
17/03/2020 10:48,2019,1,WESTERN EUROPE-EU,IRISH REPUBLIC,1,LUTON,DUBLIN,379069,379069,0,356814,356814,0,6.23714
17/03/2020 10:48,2019,1,WESTERN EUROPE-EU,IRISH REPUBLIC,1,LUTON,IRELAND WEST(KNOCK),135271,135271,0,134530,134530,0,0.55081
17/03/2020 10:48,2019,1,WESTERN EUROPE-EU,IRISH REPUBLIC,1,LUTON,KERRY COUNTY,111742,111742,0,112148,112148,0,-0.36202
17/03/2020 10:48,2019,1,WESTERN EUROPE-EU,IRISH REPUBLIC,1,LUTON,SHANNON,41,41,0,90,90,0,-54.44444
17/03/2020 10:48,2019,1,WESTERN EUROPE-EU,IRISH REPUBLIC,1,SOUTHEND,DUBLIN,153995,153849,146,122214,122214,0,26.00439
17/03/2020 10:48,2019,1,WESTERN EUROPE-EU,IRISH REPUBLIC,1,SOUTHEND,SHANNON,64,64,0,0,0,0,0
17/03/2020 10:48,2019,1,WESTERN EUROPE-EU,IRISH REPUBLIC,1,STANSTED,CORK,347059,347059,0,347080,347080,0,-0.00605
17/03/2020 10:48,2019,1,WESTERN EUROPE-EU,IRISH REPUBLIC,1,STANSTED,DUBLIN,908262,907857,405,898295,898295,0,1.10955
17/03/2020 10:48,2019,1,WESTERN EUROPE-EU,IRISH REPUBLIC,1,STANSTED,IRELAND WEST(KNOCK),162232,162232,0,158349,158349,0,2.45218
17/03/2020 10:48,2019,1,WESTERN EUROPE-EU,IRISH REPUBLIC,1,STANSTED,KERRY COUNTY,83246,83246,0,81186,81186,0,2.53738
17/03/2020 10:48,2019,1,WESTERN EUROPE-EU,IRISH REPUBLIC,1,STANSTED,SHANNON,201249,201249,0,201589,201459,130,-0.16866
17/03/2020 10:48,2019,1,WESTERN EUROPE-EU,IRISH REPUBLIC,2,ABERDEEN,DUBLIN,48613,48613,0,49903,49903,0,-2.58501
17/03/2020 10:48,2019,1,WESTERN EUROPE-EU,IRISH REPUBLIC,2,ABERDEEN,KERRY COUNTY,1043,0,1043,0,0,0,0
17/03/2020 10:48,2019,1,WESTERN EUROPE-EU,IRISH REPUBLIC,2,BELFAST CITY (GEORGE BEST),DUBLIN,0,0,0,31,0,31,-100
17/03/2020 10:48,2019,1,WESTERN EUROPE-EU,IRISH REPUBLIC,2,BELFAST CITY (GEORGE BEST),IRELAND WEST(KNOCK),0,0,0,60,60,0,-100
17/03/2020 10:48,2019,1,WESTERN EUROPE-EU,IRISH REPUBLIC,2,BELFAST CITY (GEORGE BEST),KERRY COUNTY,0,0,0,8,0,8,-100
17/03/2020 10:48,2019,1,WESTERN EUROPE-EU,IRISH REPUBLIC,2,BELFAST INTERNATIONAL,DUBLIN,966,0,966,875,0,875,10.4
17/03/2020 10:48,2019,1,WESTERN EUROPE-EU,IRISH REPUBLIC,2,BIGGIN HILL,DUBLIN,3,0,3,0,0,0,0
17/03/2020 10:48,2019,1,WESTERN EUROPE-EU,IRISH REPUBLIC,2,BIRMINGHAM,CORK,83722,83722,0,76832,76832,0,8.96762
17/03/2020 10:48,2019,1,WESTERN EUROPE-EU,IRISH REPUBLIC,2,BIRMINGHAM,DUBLIN,943294,943027,267,923343,923161,182,2.16074
17/03/2020 10:48,2019,1,WESTERN EUROPE-EU,IRISH REPUBLIC,2,BIRMINGHAM,IRELAND WEST(KNOCK),29801,29801,0,33410,33410,0,-10.80216
17/03/2020 10:48,2019,1,WESTERN EUROPE-EU,IRISH REPUBLIC,2,BIRMINGHAM,SHANNON,37360,37076,284,38013,37863,150,-1.71783
17/03/2020 10:48,2019,1,WESTERN EUROPE-EU,IRISH REPUBLIC,2,BOURNEMOUTH,DUBLIN,47188,47188,0,0,0,0,0
17/03/2020 10:48,2019,1,WESTERN EUROPE-EU,IRISH REPUBLIC,2,BRISTOL,CORK,39447,39447,0,40493,40493,0,-2.58316
17/03/2020 10:48,2019,1,WESTERN EUROPE-EU,IRISH REPUBLIC,2,BRISTOL,DUBLIN,421494,421395,99,429127,428850,277,-1.77873
17/03/2020 10:48,2019,1,WESTERN EUROPE-EU,IRISH REPUBLIC,2,BRISTOL,IRELAND WEST(KNOCK),45039,45039,0,35454,35454,0,27.03503
17/03/2020 10:48,2019,1,WESTERN EUROPE-EU,IRISH REPUBLIC,2,BRISTOL,SHANNON,14232,14189,43,13011,13011,0,9.38437
17/03/2020 10:48,2019,1,WESTERN EUROPE-EU,IRISH REPUBLIC,2,CARDIFF WALES,CORK,12850,12765,85,14589,14502,87,-11.91994
17/03/2020 10:48,2019,1,WESTERN EUROPE-EU,IRISH REPUBLIC,2,CARDIFF WALES,DUBLIN,102150,98541,3609,108275,104890,3385,-5.65689
17/03/2020 10:48,2019,1,WESTERN EUROPE-EU,IRISH REPUBLIC,2,CARDIFF WALES,SHANNON,439,0,439,115,0,115,281.73913
17/03/2020 10:48,2019,1,WESTERN EUROPE-EU,IRISH REPUBLIC,2,CITY OF DERRY (EGLINTON),DUBLIN,0,0,0,13,13,0,-100
17/03/2020 10:48,2019,1,WESTERN EUROPE-EU,IRISH REPUBLIC,2,DONCASTER SHEFFIELD,DUBLIN,29779,29779,0,33659,33562,97,-11.52738
17/03/2020 10:48,2019,1,WESTERN EUROPE-EU,IRISH REPUBLIC,2,DUNDEE,CORK,0,0,0,4,0,4,-100
17/03/2020 10:48,2019,1,WESTERN EUROPE-EU,IRISH REPUBLIC,2,DUNDEE,DUBLIN,28,0,28,0,0,0,0
17/03/2020 10:48,2019,1,WESTERN EUROPE-EU,IRISH REPUBLIC,2,EAST MIDLANDS INTERNATIONAL,DUBLIN,179822,179822,0,204772,204772,0,-12.18428
17/03/2020 10:48,2019,1,WESTERN EUROPE-EU,IRISH REPUBLIC,2,EAST MIDLANDS INTERNATIONAL,IRELAND WEST(KNOCK),71059,71059,0,70223,70223,0,1.19049
17/03/2020 10:48,2019,1,WESTERN EUROPE-EU,IRISH REPUBLIC,2,EAST MIDLANDS INTERNATIONAL,SHANNON,15377,15377,0,0,0,0,0
17/03/2020 10:48,2019,1,WESTERN EUROPE-EU,IRISH REPUBLIC,2,EDINBURGH,CORK,56608,55668,940,50259,50259,0,12.63256
17/03/2020 10:48,2019,1,WESTERN EUROPE-EU,IRISH REPUBLIC,2,EDINBURGH,DUBLIN,655294,653271,2023,627537,625566,1971,4.42317
17/03/2020 10:48,2019,1,WESTERN EUROPE-EU,IRISH REPUBLIC,2,EDINBURGH,IRELAND WEST(KNOCK),27227,27227,0,28776,28776,0,-5.38296
17/03/2020 10:48,2019,1,WESTERN EUROPE-EU,IRISH REPUBLIC,2,EDINBURGH,SHANNON,29187,28287,900,28802,28477,325,1.33671
17/03/2020 10:48,2019,1,WESTERN EUROPE-EU,IRISH REPUBLIC,2,EXETER,CORK,0,0,0,108,0,108,-100
17/03/2020 10:48,2019,1,WESTERN EUROPE-EU,IRISH REPUBLIC,2,EXETER,DUBLIN,32947,32947,0,35587,35587,0,-7.41844
17/03/2020 10:48,2019,1,WESTERN EUROPE-EU,IRISH REPUBLIC,2,EXETER,SHANNON,78,0,78,293,0,293,-73.37884
17/03/2020 10:48,2019,1,WESTERN EUROPE-EU,IRISH REPUBLIC,2,GLASGOW,CORK,26505,26505,0,25481,25481,0,4.01868
17/03/2020 10:48,2019,1,WESTERN EUROPE-EU,IRISH REPUBLIC,2,GLASGOW,DONEGAL,8770,8770,0,8335,8335,0,5.21896
17/03/2020 10:48,2019,1,WESTERN EUROPE-EU,IRISH REPUBLIC,2,GLASGOW,DUBLIN,500441,499713,728,494340,493911,429,1.23417
17/03/2020 10:48,2019,1,WESTERN EUROPE-EU,IRISH REPUBLIC,2,GLASGOW,SHANNON,0,0,0,41,0,41,-100
17/03/2020 10:48,2019,1,WESTERN EUROPE-EU,IRISH REPUBLIC,2,GUERNSEY,DUBLIN,8,0,8,0,0,0,0
17/03/2020 10:48,2019,1,WESTERN EUROPE-EU,IRISH REPUBLIC,2,INVERNESS,DUBLIN,15484,15484,0,12881,12881,0,20.20806
17/03/2020 10:48,2019,1,WESTERN EUROPE-EU,IRISH REPUBLIC,2,ISLE OF MAN,DUBLIN,42116,42116,0,43302,43302,0,-2.7389
17/03/2020 10:48,2019,1,WESTERN EUROPE-EU,IRISH REPUBLIC,2,JERSEY,DUBLIN,14637,14637,0,14774,14774,0,-0.9273
17/03/2020 10:48,2019,1,WESTERN EUROPE-EU,IRISH REPUBLIC,2,LEEDS BRADFORD,DUBLIN,298161,298161,0,289963,289963,0,2.82726
17/03/2020 10:48,2019,1,WESTERN EUROPE-EU,IRISH REPUBLIC,2,LIVERPOOL (JOHN LENNON),CORK,72490,72490,0,71757,71757,0,1.0215
17/03/2020 10:48,2019,1,WESTERN EUROPE-EU,IRISH REPUBLIC,2,LIVERPOOL (JOHN LENNON),DUBLIN,379863,379863,0,380437,380382,55,-0.15088
17/03/2020 10:48,2019,1,WESTERN EUROPE-EU,IRISH REPUBLIC,2,LIVERPOOL (JOHN LENNON),IRELAND WEST(KNOCK),87370,87370,0,85738,85738,0,1.90347
17/03/2020 10:48,2019,1,WESTERN EUROPE-EU,IRISH REPUBLIC,2,LIVERPOOL (JOHN LENNON),SHANNON,22,0,22,15067,15067,0,-99.85399
17/03/2020 10:48,2019,1,WESTERN EUROPE-EU,IRISH REPUBLIC,2,MANCHESTER,CORK,107675,107675,0,105782,105740,42,1.78953
17/03/2020 10:48,2019,1,WESTERN EUROPE-EU,IRISH REPUBLIC,2,MANCHESTER,DUBLIN,1000584,1000297,287,980158,979240,918,2.08395
17/03/2020 10:48,2019,1,WESTERN EUROPE-EU,IRISH REPUBLIC,2,MANCHESTER,IRELAND WEST(KNOCK),38119,38119,0,37299,37299,0,2.19845
17/03/2020 10:48,2019,1,WESTERN EUROPE-EU,IRISH REPUBLIC,2,MANCHESTER,SHANNON,84162,84162,0,84283,84283,0,-0.14356
17/03/2020 10:48,2019,1,WESTERN EUROPE-EU,IRISH REPUBLIC,2,NEWCASTLE,CORK,0,0,0,8973,8973,0,-100
17/03/2020 10:48,2019,1,WESTERN EUROPE-EU,IRISH REPUBLIC,2,NEWCASTLE,DUBLIN,221458,216540,4918,227780,227671,109,-2.77549
17/03/2020 10:48,2019,1,WESTERN EUROPE-EU,IRISH REPUBLIC,2,NEWQUAY,CORK,3444,3444,0,3581,3581,0,-3.82575
17/03/2020 10:48,2019,1,WESTERN EUROPE-EU,IRISH REPUBLIC,2,NEWQUAY,DUBLIN,30534,30534,0,29156,29156,0,4.7263
17/03/2020 10:48,2019,1,WESTERN EUROPE-EU,IRISH REPUBLIC,2,OXFORD (KIDLINGTON),DUBLIN,0,0,0,100,100,0,-100
17/03/2020 10:48,2019,1,WESTERN EUROPE-EU,IRISH REPUBLIC,2,PRESTWICK,DUBLIN,694,694,0,0,0,0,0
17/03/2020 10:48,2019,1,WESTERN EUROPE-EU,IRISH REPUBLIC,2,SOUTHAMPTON,CORK,6772,6772,0,24190,24190,0,-72.00496
17/03/2020 10:48,2019,1,WESTERN EUROPE-EU,IRISH REPUBLIC,2,SOUTHAMPTON,DUBLIN,130714,130673,41,154846,154846,0,-15.58452
17/03/2020 10:48,2019,1,WESTERN EUROPE-EU,ITALY,1,GATWICK,ALGHERO (FERTILIA),7603,0,7603,8440,0,8440,-9.91706
17/03/2020 10:48,2019,1,WESTERN EUROPE-EU,ITALY,1,GATWICK,ANCONA,14930,14930,0,6176,6176,0,141.74223
17/03/2020 10:48,2019,1,WESTERN EUROPE-EU,ITALY,1,GATWICK,BARI (PALESE),107939,107939,0,92968,92968,0,16.10339
17/03/2020 10:48,2019,1,WESTERN EUROPE-EU,ITALY,1,GATWICK,BERGAMO,27076,26889,187,0,0,0,0
17/03/2020 10:48,2019,1,WESTERN EUROPE-EU,ITALY,1,GATWICK,BOLOGNA,95938,95938,0,97239,97239,0,-1.33794
17/03/2020 10:48,2019,1,WESTERN EUROPE-EU,ITALY,1,GATWICK,BRINDISI,21945,21945,0,17436,17436,0,25.86029
17/03/2020 10:48,2019,1,WESTERN EUROPE-EU,ITALY,1,GATWICK,CAGLIARI (ELMAS),42835,42835,0,36263,36237,26,18.12316
17/03/2020 10:48,2019,1,WESTERN EUROPE-EU,ITALY,1,GATWICK,CATANIA (FONTANAROSSA),204132,193972,10160,206029,193652,12377,-0.92074
17/03/2020 10:48,2019,1,WESTERN EUROPE-EU,ITALY,1,GATWICK,FLORENCE,121526,121526,0,96458,96458,0,25.98851
17/03/2020 10:48,2019,1,WESTERN EUROPE-EU,ITALY,1,GATWICK,GENOA,72769,72769,0,76750,76723,27,-5.18697
17/03/2020 10:48,2019,1,WESTERN EUROPE-EU,ITALY,1,GATWICK,LAMETIA-TERME,8680,0,8680,0,0,0,0
17/03/2020 10:48,2019,1,WESTERN EUROPE-EU,ITALY,1,GATWICK,MILAN (LINATE),218656,218656,0,302431,302431,0,-27.70053
17/03/2020 10:48,2019,1,WESTERN EUROPE-EU,ITALY,1,GATWICK,MILAN (MALPENSA),644227,644094,133,577949,577830,119,11.46779
17/03/2020 10:48,2019,1,WESTERN EUROPE-EU,ITALY,1,GATWICK,NAPLES,435312,387431,47881,417951,388881,29070,4.15384
17/03/2020 10:48,2019,1,WESTERN EUROPE-EU,ITALY,1,GATWICK,OLBIA,95199,86186,9013,103160,94351,8809,-7.71714
17/03/2020 10:48,2019,1,WESTERN EUROPE-EU,ITALY,1,GATWICK,PALERMO,63938,63938,0,65170,65170,0,-1.89044
17/03/2020 10:48,2019,1,WESTERN EUROPE-EU,ITALY,1,GATWICK,PISA,188044,188044,0,266199,266199,0,-29.35961
17/03/2020 10:48,2019,1,WESTERN EUROPE-EU,ITALY,1,GATWICK,ROME (FIUMICINO),740666,740666,0,695278,691260,4018,6.52804
17/03/2020 10:48,2019,1,WESTERN EUROPE-EU,ITALY,1,GATWICK,TURIN,209938,188088,21850,183846,160996,22850,14.19231
17/03/2020 10:48,2019,1,WESTERN EUROPE-EU,ITALY,1,GATWICK,VENICE,696161,689090,7071,704520,697273,7247,-1.18648
17/03/2020 10:48,2019,1,WESTERN EUROPE-EU,ITALY,1,GATWICK,VERONA VILLAFRANCA,275519,256484,19035,281950,262190,19760,-2.2809
17/03/2020 10:48,2019,1,WESTERN EUROPE-EU,ITALY,1,HEATHROW,BOLOGNA,310343,310343,0,295711,295711,0,4.94807
17/03/2020 10:48,2019,1,WESTERN EUROPE-EU,ITALY,1,HEATHROW,BRINDISI,11992,11992,0,10846,10846,0,10.56611
17/03/2020 10:48,2019,1,WESTERN EUROPE-EU,ITALY,1,HEATHROW,CAGLIARI (ELMAS),4057,0,4057,7587,0,7587,-46.52695
17/03/2020 10:48,2019,1,WESTERN EUROPE-EU,ITALY,1,HEATHROW,LAMETIA-TERME,8315,0,8315,8409,0,8409,-1.11785
17/03/2020 10:48,2019,1,WESTERN EUROPE-EU,ITALY,1,HEATHROW,MILAN (LINATE),501815,501815,0,672959,672959,0,-25.43156
17/03/2020 10:48,2019,1,WESTERN EUROPE-EU,ITALY,1,HEATHROW,MILAN (MALPENSA),365044,365044,0,248131,248131,0,47.11745
17/03/2020 10:48,2019,1,WESTERN EUROPE-EU,ITALY,1,HEATHROW,OLBIA,38798,28497,10301,33355,24271,9084,16.31839
17/03/2020 10:48,2019,1,WESTERN EUROPE-EU,ITALY,1,HEATHROW,PALERMO,28507,28507,0,30845,30845,0,-7.57983
17/03/2020 10:48,2019,1,WESTERN EUROPE-EU,ITALY,1,HEATHROW,PISA,174155,174155,0,130957,130957,0,32.9864
17/03/2020 10:48,2019,1,WESTERN EUROPE-EU,ITALY,1,HEATHROW,ROME (FIUMICINO),930930,930930,0,1076489,1073620,2869,-13.52164
17/03/2020 10:48,2019,1,WESTERN EUROPE-EU,ITALY,1,HEATHROW,TREVISO,0,0,0,455,0,455,-100
17/03/2020 10:48,2019,1,WESTERN EUROPE-EU,ITALY,1,HEATHROW,TURIN,0,0,0,5550,5550,0,-100
17/03/2020 10:48,2019,1,WESTERN EUROPE-EU,ITALY,1,HEATHROW,VENICE,174134,174134,0,200412,199962,450,-13.11199
17/03/2020 10:48,2019,1,WESTERN EUROPE-EU,ITALY,1,HEATHROW,VERONA VILLAFRANCA,156,156,0,0,0,0,0
17/03/2020 10:48,2019,1,WESTERN EUROPE-EU,ITALY,1,LONDON CITY,BOLOGNA,0,0,0,532,532,0,-100
17/03/2020 10:48,2019,1,WESTERN EUROPE-EU,ITALY,1,LONDON CITY,FLORENCE,73781,73781,0,94648,94648,0,-22.04695
17/03/2020 10:48,2019,1,WESTERN EUROPE-EU,ITALY,1,LONDON CITY,MILAN (LINATE),276576,276576,0,363021,363021,0,-23.81267
17/03/2020 10:48,2019,1,WESTERN EUROPE-EU,ITALY,1,LONDON CITY,MILAN (MALPENSA),80007,79898,109,0,0,0,0
17/03/2020 10:48,2019,1,WESTERN EUROPE-EU,ITALY,1,LONDON CITY,PISA,61,61,0,138,138,0,-55.7971
17/03/2020 10:48,2019,1,WESTERN EUROPE-EU,ITALY,1,LONDON CITY,ROME (FIUMICINO),43842,43842,0,15043,15043,0,191.44453
17/03/2020 10:48,2019,1,WESTERN EUROPE-EU,ITALY,1,LONDON CITY,TREVISO,2,2,0,0,0,0,0
17/03/2020 10:48,2019,1,WESTERN EUROPE-EU,ITALY,1,LONDON CITY,VENICE,20171,20171,0,20897,20897,0,-3.47418
17/03/2020 10:48,2019,1,WESTERN EUROPE-EU,ITALY,1,LUTON,ALGHERO (FERTILIA),29357,29357,0,30421,30421,0,-3.49758
17/03/2020 10:48,2019,1,WESTERN EUROPE-EU,ITALY,1,LUTON,BARI (PALESE),52054,52054,0,43630,43630,0,19.30782
17/03/2020 10:48,2019,1,WESTERN EUROPE-EU,ITALY,1,LUTON,BOLOGNA,122695,122695,0,20500,20500,0,498.5122
17/03/2020 10:48,2019,1,WESTERN EUROPE-EU,ITALY,1,LUTON,CATANIA (FONTANAROSSA),62827,62827,0,57011,57011,0,10.20154
17/03/2020 10:48,2019,1,WESTERN EUROPE-EU,ITALY,1,LUTON,FLORENCE,16042,16042,0,23168,23168,0,-30.75794
17/03/2020 10:48,2019,1,WESTERN EUROPE-EU,ITALY,1,LUTON,GENOA,18387,18387,0,19418,19418,0,-5.30951
17/03/2020 10:48,2019,1,WESTERN EUROPE-EU,ITALY,1,LUTON,MILAN (LINATE),0,0,0,117,117,0,-100
17/03/2020 10:48,2019,1,WESTERN EUROPE-EU,ITALY,1,LUTON,MILAN (MALPENSA),171423,171171,252,171832,171591,241,-0.23802
17/03/2020 10:48,2019,1,WESTERN EUROPE-EU,ITALY,1,LUTON,NAPLES,126155,126040,115,133038,125214,7824,-5.17371
17/03/2020 10:48,2019,1,WESTERN EUROPE-EU,ITALY,1,LUTON,OLBIA,20355,20355,0,18305,18305,0,11.19913
17/03/2020 10:48,2019,1,WESTERN EUROPE-EU,ITALY,1,LUTON,PALERMO,30878,30878,0,29270,29270,0,5.49368
17/03/2020 10:48,2019,1,WESTERN EUROPE-EU,ITALY,1,LUTON,PISA,91107,91107,0,95821,95761,60,-4.91959
17/03/2020 10:48,2019,1,WESTERN EUROPE-EU,ITALY,1,LUTON,ROME (FIUMICINO),93481,93481,0,123515,123223,292,-24.31607
17/03/2020 10:48,2019,1,WESTERN EUROPE-EU,ITALY,1,LUTON,TURIN,11354,11354,0,38682,38682,0,-70.64785
17/03/2020 10:48,2019,1,WESTERN EUROPE-EU,ITALY,1,LUTON,VENICE,95243,95243,0,96105,96105,0,-0.89694
17/03/2020 10:48,2019,1,WESTERN EUROPE-EU,ITALY,1,LUTON,VERONA VILLAFRANCA,6478,6118,360,1779,1411,368,264.13716
17/03/2020 10:48,2019,1,WESTERN EUROPE-EU,ITALY,1,SOUTHEND,BERGAMO,44672,44672,0,0,0,0,0
17/03/2020 10:48,2019,1,WESTERN EUROPE-EU,ITALY,1,SOUTHEND,CAGLIARI (ELMAS),0,0,0,11514,11514,0,-100
17/03/2020 10:48,2019,1,WESTERN EUROPE-EU,ITALY,1,SOUTHEND,CATANIA (FONTANAROSSA),775,775,0,17909,17909,0,-95.67257
17/03/2020 10:48,2019,1,WESTERN EUROPE-EU,ITALY,1,SOUTHEND,MILAN (LINATE),0,0,0,43,43,0,-100
17/03/2020 10:48,2019,1,WESTERN EUROPE-EU,ITALY,1,SOUTHEND,MILAN (MALPENSA),0,0,0,16286,16286,0,-100
17/03/2020 10:48,2019,1,WESTERN EUROPE-EU,ITALY,1,SOUTHEND,TREVISO,7520,7520,0,0,0,0,0
17/03/2020 10:48,2019,1,WESTERN EUROPE-EU,ITALY,1,SOUTHEND,VENICE,37758,37758,0,0,0,0,0
17/03/2020 10:48,2019,1,WESTERN EUROPE-EU,ITALY,1,STANSTED,ALGHERO (FERTILIA),31068,31068,0,31057,31057,0,0.03542
17/03/2020 10:48,2019,1,WESTERN EUROPE-EU,ITALY,1,STANSTED,ANCONA,109197,109197,0,112199,112199,0,-2.6756
17/03/2020 10:48,2019,1,WESTERN EUROPE-EU,ITALY,1,STANSTED,BARI (PALESE),125471,125471,0,123400,122662,738,1.67828
17/03/2020 10:48,2019,1,WESTERN EUROPE-EU,ITALY,1,STANSTED,BERGAMO,504192,504192,0,476531,476531,0,5.80466
17/03/2020 10:48,2019,1,WESTERN EUROPE-EU,ITALY,1,STANSTED,BOLOGNA,264822,264822,0,222938,222938,0,18.78729
17/03/2020 10:48,2019,1,WESTERN EUROPE-EU,ITALY,1,STANSTED,BRINDISI,74901,74901,0,84402,84402,0,-11.25684
17/03/2020 10:48,2019,1,WESTERN EUROPE-EU,ITALY,1,STANSTED,CAGLIARI (ELMAS),127945,127945,0,131422,131422,0,-2.64568
17/03/2020 10:48,2019,1,WESTERN EUROPE-EU,ITALY,1,STANSTED,CATANIA (FONTANAROSSA),183,183,0,0,0,0,0
17/03/2020 10:48,2019,1,WESTERN EUROPE-EU,ITALY,1,STANSTED,COMISO,8338,8338,0,20781,20781,0,-59.87681
17/03/2020 10:48,2019,1,WESTERN EUROPE-EU,ITALY,1,STANSTED,FLORENCE,3874,3874,0,7626,7626,0,-49.2001
17/03/2020 10:48,2019,1,WESTERN EUROPE-EU,ITALY,1,STANSTED,GENOA,83609,83609,0,82233,82233,0,1.67329
17/03/2020 10:48,2019,1,WESTERN EUROPE-EU,ITALY,1,STANSTED,LAMETIA-TERME,59509,59509,0,61928,61928,0,-3.90615
17/03/2020 10:48,2019,1,WESTERN EUROPE-EU,ITALY,1,STANSTED,MILAN (LINATE),0,0,0,11470,11470,0,-100
17/03/2020 10:48,2019,1,WESTERN EUROPE-EU,ITALY,1,STANSTED,MILAN (MALPENSA),246679,246679,0,217422,217366,56,13.45632
17/03/2020 10:48,2019,1,WESTERN EUROPE-EU,ITALY,1,STANSTED,NAPLES,319387,319057,330,319553,319553,0,-0.05195
17/03/2020 10:48,2019,1,WESTERN EUROPE-EU,ITALY,1,STANSTED,PALERMO,108148,108148,0,108074,108074,0,0.06847
17/03/2020 10:48,2019,1,WESTERN EUROPE-EU,ITALY,1,STANSTED,PERUGIA,91897,91897,0,96227,96227,0,-4.49978
17/03/2020 10:48,2019,1,WESTERN EUROPE-EU,ITALY,1,STANSTED,PESCARA,92570,92570,0,91024,91024,0,1.69845
17/03/2020 10:48,2019,1,WESTERN EUROPE-EU,ITALY,1,STANSTED,PISA,327625,327625,0,308557,308557,0,6.17973
17/03/2020 10:48,2019,1,WESTERN EUROPE-EU,ITALY,1,STANSTED,RIMINI,20294,20198,96,20775,20775,0,-2.31528
17/03/2020 10:48,2019,1,WESTERN EUROPE-EU,ITALY,1,STANSTED,ROME (CIAMPINO),626868,626868,0,622875,622875,0,0.64106
17/03/2020 10:48,2019,1,WESTERN EUROPE-EU,ITALY,1,STANSTED,ROME (FIUMICINO),1583,1583,0,3050,2066,984,-48.09836
17/03/2020 10:48,2019,1,WESTERN EUROPE-EU,ITALY,1,STANSTED,TREVISO,80828,80828,0,320800,320800,0,-74.80424
17/03/2020 10:48,2019,1,WESTERN EUROPE-EU,ITALY,1,STANSTED,TRIESTE (RONCHI DEI LEGIONARI),62815,62815,0,63765,63765,0,-1.48985
17/03/2020 10:48,2019,1,WESTERN EUROPE-EU,ITALY,1,STANSTED,TURIN,140139,135240,4899,133865,126529,7336,4.68681
17/03/2020 10:48,2019,1,WESTERN EUROPE-EU,ITALY,1,STANSTED,VENICE,254921,254921,0,538,538,0,47283.0855
17/03/2020 10:48,2019,1,WESTERN EUROPE-EU,ITALY,1,STANSTED,VERONA VILLAFRANCA,87772,87194,578,84866,84866,0,3.42422
17/03/2020 10:48,2019,1,WESTERN EUROPE-EU,ITALY,2,ABERDEEN,BERGAMO,377,0,377,0,0,0,0
17/03/2020 10:48,2019,1,WESTERN EUROPE-EU,ITALY,2,ABERDEEN,CATANIA (FONTANAROSSA),0,0,0,182,182,0,-100
17/03/2020 10:48,2019,1,WESTERN EUROPE-EU,ITALY,2,BELFAST INTERNATIONAL,BERGAMO,27984,27984,0,32078,32078,0,-12.76264
17/03/2020 10:48,2019,1,WESTERN EUROPE-EU,ITALY,2,BELFAST INTERNATIONAL,NAPLES,24879,24879,0,17617,17617,0,41.22155
17/03/2020 10:48,2019,1,WESTERN EUROPE-EU,ITALY,2,BELFAST INTERNATIONAL,ROME (FIUMICINO),337,0,337,824,0,824,-59.10194
17/03/2020 10:48,2019,1,WESTERN EUROPE-EU,ITALY,2,BELFAST INTERNATIONAL,TREVISO,0,0,0,43,0,43,-100
17/03/2020 10:48,2019,1,WESTERN EUROPE-EU,ITALY,2,BELFAST INTERNATIONAL,VENICE,26577,26577,0,16746,16487,259,58.70656
17/03/2020 10:48,2019,1,WESTERN EUROPE-EU,ITALY,2,BELFAST INTERNATIONAL,VERONA VILLAFRANCA,3811,0,3811,8665,0,8665,-56.01847
17/03/2020 10:48,2019,1,WESTERN EUROPE-EU,ITALY,2,BIGGIN HILL,BOLOGNA,4,0,4,0,0,0,0
17/03/2020 10:48,2019,1,WESTERN EUROPE-EU,ITALY,2,BIGGIN HILL,BRINDISI,0,0,0,14,0,14,-100
17/03/2020 10:48,2019,1,WESTERN EUROPE-EU,ITALY,2,BIGGIN HILL,CAGLIARI (ELMAS),0,0,0,33,0,33,-100
17/03/2020 10:48,2019,1,WESTERN EUROPE-EU,ITALY,2,BIGGIN HILL,FLORENCE,0,0,0,7,0,7,-100
17/03/2020 10:48,2019,1,WESTERN EUROPE-EU,ITALY,2,BIGGIN HILL,MILAN (LINATE),11,0,11,15,0,15,-26.66667
17/03/2020 10:48,2019,1,WESTERN EUROPE-EU,ITALY,2,BIGGIN HILL,NAPLES,0,0,0,8,0,8,-100
17/03/2020 10:48,2019,1,WESTERN EUROPE-EU,ITALY,2,BIGGIN HILL,OLBIA,21,0,21,12,0,12,75
17/03/2020 10:48,2019,1,WESTERN EUROPE-EU,ITALY,2,BIGGIN HILL,PALERMO,11,0,11,5,0,5,120
17/03/2020 10:48,2019,1,WESTERN EUROPE-EU,ITALY,2,BIGGIN HILL,PERUGIA,18,0,18,0,0,0,0
17/03/2020 10:48,2019,1,WESTERN EUROPE-EU,ITALY,2,BIGGIN HILL,PISA,0,0,0,4,0,4,-100
17/03/2020 10:48,2019,1,WESTERN EUROPE-EU,ITALY,2,BIGGIN HILL,ROME (CIAMPINO),13,0,13,29,0,29,-55.17241
17/03/2020 10:48,2019,1,WESTERN EUROPE-EU,ITALY,2,BIGGIN HILL,SALERNO COSTA AMALFI,0,0,0,5,0,5,-100
17/03/2020 10:48,2019,1,WESTERN EUROPE-EU,ITALY,2,BIGGIN HILL,TREVISO,0,0,0,13,0,13,-100
17/03/2020 10:48,2019,1,WESTERN EUROPE-EU,ITALY,2,BIGGIN HILL,TURIN,13,0,13,0,0,0,0
17/03/2020 10:48,2019,1,WESTERN EUROPE-EU,ITALY,2,BIGGIN HILL,VENICE,0,0,0,2,0,2,-100
17/03/2020 10:48,2019,1,WESTERN EUROPE-EU,ITALY,2,BIGGIN HILL,VERONA VILLAFRANCA,3,0,3,0,0,0,0
17/03/2020 10:48,2019,1,WESTERN EUROPE-EU,ITALY,2,BIRMINGHAM,ALGHERO (FERTILIA),6559,0,6559,7802,182,7620,-15.93181
17/03/2020 10:48,2019,1,WESTERN EUROPE-EU,ITALY,2,BIRMINGHAM,BARI (PALESE),0,0,0,689,0,689,-100
17/03/2020 10:48,2019,1,WESTERN EUROPE-EU,ITALY,2,BIRMINGHAM,BERGAMO,0,0,0,211,0,211,-100
17/03/2020 10:48,2019,1,WESTERN EUROPE-EU,ITALY,2,BIRMINGHAM,BOLOGNA,205,0,205,186,0,186,10.21505
17/03/2020 10:48,2019,1,WESTERN EUROPE-EU,ITALY,2,BIRMINGHAM,CATANIA (FONTANAROSSA),7899,0,7899,8250,0,8250,-4.25455
17/03/2020 10:48,2019,1,WESTERN EUROPE-EU,ITALY,2,BIRMINGHAM,COMISO,0,0,0,8194,8194,0,-100
17/03/2020 10:48,2019,1,WESTERN EUROPE-EU,ITALY,2,BIRMINGHAM,FLORENCE,0,0,0,3945,3945,0,-100
17/03/2020 10:48,2019,1,WESTERN EUROPE-EU,ITALY,2,BIRMINGHAM,MILAN (LINATE),355,355,0,60,60,0,491.66667
17/03/2020 10:48,2019,1,WESTERN EUROPE-EU,ITALY,2,BIRMINGHAM,MILAN (MALPENSA),53863,53863,0,59604,59530,74,-9.6319
17/03/2020 10:48,2019,1,WESTERN EUROPE-EU,ITALY,2,BIRMINGHAM,NAPLES,55624,19465,36159,45755,19857,25898,21.56923
17/03/2020 10:48,2019,1,WESTERN EUROPE-EU,ITALY,2,BIRMINGHAM,PISA,14256,14256,0,16089,16089,0,-11.39288
17/03/2020 10:48,2019,1,WESTERN EUROPE-EU,ITALY,2,BIRMINGHAM,ROME (CIAMPINO),0,0,0,502,502,0,-100
17/03/2020 10:48,2019,1,WESTERN EUROPE-EU,ITALY,2,BIRMINGHAM,ROME (FIUMICINO),66497,66497,0,58270,56430,1840,14.11876
17/03/2020 10:48,2019,1,WESTERN EUROPE-EU,ITALY,2,BIRMINGHAM,TREVISO,0,0,0,42,0,42,-100
17/03/2020 10:48,2019,1,WESTERN EUROPE-EU,ITALY,2,BIRMINGHAM,TURIN,12808,7375,5433,13994,8155,5839,-8.47506
17/03/2020 10:48,2019,1,WESTERN EUROPE-EU,ITALY,2,BIRMINGHAM,VENICE,26617,26462,155,16512,16512,0,61.19792
17/03/2020 10:48,2019,1,WESTERN EUROPE-EU,ITALY,2,BIRMINGHAM,VERONA VILLAFRANCA,61087,40427,20660,56951,35209,21742,7.26238
17/03/2020 10:48,2019,1,WESTERN EUROPE-EU,ITALY,2,BOURNEMOUTH,BERGAMO,378,0,378,0,0,0,0
17/03/2020 10:48,2019,1,WESTERN EUROPE-EU,ITALY,2,BOURNEMOUTH,NAPLES,0,0,0,8926,0,8926,-100
17/03/2020 10:48,2019,1,WESTERN EUROPE-EU,ITALY,2,BOURNEMOUTH,TURIN,1912,0,1912,2292,140,2152,-16.57941
17/03/2020 10:48,2019,1,WESTERN EUROPE-EU,ITALY,2,BOURNEMOUTH,VENICE,357,0,357,0,0,0,0
17/03/2020 10:48,2019,1,WESTERN EUROPE-EU,ITALY,2,BOURNEMOUTH,VERONA VILLAFRANCA,357,0,357,0,0,0,0
17/03/2020 10:48,2019,1,WESTERN EUROPE-EU,ITALY,2,BRISTOL,BERGAMO,51240,51240,0,50945,50945,0,0.57906
17/03/2020 10:48,2019,1,WESTERN EUROPE-EU,ITALY,2,BRISTOL,BOLOGNA,19420,19420,0,19690,19690,0,-1.37125
17/03/2020 10:48,2019,1,WESTERN EUROPE-EU,ITALY,2,BRISTOL,BRINDISI,8112,8112,0,0,0,0,0
17/03/2020 10:48,2019,1,WESTERN EUROPE-EU,ITALY,2,BRISTOL,CATANIA (FONTANAROSSA),26137,26137,0,22466,22466,0,16.34025
17/03/2020 10:48,2019,1,WESTERN EUROPE-EU,ITALY,2,BRISTOL,FLORENCE,0,0,0,3065,3010,55,-100
17/03/2020 10:48,2019,1,WESTERN EUROPE-EU,ITALY,2,BRISTOL,GENOA,14368,14368,0,11691,11691,0,22.89796
17/03/2020 10:48,2019,1,WESTERN EUROPE-EU,ITALY,2,BRISTOL,MILAN (MALPENSA),50199,50199,0,5187,5187,0,867.78485
17/03/2020 10:48,2019,1,WESTERN EUROPE-EU,ITALY,2,BRISTOL,NAPLES,64632,38300,26332,51460,34596,16864,25.59658
17/03/2020 10:48,2019,1,WESTERN EUROPE-EU,ITALY,2,BRISTOL,OLBIA,26664,25564,1100,25694,23679,2015,3.7752
17/03/2020 10:48,2019,1,WESTERN EUROPE-EU,ITALY,2,BRISTOL,PISA,77129,77129,0,76899,76899,0,0.29909
17/03/2020 10:48,2019,1,WESTERN EUROPE-EU,ITALY,2,BRISTOL,ROME (FIUMICINO),114886,114886,0,113402,112653,749,1.30862
17/03/2020 10:48,2019,1,WESTERN EUROPE-EU,ITALY,2,BRISTOL,TURIN,10750,5748,5002,10775,4652,6123,-0.23202
17/03/2020 10:48,2019,1,WESTERN EUROPE-EU,ITALY,2,BRISTOL,VENICE,165147,165147,0,157044,157044,0,5.1597
17/03/2020 10:48,2019,1,WESTERN EUROPE-EU,ITALY,2,BRISTOL,VERONA VILLAFRANCA,11655,142,11513,13036,0,13036,-10.59374
17/03/2020 10:48,2019,1,WESTERN EUROPE-EU,ITALY,2,CARDIFF WALES,BERGAMO,41,0,41,146,146,0,-71.91781
17/03/2020 10:48,2019,1,WESTERN EUROPE-EU,ITALY,2,CARDIFF WALES,MILAN (MALPENSA),9899,9774,125,21483,21445,38,-53.92171
17/03/2020 10:48,2019,1,WESTERN EUROPE-EU,ITALY,2,CARDIFF WALES,NAPLES,9266,0,9266,0,0,0,0
17/03/2020 10:48,2019,1,WESTERN EUROPE-EU,ITALY,2,CARDIFF WALES,PARMA,0,0,0,267,0,267,-100
17/03/2020 10:48,2019,1,WESTERN EUROPE-EU,ITALY,2,CARDIFF WALES,ROME (FIUMICINO),12699,10030,2669,17584,17584,0,-27.78094
17/03/2020 10:48,2019,1,WESTERN EUROPE-EU,ITALY,2,CARDIFF WALES,TREVISO,0,0,0,80,0,80,-100
17/03/2020 10:48,2019,1,WESTERN EUROPE-EU,ITALY,2,CARDIFF WALES,VENICE,5431,5431,0,8467,8467,0,-35.85686
17/03/2020 10:48,2019,1,WESTERN EUROPE-EU,ITALY,2,CARDIFF WALES,VERONA VILLAFRANCA,5377,5377,0,8180,8180,0,-34.2665
17/03/2020 10:48,2019,1,WESTERN EUROPE-EU,ITALY,2,DONCASTER SHEFFIELD,NAPLES,9847,0,9847,6802,0,6802,44.76625
17/03/2020 10:48,2019,1,WESTERN EUROPE-EU,ITALY,2,DONCASTER SHEFFIELD,TURIN,0,0,0,2297,0,2297,-100
17/03/2020 10:48,2019,1,WESTERN EUROPE-EU,ITALY,2,DUNDEE,CATANIA (FONTANAROSSA),2,0,2,0,0,0,0
17/03/2020 10:48,2019,1,WESTERN EUROPE-EU,ITALY,2,DUNDEE,OLBIA,0,0,0,6,0,6,-100
17/03/2020 10:48,2019,1,WESTERN EUROPE-EU,ITALY,2,EAST MIDLANDS INTERNATIONAL,BERGAMO,54744,54696,48,53280,53280,0,2.74775
17/03/2020 10:48,2019,1,WESTERN EUROPE-EU,ITALY,2,EAST MIDLANDS INTERNATIONAL,BRINDISI,0,0,0,181,0,181,-100
17/03/2020 10:48,2019,1,WESTERN EUROPE-EU,ITALY,2,EAST MIDLANDS INTERNATIONAL,NAPLES,34792,17642,17150,47738,30452,17286,-27.11886
17/03/2020 10:48,2019,1,WESTERN EUROPE-EU,ITALY,2,EAST MIDLANDS INTERNATIONAL,PISA,22215,22215,0,26714,26714,0,-16.84136
17/03/2020 10:48,2019,1,WESTERN EUROPE-EU,ITALY,2,EAST MIDLANDS INTERNATIONAL,ROME (CIAMPINO),20138,20138,0,32755,32755,0,-38.51931
17/03/2020 10:48,2019,1,WESTERN EUROPE-EU,ITALY,2,EAST MIDLANDS INTERNATIONAL,TREVISO,40344,40344,0,44264,44264,0,-8.85596
17/03/2020 10:48,2019,1,WESTERN EUROPE-EU,ITALY,2,EAST MIDLANDS INTERNATIONAL,TURIN,92,0,92,0,0,0,0
17/03/2020 10:48,2019,1,WESTERN EUROPE-EU,ITALY,2,EAST MIDLANDS INTERNATIONAL,VERONA VILLAFRANCA,6262,6262,0,6445,6445,0,-2.83941
17/03/2020 10:48,2019,1,WESTERN EUROPE-EU,ITALY,2,EDINBURGH,BERGAMO,89405,89405,0,84950,84792,158,5.24426
17/03/2020 10:48,2019,1,WESTERN EUROPE-EU,ITALY,2,EDINBURGH,BOLOGNA,36769,36769,0,34516,34516,0,6.52741
17/03/2020 10:48,2019,1,WESTERN EUROPE-EU,ITALY,2,EDINBURGH,FLORENCE,6844,6844,0,3499,3499,0,95.59874
17/03/2020 10:48,2019,1,WESTERN EUROPE-EU,ITALY,2,EDINBURGH,MILAN (LINATE),1556,1556,0,0,0,0,0
17/03/2020 10:48,2019,1,WESTERN EUROPE-EU,ITALY,2,EDINBURGH,MILAN (MALPENSA),168370,168237,133,164921,164921,0,2.0913
17/03/2020 10:48,2019,1,WESTERN EUROPE-EU,ITALY,2,EDINBURGH,NAPLES,56909,56868,41,46838,46838,0,21.50177
17/03/2020 10:48,2019,1,WESTERN EUROPE-EU,ITALY,2,EDINBURGH,PISA,31280,31280,0,32428,32428,0,-3.54015
17/03/2020 10:48,2019,1,WESTERN EUROPE-EU,ITALY,2,EDINBURGH,ROME (CIAMPINO),91905,91905,0,87245,87245,0,5.34128
17/03/2020 10:48,2019,1,WESTERN EUROPE-EU,ITALY,2,EDINBURGH,ROME (FIUMICINO),1504,0,1504,3442,684,2758,-56.30447
17/03/2020 10:48,2019,1,WESTERN EUROPE-EU,ITALY,2,EDINBURGH,TREVISO,48248,48248,0,49630,49630,0,-2.78461
17/03/2020 10:48,2019,1,WESTERN EUROPE-EU,ITALY,2,EDINBURGH,TURIN,4515,4515,0,3823,3823,0,18.10097
17/03/2020 10:48,2019,1,WESTERN EUROPE-EU,ITALY,2,EDINBURGH,VENICE,90723,90723,0,77974,77974,0,16.35032
17/03/2020 10:48,2019,1,WESTERN EUROPE-EU,ITALY,2,EDINBURGH,VERONA VILLAFRANCA,18002,15385,2617,14337,12041,2296,25.56323
17/03/2020 10:48,2019,1,WESTERN EUROPE-EU,ITALY,2,EXETER,MILAN (MALPENSA),0,0,0,31,31,0,-100
17/03/2020 10:48,2019,1,WESTERN EUROPE-EU,ITALY,2,EXETER,NAPLES,18260,18260,0,0,0,0,0
17/03/2020 10:48,2019,1,WESTERN EUROPE-EU,ITALY,2,GLASGOW,GENOA,4097,0,4097,3406,0,3406,20.28773
17/03/2020 10:48,2019,1,WESTERN EUROPE-EU,ITALY,2,GLASGOW,MILAN (MALPENSA),403,145,258,35384,33381,2003,-98.86107
17/03/2020 10:48,2019,1,WESTERN EUROPE-EU,ITALY,2,GLASGOW,NAPLES,30090,8394,21696,12629,0,12629,138.26114
17/03/2020 10:48,2019,1,WESTERN EUROPE-EU,ITALY,2,GLASGOW,RIMINI,220,0,220,0,0,0,0
17/03/2020 10:48,2019,1,WESTERN EUROPE-EU,ITALY,2,GLASGOW,ROME (FIUMICINO),34349,32558,1791,30518,29743,775,12.55325
17/03/2020 10:48,2019,1,WESTERN EUROPE-EU,ITALY,2,GLASGOW,TRIESTE (RONCHI DEI LEGIONARI),0,0,0,173,173,0,-100
17/03/2020 10:48,2019,1,WESTERN EUROPE-EU,ITALY,2,GLASGOW,TURIN,5204,0,5204,5315,0,5315,-2.08843
17/03/2020 10:48,2019,1,WESTERN EUROPE-EU,ITALY,2,GLASGOW,VENICE,29490,29490,0,8006,4449,3557,268.34874
17/03/2020 10:48,2019,1,WESTERN EUROPE-EU,ITALY,2,GLASGOW,VERONA VILLAFRANCA,13542,0,13542,12186,158,12028,11.12752
17/03/2020 10:48,2019,1,WESTERN EUROPE-EU,ITALY,2,GUERNSEY,FLORENCE,0,0,0,92,0,92,-100
17/03/2020 10:48,2019,1,WESTERN EUROPE-EU,ITALY,2,HUMBERSIDE,BERGAMO,704,0,704,0,0,0,0
17/03/2020 10:48,2019,1,WESTERN EUROPE-EU,ITALY,2,HUMBERSIDE,VENICE,86,0,86,168,0,168,-48.80952
17/03/2020 10:48,2019,1,WESTERN EUROPE-EU,ITALY,2,INVERNESS,BERGAMO,330,0,330,0,0,0,0
17/03/2020 10:48,2019,1,WESTERN EUROPE-EU,ITALY,2,INVERNESS,MILAN (MALPENSA),0,0,0,266,0,266,-100
17/03/2020 10:48,2019,1,WESTERN EUROPE-EU,ITALY,2,ISLE OF MAN,MILAN (MALPENSA),409,0,409,0,0,0,0
17/03/2020 10:48,2019,1,WESTERN EUROPE-EU,ITALY,2,LEEDS BRADFORD,NAPLES,18449,18449,0,15235,15235,0,21.09616
17/03/2020 10:48,2019,1,WESTERN EUROPE-EU,ITALY,2,LEEDS BRADFORD,PISA,30263,30263,0,38879,38879,0,-22.16106
17/03/2020 10:48,2019,1,WESTERN EUROPE-EU,ITALY,2,LEEDS BRADFORD,ROME (FIUMICINO),27359,27359,0,28726,28526,200,-4.75876
17/03/2020 10:48,2019,1,WESTERN EUROPE-EU,ITALY,2,LEEDS BRADFORD,TREVISO,0,0,0,20453,20453,0,-100
17/03/2020 10:48,2019,1,WESTERN EUROPE-EU,ITALY,2,LEEDS BRADFORD,TURIN,2132,2132,0,288,288,0,640.27778
17/03/2020 10:48,2019,1,WESTERN EUROPE-EU,ITALY,2,LEEDS BRADFORD,VENICE,17122,17122,0,16953,16953,0,0.99687
17/03/2020 10:48,2019,1,WESTERN EUROPE-EU,ITALY,2,LEEDS BRADFORD,VERONA VILLAFRANCA,6032,6032,0,6345,6345,0,-4.93302
17/03/2020 10:48,2019,1,WESTERN EUROPE-EU,ITALY,2,LIVERPOOL (JOHN LENNON),BARI (PALESE),20818,20818,0,21060,21060,0,-1.1491
17/03/2020 10:48,2019,1,WESTERN EUROPE-EU,ITALY,2,LIVERPOOL (JOHN LENNON),BERGAMO,177,177,0,17242,17242,0,-98.97344
17/03/2020 10:48,2019,1,WESTERN EUROPE-EU,ITALY,2,LIVERPOOL (JOHN LENNON),MILAN (MALPENSA),39523,39374,149,46624,46624,0,-15.23035
17/03/2020 10:48,2019,1,WESTERN EUROPE-EU,ITALY,2,LIVERPOOL (JOHN LENNON),NAPLES,26487,26009,478,24022,23111,911,10.26143
17/03/2020 10:48,2019,1,WESTERN EUROPE-EU,ITALY,2,LIVERPOOL (JOHN LENNON),PALERMO,19871,19871,0,8115,8115,0,144.86753
17/03/2020 10:48,2019,1,WESTERN EUROPE-EU,ITALY,2,LIVERPOOL (JOHN LENNON),PISA,20679,20679,0,20418,20418,0,1.27828
17/03/2020 10:48,2019,1,WESTERN EUROPE-EU,ITALY,2,LIVERPOOL (JOHN LENNON),RIMINI,0,0,0,102,0,102,-100
17/03/2020 10:48,2019,1,WESTERN EUROPE-EU,ITALY,2,LIVERPOOL (JOHN LENNON),ROME (FIUMICINO),6387,6387,0,56308,52100,4208,-88.65703
17/03/2020 10:48,2019,1,WESTERN EUROPE-EU,ITALY,2,LIVERPOOL (JOHN LENNON),TURIN,0,0,0,136,0,136,-100
17/03/2020 10:48,2019,1,WESTERN EUROPE-EU,ITALY,2,LIVERPOOL (JOHN LENNON),VENICE,34634,34634,0,33055,33055,0,4.77689
17/03/2020 10:48,2019,1,WESTERN EUROPE-EU,ITALY,2,MANCHESTER,ALGHERO (FERTILIA),7915,0,7915,7961,0,7961,-0.57782
17/03/2020 10:48,2019,1,WESTERN EUROPE-EU,ITALY,2,MANCHESTER,BARI (PALESE),6553,6553,0,266,0,266,2363.53383
17/03/2020 10:48,2019,1,WESTERN EUROPE-EU,ITALY,2,MANCHESTER,BERGAMO,162345,159330,3015,151178,151178,0,7.38666
17/03/2020 10:48,2019,1,WESTERN EUROPE-EU,ITALY,2,MANCHESTER,BOLOGNA,57724,57724,0,52588,52588,0,9.76649
17/03/2020 10:48,2019,1,WESTERN EUROPE-EU,ITALY,2,MANCHESTER,BRINDISI,20457,20457,0,21185,21185,0,-3.43639
17/03/2020 10:48,2019,1,WESTERN EUROPE-EU,ITALY,2,MANCHESTER,CAGLIARI (ELMAS),19875,19875,0,14112,14112,0,40.83759
17/03/2020 10:48,2019,1,WESTERN EUROPE-EU,ITALY,2,MANCHESTER,CATANIA (FONTANAROSSA),70857,61013,9844,65737,54653,11084,7.78861
17/03/2020 10:48,2019,1,WESTERN EUROPE-EU,ITALY,2,MANCHESTER,FLORENCE,3159,3159,0,3384,3384,0,-6.64894
17/03/2020 10:48,2019,1,WESTERN EUROPE-EU,ITALY,2,MANCHESTER,GENOA,24009,24009,0,22473,22473,0,6.83487
17/03/2020 10:48,2019,1,WESTERN EUROPE-EU,ITALY,2,MANCHESTER,LAMETIA-TERME,8583,0,8583,0,0,0,0
17/03/2020 10:48,2019,1,WESTERN EUROPE-EU,ITALY,2,MANCHESTER,MILAN (LINATE),271,0,271,0,0,0,0
17/03/2020 10:48,2019,1,WESTERN EUROPE-EU,ITALY,2,MANCHESTER,MILAN (MALPENSA),181723,180578,1145,151543,151438,105,19.91514
17/03/2020 10:48,2019,1,WESTERN EUROPE-EU,ITALY,2,MANCHESTER,NAPLES,142342,98703,43639,123883,92614,31269,14.90035
17/03/2020 10:48,2019,1,WESTERN EUROPE-EU,ITALY,2,MANCHESTER,OLBIA,31130,25544,5586,37115,26727,10388,-16.12556
17/03/2020 10:48,2019,1,WESTERN EUROPE-EU,ITALY,2,MANCHESTER,PALERMO,20691,20691,0,15219,15219,0,35.95506
17/03/2020 10:48,2019,1,WESTERN EUROPE-EU,ITALY,2,MANCHESTER,PARMA,43,0,43,0,0,0,0
17/03/2020 10:48,2019,1,WESTERN EUROPE-EU,ITALY,2,MANCHESTER,PISA,86160,86160,0,84883,84883,0,1.50442
17/03/2020 10:48,2019,1,WESTERN EUROPE-EU,ITALY,2,MANCHESTER,ROME (CIAMPINO),159768,159768,0,166294,166294,0,-3.92437
17/03/2020 10:48,2019,1,WESTERN EUROPE-EU,ITALY,2,MANCHESTER,ROME (FIUMICINO),108871,108871,0,98769,94826,3943,10.22791
17/03/2020 10:48,2019,1,WESTERN EUROPE-EU,ITALY,2,MANCHESTER,TREVISO,53001,53001,0,29386,29386,0,80.3614
17/03/2020 10:48,2019,1,WESTERN EUROPE-EU,ITALY,2,MANCHESTER,TRIESTE (RONCHI DEI LEGIONARI),83,0,83,0,0,0,0
17/03/2020 10:48,2019,1,WESTERN EUROPE-EU,ITALY,2,MANCHESTER,TURIN,28417,18637,9780,33561,20647,12914,-15.32731
17/03/2020 10:48,2019,1,WESTERN EUROPE-EU,ITALY,2,MANCHESTER,VENICE,133147,125706,7441,124134,115756,8378,7.2607
17/03/2020 10:48,2019,1,WESTERN EUROPE-EU,ITALY,2,MANCHESTER,VERONA VILLAFRANCA,45995,18777,27218,43142,14483,28659,6.61305
17/03/2020 10:48,2019,1,WESTERN EUROPE-EU,ITALY,2,NEWCASTLE,NAPLES,25818,25818,0,17651,17651,0,46.26933
17/03/2020 10:48,2019,1,WESTERN EUROPE-EU,ITALY,2,NEWCASTLE,PISA,13220,13220,0,10732,10732,0,23.183
17/03/2020 10:48,2019,1,WESTERN EUROPE-EU,ITALY,2,NEWCASTLE,ROME (FIUMICINO),27897,27897,0,18075,18075,0,54.34025
17/03/2020 10:48,2019,1,WESTERN EUROPE-EU,ITALY,2,NEWCASTLE,TREVISO,50,0,50,0,0,0,0
17/03/2020 10:48,2019,1,WESTERN EUROPE-EU,ITALY,2,NEWCASTLE,TURIN,4367,4367,0,4848,4848,0,-9.92162
17/03/2020 10:48,2019,1,WESTERN EUROPE-EU,ITALY,2,NEWCASTLE,VERONA VILLAFRANCA,14104,14104,0,14416,14416,0,-2.16426
17/03/2020 10:48,2019,1,WESTERN EUROPE-EU,ITALY,2,NEWQUAY,BERGAMO,735,0,735,0,0,0,0
17/03/2020 10:48,2019,1,WESTERN EUROPE-EU,ITALY,2,NORWICH,BERGAMO,712,0,712,0,0,0,0
17/03/2020 10:48,2019,1,WESTERN EUROPE-EU,ITALY,2,PRESTWICK,BERGAMO,0,0,0,130,0,130,-100
17/03/2020 10:48,2019,1,WESTERN EUROPE-EU,ITALY,2,PRESTWICK,PALERMO,29,0,29,0,0,0,0
17/03/2020 10:48,2019,1,WESTERN EUROPE-EU,ITALY,2,PRESTWICK,PISA,19696,19696,0,20029,20029,0,-1.66259
17/03/2020 10:48,2019,1,WESTERN EUROPE-EU,ITALY,2,PRESTWICK,ROME (CIAMPINO),20889,20889,0,21663,21663,0,-3.57291
17/03/2020 10:48,2019,1,WESTERN EUROPE-EU,ITALY,2,SOUTHAMPTON,VERONA VILLAFRANCA,5307,5307,0,7741,7741,0,-31.44297
17/03/2020 10:48,2019,1,WESTERN EUROPE-EU,ITALY,2,TEESSIDE INTERNATIONAL AIRPORT,BERGAMO,332,0,332,0,0,0,0
17/03/2020 10:48,2019,1,WESTERN EUROPE-EU,LUXEMBOURG,1,GATWICK,LUXEMBOURG,65662,65662,0,65487,65487,0,0.26723
17/03/2020 10:48,2019,1,WESTERN EUROPE-EU,LUXEMBOURG,1,HEATHROW,LUXEMBOURG,181538,181538,0,168605,168605,0,7.67059
17/03/2020 10:48,2019,1,WESTERN EUROPE-EU,LUXEMBOURG,1,LONDON CITY,LUXEMBOURG,177018,177018,0,184139,184139,0,-3.86719
17/03/2020 10:48,2019,1,WESTERN EUROPE-EU,LUXEMBOURG,1,LUTON,LUXEMBOURG,66,66,0,192,192,0,-65.625
17/03/2020 10:48,2019,1,WESTERN EUROPE-EU,LUXEMBOURG,1,SOUTHEND,LUXEMBOURG,73,73,0,0,0,0,0
17/03/2020 10:48,2019,1,WESTERN EUROPE-EU,LUXEMBOURG,1,STANSTED,LUXEMBOURG,104466,104466,0,108122,108122,0,-3.38137
17/03/2020 10:48,2019,1,WESTERN EUROPE-EU,LUXEMBOURG,2,BELFAST INTERNATIONAL,LUXEMBOURG,90,0,90,0,0,0,0
17/03/2020 10:48,2019,1,WESTERN EUROPE-EU,LUXEMBOURG,2,BIGGIN HILL,LUXEMBOURG,3,0,3,0,0,0,0
17/03/2020 10:48,2019,1,WESTERN EUROPE-EU,LUXEMBOURG,2,BIRMINGHAM,LUXEMBOURG,36,36,0,0,0,0,0
17/03/2020 10:48,2019,1,WESTERN EUROPE-EU,LUXEMBOURG,2,EDINBURGH,LUXEMBOURG,35185,35185,0,25,0,25,140640
17/03/2020 10:48,2019,1,WESTERN EUROPE-EU,LUXEMBOURG,2,GLASGOW,LUXEMBOURG,304,0,304,25,0,25,1116
17/03/2020 10:48,2019,1,WESTERN EUROPE-EU,LUXEMBOURG,2,JERSEY,LUXEMBOURG,434,27,407,470,0,470,-7.65957
17/03/2020 10:48,2019,1,WESTERN EUROPE-EU,LUXEMBOURG,2,MANCHESTER,LUXEMBOURG,27033,27033,0,28318,28318,0,-4.53775
17/03/2020 10:48,2019,1,WESTERN EUROPE-EU,LUXEMBOURG,2,STORNOWAY,LUXEMBOURG,24,0,24,0,0,0,0
17/03/2020 10:48,2019,1,WESTERN EUROPE-EU,MALTA,1,GATWICK,MALTA,400620,376073,24547,395639,368954,26685,1.25898
17/03/2020 10:48,2019,1,WESTERN EUROPE-EU,MALTA,1,HEATHROW,MALTA,201035,201035,0,209863,209863,0,-4.20655
17/03/2020 10:48,2019,1,WESTERN EUROPE-EU,MALTA,1,LUTON,MALTA,115466,115466,0,116793,116793,0,-1.1362
17/03/2020 10:48,2019,1,WESTERN EUROPE-EU,MALTA,1,SOUTHEND,MALTA,66329,66329,0,58673,58673,0,13.04859
17/03/2020 10:48,2019,1,WESTERN EUROPE-EU,MALTA,1,STANSTED,MALTA,115975,115975,0,110964,110633,331,4.51588
17/03/2020 10:48,2019,1,WESTERN EUROPE-EU,MALTA,2,ABERDEEN,MALTA,20075,20075,0,20269,20269,0,-0.95713
17/03/2020 10:48,2019,1,WESTERN EUROPE-EU,MALTA,2,BELFAST INTERNATIONAL,MALTA,34534,34534,0,39746,39746,0,-13.11327
17/03/2020 10:48,2019,1,WESTERN EUROPE-EU,MALTA,2,BIGGIN HILL,MALTA,0,0,0,9,0,9,-100
17/03/2020 10:48,2019,1,WESTERN EUROPE-EU,MALTA,2,BIRMINGHAM,MALTA,89729,78999,10730,91738,81926,9812,-2.18993
17/03/2020 10:48,2019,1,WESTERN EUROPE-EU,MALTA,2,BOURNEMOUTH,MALTA,33136,33136,0,34748,34748,0,-4.63912
17/03/2020 10:48,2019,1,WESTERN EUROPE-EU,MALTA,2,BRISTOL,MALTA,70514,66219,4295,67576,63180,4396,4.3477
17/03/2020 10:48,2019,1,WESTERN EUROPE-EU,MALTA,2,CARDIFF WALES,MALTA,25536,25536,0,0,0,0,0
17/03/2020 10:48,2019,1,WESTERN EUROPE-EU,MALTA,2,EAST MIDLANDS INTERNATIONAL,MALTA,63208,63208,0,64733,64733,0,-2.35583
17/03/2020 10:48,2019,1,WESTERN EUROPE-EU,MALTA,2,EDINBURGH,MALTA,58587,58587,0,58141,58141,0,0.7671
17/03/2020 10:48,2019,1,WESTERN EUROPE-EU,MALTA,2,EXETER,MALTA,24010,24010,0,0,0,0,0
17/03/2020 10:48,2019,1,WESTERN EUROPE-EU,MALTA,2,GLASGOW,MALTA,22623,22623,0,19748,19748,0,14.55844
17/03/2020 10:48,2019,1,WESTERN EUROPE-EU,MALTA,2,LEEDS BRADFORD,MALTA,56561,56561,0,54502,54502,0,3.77784
17/03/2020 10:48,2019,1,WESTERN EUROPE-EU,MALTA,2,LIVERPOOL (JOHN LENNON),MALTA,35439,35439,0,35534,35534,0,-0.26735
17/03/2020 10:48,2019,1,WESTERN EUROPE-EU,MALTA,2,MANCHESTER,MALTA,237563,206806,30757,233514,204148,29366,1.73394
17/03/2020 10:48,2019,1,WESTERN EUROPE-EU,MALTA,2,NEWCASTLE,MALTA,42874,42874,0,44468,44468,0,-3.5846
17/03/2020 10:48,2019,1,WESTERN EUROPE-EU,MALTA,2,PRESTWICK,MALTA,3654,3654,0,16493,16493,0,-77.84515
17/03/2020 10:48,2019,1,WESTERN EUROPE-EU,NETHERLANDS,1,GATWICK,AMSTERDAM,1098936,1098711,225,1085024,1085023,1,1.28218
17/03/2020 10:48,2019,1,WESTERN EUROPE-EU,NETHERLANDS,1,HEATHROW,AMSTERDAM,1748216,1748216,0,1746528,1746528,0,0.09665
17/03/2020 10:48,2019,1,WESTERN EUROPE-EU,NETHERLANDS,1,LONDON CITY,AMSTERDAM,667584,667584,0,624965,624904,61,6.81942
17/03/2020 10:48,2019,1,WESTERN EUROPE-EU,NETHERLANDS,1,LONDON CITY,ROTTERDAM,177797,177797,0,173208,173208,0,2.64942
17/03/2020 10:48,2019,1,WESTERN EUROPE-EU,NETHERLANDS,1,LUTON,AMSTERDAM,840703,840703,0,808549,808549,0,3.97675
17/03/2020 10:48,2019,1,WESTERN EUROPE-EU,NETHERLANDS,1,LUTON,EINDHOVEN,228,228,0,544,0,544,-58.08824
17/03/2020 10:48,2019,1,WESTERN EUROPE-EU,NETHERLANDS,1,LUTON,MAASTRICHT,0,0,0,63,0,63,-100
17/03/2020 10:48,2019,1,WESTERN EUROPE-EU,NETHERLANDS,1,LUTON,ROTTERDAM,288,0,288,0,0,0,0
17/03/2020 10:48,2019,1,WESTERN EUROPE-EU,NETHERLANDS,1,SOUTHEND,AMSTERDAM,201625,201625,0,193652,193652,0,4.11718
17/03/2020 10:48,2019,1,WESTERN EUROPE-EU,NETHERLANDS,1,SOUTHEND,GRONINGEN,41847,41847,0,55140,55140,0,-24.10773
17/03/2020 10:48,2019,1,WESTERN EUROPE-EU,NETHERLANDS,1,STANSTED,AMSTERDAM,363360,363114,246,358127,358127,0,1.46121
17/03/2020 10:48,2019,1,WESTERN EUROPE-EU,NETHERLANDS,1,STANSTED,EINDHOVEN,316885,316885,0,259398,259398,0,22.1617
17/03/2020 10:48,2019,1,WESTERN EUROPE-EU,NETHERLANDS,1,STANSTED,GRONINGEN,0,0,0,171,0,171,-100
17/03/2020 10:48,2019,1,WESTERN EUROPE-EU,NETHERLANDS,1,STANSTED,ROTTERDAM,95,95,0,182,0,182,-47.8022
17/03/2020 10:48,2019,1,WESTERN EUROPE-EU,NETHERLANDS,2,ABERDEEN,AMSTERDAM,319669,319669,0,291139,291139,0,9.79944
17/03/2020 10:48,2019,1,WESTERN EUROPE-EU,NETHERLANDS,2,BELFAST CITY (GEORGE BEST),AMSTERDAM,52329,51840,489,49648,49605,43,5.40002
17/03/2020 10:48,2019,1,WESTERN EUROPE-EU,NETHERLANDS,2,BELFAST CITY (GEORGE BEST),MAASTRICHT,0,0,0,75,0,75,-100
17/03/2020 10:48,2019,1,WESTERN EUROPE-EU,NETHERLANDS,2,BELFAST INTERNATIONAL,AMSTERDAM,130257,130134,123,131014,130957,57,-0.5778
17/03/2020 10:48,2019,1,WESTERN EUROPE-EU,NETHERLANDS,2,BELFAST INTERNATIONAL,ROTTERDAM,43,0,43,0,0,0,0
17/03/2020 10:48,2019,1,WESTERN EUROPE-EU,NETHERLANDS,2,BIGGIN HILL,ROTTERDAM,11,0,11,0,0,0,0
17/03/2020 10:48,2019,1,WESTERN EUROPE-EU,NETHERLANDS,2,BIRMINGHAM,AMSTERDAM,701737,701659,78,703047,703047,0,-0.18633
17/03/2020 10:48,2019,1,WESTERN EUROPE-EU,NETHERLANDS,2,BIRMINGHAM,EINDHOVEN,59,0,59,148,148,0,-60.13514
17/03/2020 10:48,2019,1,WESTERN EUROPE-EU,NETHERLANDS,2,BIRMINGHAM,GRONINGEN,0,0,0,241,0,241,-100
17/03/2020 10:48,2019,1,WESTERN EUROPE-EU,NETHERLANDS,2,BIRMINGHAM,ROTTERDAM,0,0,0,70,70,0,-100
17/03/2020 10:48,2019,1,WESTERN EUROPE-EU,NETHERLANDS,2,BRISTOL,AMSTERDAM,457330,457330,0,433802,433802,0,5.42367
17/03/2020 10:48,2019,1,WESTERN EUROPE-EU,NETHERLANDS,2,CARDIFF WALES,AMSTERDAM,161946,161946,0,146058,146058,0,10.87787
17/03/2020 10:48,2019,1,WESTERN EUROPE-EU,NETHERLANDS,2,DONCASTER SHEFFIELD,AMSTERDAM,48840,48840,0,58262,58262,0,-16.17178
17/03/2020 10:48,2019,1,WESTERN EUROPE-EU,NETHERLANDS,2,DUNDEE,AMSTERDAM,18,0,18,2,0,2,800
17/03/2020 10:48,2019,1,WESTERN EUROPE-EU,NETHERLANDS,2,EAST MIDLANDS INTERNATIONAL,AMSTERDAM,48462,48462,0,48408,48408,0,0.11155
17/03/2020 10:48,2019,1,WESTERN EUROPE-EU,NETHERLANDS,2,EAST MIDLANDS INTERNATIONAL,MAASTRICHT,0,0,0,66,0,66,-100
17/03/2020 10:48,2019,1,WESTERN EUROPE-EU,NETHERLANDS,2,EDINBURGH,AMSTERDAM,680388,680031,357,679148,679051,97,0.18258
17/03/2020 10:48,2019,1,WESTERN EUROPE-EU,NETHERLANDS,2,EDINBURGH,EINDHOVEN,48334,48334,0,49722,49722,0,-2.79152
17/03/2020 10:48,2019,1,WESTERN EUROPE-EU,NETHERLANDS,2,EXETER,AMSTERDAM,61658,61658,0,52725,52620,105,16.94263
17/03/2020 10:48,2019,1,WESTERN EUROPE-EU,NETHERLANDS,2,GLASGOW,AMSTERDAM,439409,439313,96,418067,418067,0,5.10492
17/03/2020 10:48,2019,1,WESTERN EUROPE-EU,NETHERLANDS,2,GLASGOW,EINDHOVEN,658,0,658,356,0,356,84.83146
17/03/2020 10:48,2019,1,WESTERN EUROPE-EU,NETHERLANDS,2,GLASGOW,GRONINGEN,0,0,0,29,0,29,-100
17/03/2020 10:48,2019,1,WESTERN EUROPE-EU,NETHERLANDS,2,GLASGOW,MAASTRICHT,0,0,0,62,0,62,-100
17/03/2020 10:48,2019,1,WESTERN EUROPE-EU,NETHERLANDS,2,GLASGOW,ROTTERDAM,1380,0,1380,122,0,122,1031.14754
17/03/2020 10:48,2019,1,WESTERN EUROPE-EU,NETHERLANDS,2,GUERNSEY,GRONINGEN,1079,88,991,0,0,0,0
17/03/2020 10:48,2019,1,WESTERN EUROPE-EU,NETHERLANDS,2,GUERNSEY,MAASTRICHT,37,0,37,0,0,0,0
17/03/2020 10:48,2019,1,WESTERN EUROPE-EU,NETHERLANDS,2,GUERNSEY,ROTTERDAM,1665,36,1629,1682,0,1682,-1.0107
17/03/2020 10:48,2019,1,WESTERN EUROPE-EU,NETHERLANDS,2,HUMBERSIDE,AMSTERDAM,134946,134946,0,127090,127090,0,6.18145
17/03/2020 10:48,2019,1,WESTERN EUROPE-EU,NETHERLANDS,2,HUMBERSIDE,ROTTERDAM,0,0,0,71,0,71,-100
17/03/2020 10:48,2019,1,WESTERN EUROPE-EU,NETHERLANDS,2,INVERNESS,AMSTERDAM,98921,98563,358,81047,81047,0,22.05387
17/03/2020 10:48,2019,1,WESTERN EUROPE-EU,NETHERLANDS,2,INVERNESS,ROTTERDAM,157,0,157,34,0,34,361.76471
17/03/2020 10:48,2019,1,WESTERN EUROPE-EU,NETHERLANDS,2,JERSEY,MAASTRICHT,56,0,56,0,0,0,0
17/03/2020 10:48,2019,1,WESTERN EUROPE-EU,NETHERLANDS,2,JERSEY,ROTTERDAM,406,115,291,454,0,454,-10.57269
17/03/2020 10:48,2019,1,WESTERN EUROPE-EU,NETHERLANDS,2,KIRKWALL,GRONINGEN,0,0,0,62,0,62,-100
17/03/2020 10:48,2019,1,WESTERN EUROPE-EU,NETHERLANDS,2,LEEDS BRADFORD,AMSTERDAM,266142,266142,0,252180,251885,295,5.53652
17/03/2020 10:48,2019,1,WESTERN EUROPE-EU,NETHERLANDS,2,LIVERPOOL (JOHN LENNON),AMSTERDAM,240087,240087,0,220517,220170,347,8.8746
17/03/2020 10:48,2019,1,WESTERN EUROPE-EU,NETHERLANDS,2,LIVERPOOL (JOHN LENNON),MAASTRICHT,669,0,669,0,0,0,0
17/03/2020 10:48,2019,1,WESTERN EUROPE-EU,NETHERLANDS,2,MANCHESTER,AMSTERDAM,1064910,1064313,597,1035637,1035592,45,2.82657
17/03/2020 10:48,2019,1,WESTERN EUROPE-EU,NETHERLANDS,2,MANCHESTER,EINDHOVEN,68173,68173,0,72129,72129,0,-5.48462
17/03/2020 10:48,2019,1,WESTERN EUROPE-EU,NETHERLANDS,2,MANCHESTER,ROTTERDAM,100,0,100,0,0,0,0
17/03/2020 10:48,2019,1,WESTERN EUROPE-EU,NETHERLANDS,2,NEWCASTLE,AMSTERDAM,362851,362636,215,347864,347369,495,4.30829
17/03/2020 10:48,2019,1,WESTERN EUROPE-EU,NETHERLANDS,2,NEWCASTLE,EINDHOVEN,155,0,155,0,0,0,0
17/03/2020 10:48,2019,1,WESTERN EUROPE-EU,NETHERLANDS,2,NORWICH,AMSTERDAM,166098,166098,0,147040,146945,95,12.9611
17/03/2020 10:48,2019,1,WESTERN EUROPE-EU,NETHERLANDS,2,NORWICH,DEN HELDER,0,0,0,38,38,0,-100
17/03/2020 10:48,2019,1,WESTERN EUROPE-EU,NETHERLANDS,2,PRESTWICK,AMSTERDAM,113,0,113,96,0,96,17.70833
17/03/2020 10:48,2019,1,WESTERN EUROPE-EU,NETHERLANDS,2,SOUTHAMPTON,AMSTERDAM,178051,178051,0,233700,233532,168,-23.81215
17/03/2020 10:48,2019,1,WESTERN EUROPE-EU,NETHERLANDS,2,SOUTHAMPTON,ROTTERDAM,53,0,53,0,0,0,0
17/03/2020 10:48,2019,1,WESTERN EUROPE-EU,NETHERLANDS,2,TEESSIDE INTERNATIONAL AIRPORT,AMSTERDAM,118907,118907,0,110754,110684,70,7.36136
17/03/2020 10:48,2019,1,WESTERN EUROPE-EU,PORTUGAL(EXCLUDING MADEIRA),1,GATWICK,AZORES PONTA DELGADA,3030,3030,0,4516,4516,0,-32.90523
17/03/2020 10:48,2019,1,WESTERN EUROPE-EU,PORTUGAL(EXCLUDING MADEIRA),1,GATWICK,FARO,714325,688842,25483,700128,662809,37319,2.02777
17/03/2020 10:48,2019,1,WESTERN EUROPE-EU,PORTUGAL(EXCLUDING MADEIRA),1,GATWICK,LISBON,376093,376000,93,349181,348545,636,7.70718
17/03/2020 10:48,2019,1,WESTERN EUROPE-EU,PORTUGAL(EXCLUDING MADEIRA),1,GATWICK,OPORTO (PORTUGAL),387074,387074,0,364152,364152,0,6.29462
17/03/2020 10:48,2019,1,WESTERN EUROPE-EU,PORTUGAL(EXCLUDING MADEIRA),1,HEATHROW,FARO,71325,71325,0,32846,32846,0,117.14973
17/03/2020 10:48,2019,1,WESTERN EUROPE-EU,PORTUGAL(EXCLUDING MADEIRA),1,HEATHROW,LISBON,943228,943228,0,853048,853048,0,10.5715
17/03/2020 10:48,2019,1,WESTERN EUROPE-EU,PORTUGAL(EXCLUDING MADEIRA),1,LONDON CITY,FARO,12476,12476,0,12186,12186,0,2.37978
17/03/2020 10:48,2019,1,WESTERN EUROPE-EU,PORTUGAL(EXCLUDING MADEIRA),1,LONDON CITY,LISBON,66171,66171,0,83211,83211,0,-20.47806
17/03/2020 10:48,2019,1,WESTERN EUROPE-EU,PORTUGAL(EXCLUDING MADEIRA),1,LONDON CITY,OPORTO (PORTUGAL),32809,32809,0,30420,30420,0,7.85339
17/03/2020 10:48,2019,1,WESTERN EUROPE-EU,PORTUGAL(EXCLUDING MADEIRA),1,LUTON,FARO,284291,281897,2394,289729,272353,17376,-1.87693
17/03/2020 10:48,2019,1,WESTERN EUROPE-EU,PORTUGAL(EXCLUDING MADEIRA),1,LUTON,LISBON,414477,414349,128,301094,300923,171,37.65701
17/03/2020 10:48,2019,1,WESTERN EUROPE-EU,PORTUGAL(EXCLUDING MADEIRA),1,LUTON,OPORTO (PORTUGAL),87697,87578,119,59302,58440,862,47.88203
17/03/2020 10:48,2019,1,WESTERN EUROPE-EU,PORTUGAL(EXCLUDING MADEIRA),1,SOUTHEND,FARO,161755,161755,0,95963,95963,0,68.55976
17/03/2020 10:48,2019,1,WESTERN EUROPE-EU,PORTUGAL(EXCLUDING MADEIRA),1,SOUTHEND,OPORTO (PORTUGAL),156,156,0,0,0,0,0
17/03/2020 10:48,2019,1,WESTERN EUROPE-EU,PORTUGAL(EXCLUDING MADEIRA),1,STANSTED,AZORES PONTA DELGADA,17090,17090,0,17521,17521,0,-2.45991
17/03/2020 10:48,2019,1,WESTERN EUROPE-EU,PORTUGAL(EXCLUDING MADEIRA),1,STANSTED,FARO,399477,381652,17825,365274,345085,20189,9.36366
17/03/2020 10:48,2019,1,WESTERN EUROPE-EU,PORTUGAL(EXCLUDING MADEIRA),1,STANSTED,LISBON,465027,464503,524,365819,365514,305,27.11942
17/03/2020 10:48,2019,1,WESTERN EUROPE-EU,PORTUGAL(EXCLUDING MADEIRA),1,STANSTED,OPORTO (PORTUGAL),348232,348027,205,322504,322504,0,7.97758
17/03/2020 10:48,2019,1,WESTERN EUROPE-EU,PORTUGAL(EXCLUDING MADEIRA),2,ABERDEEN,FARO,20755,20755,0,22115,22115,0,-6.14967
17/03/2020 10:48,2019,1,WESTERN EUROPE-EU,PORTUGAL(EXCLUDING MADEIRA),2,BELFAST CITY (GEORGE BEST),FARO,34689,34689,0,39683,39674,9,-12.58473
17/03/2020 10:48,2019,1,WESTERN EUROPE-EU,PORTUGAL(EXCLUDING MADEIRA),2,BELFAST INTERNATIONAL,FARO,209374,209242,132,186267,186267,0,12.40531
17/03/2020 10:48,2019,1,WESTERN EUROPE-EU,PORTUGAL(EXCLUDING MADEIRA),2,BIGGIN HILL,FARO,19,0,19,20,0,20,-5
17/03/2020 10:48,2019,1,WESTERN EUROPE-EU,PORTUGAL(EXCLUDING MADEIRA),2,BIGGIN HILL,LISBON,7,0,7,3,0,3,133.33333
17/03/2020 10:48,2019,1,WESTERN EUROPE-EU,PORTUGAL(EXCLUDING MADEIRA),2,BIRMINGHAM,FARO,285487,266289,19198,253213,225124,28089,12.74579
17/03/2020 10:48,2019,1,WESTERN EUROPE-EU,PORTUGAL(EXCLUDING MADEIRA),2,BIRMINGHAM,LISBON,0,0,0,355,355,0,-100
17/03/2020 10:48,2019,1,WESTERN EUROPE-EU,PORTUGAL(EXCLUDING MADEIRA),2,BIRMINGHAM,OPORTO (PORTUGAL),27484,27228,256,21967,21967,0,25.11495
17/03/2020 10:48,2019,1,WESTERN EUROPE-EU,PORTUGAL(EXCLUDING MADEIRA),2,BOURNEMOUTH,FARO,57043,57043,0,56589,56589,0,0.80228
17/03/2020 10:48,2019,1,WESTERN EUROPE-EU,PORTUGAL(EXCLUDING MADEIRA),2,BOURNEMOUTH,LISBON,0,0,0,94,0,94,-100
17/03/2020 10:48,2019,1,WESTERN EUROPE-EU,PORTUGAL(EXCLUDING MADEIRA),2,BRISTOL,FARO,307097,298118,8979,301716,292146,9570,1.78347
17/03/2020 10:48,2019,1,WESTERN EUROPE-EU,PORTUGAL(EXCLUDING MADEIRA),2,BRISTOL,LISBON,84516,84516,0,76538,76538,0,10.42358
17/03/2020 10:48,2019,1,WESTERN EUROPE-EU,PORTUGAL(EXCLUDING MADEIRA),2,BRISTOL,OPORTO (PORTUGAL),48667,48667,0,43120,43120,0,12.8641
17/03/2020 10:48,2019,1,WESTERN EUROPE-EU,PORTUGAL(EXCLUDING MADEIRA),2,CARDIFF WALES,FARO,48560,39684,8876,64036,56290,7746,-24.16766
17/03/2020 10:48,2019,1,WESTERN EUROPE-EU,PORTUGAL(EXCLUDING MADEIRA),2,CARDIFF WALES,LISBON,0,0,0,141,141,0,-100
17/03/2020 10:48,2019,1,WESTERN EUROPE-EU,PORTUGAL(EXCLUDING MADEIRA),2,DONCASTER SHEFFIELD,FARO,17394,8193,9201,31624,13249,18375,-44.99747
17/03/2020 10:48,2019,1,WESTERN EUROPE-EU,PORTUGAL(EXCLUDING MADEIRA),2,EAST MIDLANDS INTERNATIONAL,FARO,252343,243223,9120,244844,244844,0,3.06277
17/03/2020 10:48,2019,1,WESTERN EUROPE-EU,PORTUGAL(EXCLUDING MADEIRA),2,EAST MIDLANDS INTERNATIONAL,LISBON,165,165,0,0,0,0,0
17/03/2020 10:48,2019,1,WESTERN EUROPE-EU,PORTUGAL(EXCLUDING MADEIRA),2,EAST MIDLANDS INTERNATIONAL,OPORTO (PORTUGAL),561,185,376,0,0,0,0
17/03/2020 10:48,2019,1,WESTERN EUROPE-EU,PORTUGAL(EXCLUDING MADEIRA),2,EDINBURGH,FARO,130968,130968,0,122750,122750,0,6.69491
17/03/2020 10:48,2019,1,WESTERN EUROPE-EU,PORTUGAL(EXCLUDING MADEIRA),2,EDINBURGH,LISBON,85141,84923,218,53497,53497,0,59.15098
17/03/2020 10:48,2019,1,WESTERN EUROPE-EU,PORTUGAL(EXCLUDING MADEIRA),2,EDINBURGH,OPORTO (PORTUGAL),31533,31533,0,35155,35155,0,-10.30294
17/03/2020 10:48,2019,1,WESTERN EUROPE-EU,PORTUGAL(EXCLUDING MADEIRA),2,EXETER,FARO,22438,14274,8164,23685,15269,8416,-5.26494
17/03/2020 10:48,2019,1,WESTERN EUROPE-EU,PORTUGAL(EXCLUDING MADEIRA),2,GLASGOW,FARO,117680,117564,116,120864,117277,3587,-2.63437
17/03/2020 10:48,2019,1,WESTERN EUROPE-EU,PORTUGAL(EXCLUDING MADEIRA),2,GLASGOW,LISBON,0,0,0,27359,27226,133,-100
17/03/2020 10:48,2019,1,WESTERN EUROPE-EU,PORTUGAL(EXCLUDING MADEIRA),2,GLASGOW,OPORTO (PORTUGAL),1313,0,1313,0,0,0,0
17/03/2020 10:48,2019,1,WESTERN EUROPE-EU,PORTUGAL(EXCLUDING MADEIRA),2,GUERNSEY,FARO,6,0,6,0,0,0,0
17/03/2020 10:48,2019,1,WESTERN EUROPE-EU,PORTUGAL(EXCLUDING MADEIRA),2,JERSEY,FARO,0,0,0,420,131,289,-100
17/03/2020 10:48,2019,1,WESTERN EUROPE-EU,PORTUGAL(EXCLUDING MADEIRA),2,LEEDS BRADFORD,FARO,200282,200282,0,197124,197124,0,1.60204
17/03/2020 10:48,2019,1,WESTERN EUROPE-EU,PORTUGAL(EXCLUDING MADEIRA),2,LIVERPOOL (JOHN LENNON),FARO,203295,203295,0,197740,197624,116,2.80924
17/03/2020 10:48,2019,1,WESTERN EUROPE-EU,PORTUGAL(EXCLUDING MADEIRA),2,LIVERPOOL (JOHN LENNON),LISBON,0,0,0,47185,47185,0,-100
17/03/2020 10:48,2019,1,WESTERN EUROPE-EU,PORTUGAL(EXCLUDING MADEIRA),2,LIVERPOOL (JOHN LENNON),OPORTO (PORTUGAL),36443,34790,1653,36742,35680,1062,-0.81378
17/03/2020 10:48,2019,1,WESTERN EUROPE-EU,PORTUGAL(EXCLUDING MADEIRA),2,MANCHESTER,AZORES PONTA DELGADA,9545,9545,0,6434,6434,0,48.3525
17/03/2020 10:48,2019,1,WESTERN EUROPE-EU,PORTUGAL(EXCLUDING MADEIRA),2,MANCHESTER,FARO,521811,501880,19931,458246,427355,30891,13.87137
17/03/2020 10:48,2019,1,WESTERN EUROPE-EU,PORTUGAL(EXCLUDING MADEIRA),2,MANCHESTER,LISBON,329193,329193,0,247476,247052,424,33.02017
17/03/2020 10:48,2019,1,WESTERN EUROPE-EU,PORTUGAL(EXCLUDING MADEIRA),2,MANCHESTER,OPORTO (PORTUGAL),101538,100659,879,78904,78067,837,28.68549
17/03/2020 10:48,2019,1,WESTERN EUROPE-EU,PORTUGAL(EXCLUDING MADEIRA),2,NEWCASTLE,FARO,183536,183536,0,172176,171983,193,6.5979
17/03/2020 10:48,2019,1,WESTERN EUROPE-EU,PORTUGAL(EXCLUDING MADEIRA),2,NEWCASTLE,OPORTO (PORTUGAL),0,0,0,90,0,90,-100
17/03/2020 10:48,2019,1,WESTERN EUROPE-EU,PORTUGAL(EXCLUDING MADEIRA),2,NEWQUAY,FARO,21439,21439,0,20868,20868,0,2.73625
17/03/2020 10:48,2019,1,WESTERN EUROPE-EU,PORTUGAL(EXCLUDING MADEIRA),2,PRESTWICK,FARO,61474,61298,176,59086,59086,0,4.04157
17/03/2020 10:48,2019,1,WESTERN EUROPE-EU,PORTUGAL(EXCLUDING MADEIRA),2,SOUTHAMPTON,FARO,15519,15519,0,19364,19364,0,-19.85643
17/03/2020 10:48,2019,1,WESTERN EUROPE-EU,PORTUGAL(MADEIRA),1,GATWICK,FUNCHAL,262527,232302,30225,264426,234240,30186,-0.71816
17/03/2020 10:48,2019,1,WESTERN EUROPE-EU,PORTUGAL(MADEIRA),1,GATWICK,PORTO SANTO,8927,0,8927,9090,76,9014,-1.79318
17/03/2020 10:48,2019,1,WESTERN EUROPE-EU,PORTUGAL(MADEIRA),1,LUTON,FUNCHAL,2138,0,2138,8831,0,8831,-75.78983
17/03/2020 10:48,2019,1,WESTERN EUROPE-EU,PORTUGAL(MADEIRA),1,STANSTED,FUNCHAL,60500,60500,0,43450,43450,0,39.24051
17/03/2020 10:48,2019,1,WESTERN EUROPE-EU,PORTUGAL(MADEIRA),2,BELFAST INTERNATIONAL,FUNCHAL,11350,11350,0,10197,10197,0,11.30725
17/03/2020 10:48,2019,1,WESTERN EUROPE-EU,PORTUGAL(MADEIRA),2,BIRMINGHAM,FUNCHAL,29916,29728,188,35510,19569,15941,-15.75331
17/03/2020 10:48,2019,1,WESTERN EUROPE-EU,PORTUGAL(MADEIRA),2,BIRMINGHAM,PORTO SANTO,5479,0,5479,7106,0,7106,-22.89614
17/03/2020 10:48,2019,1,WESTERN EUROPE-EU,PORTUGAL(MADEIRA),2,BOURNEMOUTH,FUNCHAL,0,0,0,314,172,142,-100
17/03/2020 10:48,2019,1,WESTERN EUROPE-EU,PORTUGAL(MADEIRA),2,BRISTOL,FUNCHAL,43699,43699,0,39613,39613,0,10.3148
17/03/2020 10:48,2019,1,WESTERN EUROPE-EU,PORTUGAL(MADEIRA),2,CARDIFF WALES,FUNCHAL,0,0,0,183,183,0,-100
17/03/2020 10:48,2019,1,WESTERN EUROPE-EU,PORTUGAL(MADEIRA),2,DONCASTER SHEFFIELD,FUNCHAL,194,0,194,0,0,0,0
17/03/2020 10:48,2019,1,WESTERN EUROPE-EU,PORTUGAL(MADEIRA),2,EAST MIDLANDS INTERNATIONAL,FUNCHAL,35083,17360,17723,33887,17172,16715,3.52938
17/03/2020 10:48,2019,1,WESTERN EUROPE-EU,PORTUGAL(MADEIRA),2,EDINBURGH,FUNCHAL,17982,17982,0,18152,18152,0,-0.93654
17/03/2020 10:48,2019,1,WESTERN EUROPE-EU,PORTUGAL(MADEIRA),2,EXETER,FUNCHAL,0,0,0,140,0,140,-100
17/03/2020 10:48,2019,1,WESTERN EUROPE-EU,PORTUGAL(MADEIRA),2,GLASGOW,FUNCHAL,17489,17489,0,17832,17832,0,-1.92351
17/03/2020 10:48,2019,1,WESTERN EUROPE-EU,PORTUGAL(MADEIRA),2,HUMBERSIDE,FUNCHAL,0,0,0,226,0,226,-100
17/03/2020 10:48,2019,1,WESTERN EUROPE-EU,PORTUGAL(MADEIRA),2,ISLE OF MAN,FUNCHAL,0,0,0,221,0,221,-100
17/03/2020 10:48,2019,1,WESTERN EUROPE-EU,PORTUGAL(MADEIRA),2,JERSEY,FUNCHAL,10919,143,10776,6857,2573,4284,59.23873
17/03/2020 10:48,2019,1,WESTERN EUROPE-EU,PORTUGAL(MADEIRA),2,LEEDS BRADFORD,FUNCHAL,18176,18176,0,18541,18541,0,-1.96861
17/03/2020 10:48,2019,1,WESTERN EUROPE-EU,PORTUGAL(MADEIRA),2,MANCHESTER,FUNCHAL,102392,75668,26724,124205,96002,28203,-17.56209
17/03/2020 10:48,2019,1,WESTERN EUROPE-EU,PORTUGAL(MADEIRA),2,MANCHESTER,PORTO SANTO,6069,0,6069,8588,0,8588,-29.33163
17/03/2020 10:48,2019,1,WESTERN EUROPE-EU,PORTUGAL(MADEIRA),2,NEWCASTLE,FUNCHAL,17016,17016,0,16733,16733,0,1.69127
17/03/2020 10:48,2019,1,WESTERN EUROPE-EU,PORTUGAL(MADEIRA),2,NORWICH,FUNCHAL,0,0,0,254,0,254,-100
17/03/2020 10:48,2019,1,WESTERN EUROPE-EU,SLOVENIA,1,GATWICK,LJUBLJANA,61299,61299,0,63032,63032,0,-2.7494
17/03/2020 10:48,2019,1,WESTERN EUROPE-EU,SLOVENIA,1,HEATHROW,LJUBLJANA,4497,4497,0,0,0,0,0
17/03/2020 10:48,2019,1,WESTERN EUROPE-EU,SLOVENIA,1,LUTON,LJUBLJANA,45493,45493,0,66047,66047,0,-31.12026
17/03/2020 10:48,2019,1,WESTERN EUROPE-EU,SLOVENIA,1,STANSTED,LJUBLJANA,120413,120413,0,118043,118043,0,2.00774
17/03/2020 10:48,2019,1,WESTERN EUROPE-EU,SLOVENIA,2,BELFAST INTERNATIONAL,LJUBLJANA,0,0,0,93,0,93,-100
17/03/2020 10:48,2019,1,WESTERN EUROPE-EU,SLOVENIA,2,GLASGOW,MARIBOR,0,0,0,582,0,582,-100
17/03/2020 10:48,2019,1,WESTERN EUROPE-EU,SLOVENIA,2,MANCHESTER,LJUBLJANA,2525,2071,454,2651,2255,396,-4.75292
17/03/2020 10:48,2019,1,WESTERN EUROPE-EU,SPAIN,1,GATWICK,ALICANTE,891356,856788,34568,802860,751284,51576,11.02259
17/03/2020 10:48,2019,1,WESTERN EUROPE-EU,SPAIN,1,GATWICK,ALMERIA,145469,136823,8646,123432,114582,8850,17.85355
17/03/2020 10:48,2019,1,WESTERN EUROPE-EU,SPAIN,1,GATWICK,ASTURIAS,35520,35520,0,34402,34402,0,3.24981
17/03/2020 10:48,2019,1,WESTERN EUROPE-EU,SPAIN,1,GATWICK,BARCELONA,1586932,1586574,358,1555323,1553603,1720,2.03231
17/03/2020 10:48,2019,1,WESTERN EUROPE-EU,SPAIN,1,GATWICK,BILBAO,215907,215907,0,108931,108795,136,98.20529
17/03/2020 10:48,2019,1,WESTERN EUROPE-EU,SPAIN,1,GATWICK,GIRONA,14479,0,14479,14722,0,14722,-1.65059
17/03/2020 10:48,2019,1,WESTERN EUROPE-EU,SPAIN,1,GATWICK,GRANADA,47591,47591,0,45748,45748,0,4.02859
17/03/2020 10:48,2019,1,WESTERN EUROPE-EU,SPAIN,1,GATWICK,IBIZA,280657,225573,55084,287019,222201,64818,-2.21658
17/03/2020 10:48,2019,1,WESTERN EUROPE-EU,SPAIN,1,GATWICK,JEREZ,35195,25967,9228,9055,0,9055,288.68029
17/03/2020 10:48,2019,1,WESTERN EUROPE-EU,SPAIN,1,GATWICK,LIEIDA,5674,0,5674,7267,6056,1211,-21.92101
17/03/2020 10:48,2019,1,WESTERN EUROPE-EU,SPAIN,1,GATWICK,MADRID,1030956,1030956,0,1026627,1026606,21,0.42167
17/03/2020 10:48,2019,1,WESTERN EUROPE-EU,SPAIN,1,GATWICK,MAHON,237337,187069,50268,248486,177660,70826,-4.48677
17/03/2020 10:48,2019,1,WESTERN EUROPE-EU,SPAIN,1,GATWICK,MALAGA,1112615,1070960,41655,1089976,1023731,66245,2.07702
17/03/2020 10:48,2019,1,WESTERN EUROPE-EU,SPAIN,1,GATWICK,MURCIA INTERNATIONAL,181236,181236,0,0,0,0,0
17/03/2020 10:48,2019,1,WESTERN EUROPE-EU,SPAIN,1,GATWICK,MURCIA SAN JAVIER,3557,3557,0,177396,177396,0,-97.99488
17/03/2020 10:48,2019,1,WESTERN EUROPE-EU,SPAIN,1,GATWICK,PALMA DE MALLORCA,772671,665136,107535,782401,644042,138359,-1.24361
17/03/2020 10:48,2019,1,WESTERN EUROPE-EU,SPAIN,1,GATWICK,REUS,43331,16400,26931,44849,17251,27598,-3.38469
17/03/2020 10:48,2019,1,WESTERN EUROPE-EU,SPAIN,1,GATWICK,SANTIAGO DE COMPOSTELA (SPAIN),22084,22084,0,34105,34105,0,-35.24703
17/03/2020 10:48,2019,1,WESTERN EUROPE-EU,SPAIN,1,GATWICK,SEVILLE,240453,239445,1008,202384,202384,0,18.81028
17/03/2020 10:48,2019,1,WESTERN EUROPE-EU,SPAIN,1,GATWICK,VALENCIA,307712,307435,277,359889,359889,0,-14.49808
17/03/2020 10:48,2019,1,WESTERN EUROPE-EU,SPAIN,1,GATWICK,VIGO,0,0,0,47,0,47,-100
17/03/2020 10:48,2019,1,WESTERN EUROPE-EU,SPAIN,1,GATWICK,VITORIA,44,0,44,0,0,0,0
17/03/2020 10:48,2019,1,WESTERN EUROPE-EU,SPAIN,1,GATWICK,ZARAGOZA,0,0,0,94,0,94,-100
17/03/2020 10:48,2019,1,WESTERN EUROPE-EU,SPAIN,1,HEATHROW,A CORUNA,112412,112412,0,113013,113013,0,-0.5318
17/03/2020 10:48,2019,1,WESTERN EUROPE-EU,SPAIN,1,HEATHROW,ALMERIA,0,0,0,17759,17759,0,-100
17/03/2020 10:48,2019,1,WESTERN EUROPE-EU,SPAIN,1,HEATHROW,ASTURIAS,0,0,0,18602,18602,0,-100
17/03/2020 10:48,2019,1,WESTERN EUROPE-EU,SPAIN,1,HEATHROW,BARCELONA,785125,785125,0,764204,764204,0,2.73762
17/03/2020 10:48,2019,1,WESTERN EUROPE-EU,SPAIN,1,HEATHROW,BILBAO,24617,24617,0,167530,167530,0,-85.30592
17/03/2020 10:48,2019,1,WESTERN EUROPE-EU,SPAIN,1,HEATHROW,IBIZA,72057,72057,0,46815,46815,0,53.91862
17/03/2020 10:48,2019,1,WESTERN EUROPE-EU,SPAIN,1,HEATHROW,JEREZ,0,0,0,104,104,0,-100
17/03/2020 10:48,2019,1,WESTERN EUROPE-EU,SPAIN,1,HEATHROW,MADRID,1476551,1475893,658,1417554,1417554,0,4.16189
17/03/2020 10:48,2019,1,WESTERN EUROPE-EU,SPAIN,1,HEATHROW,MAHON,0,0,0,12561,12561,0,-100
17/03/2020 10:48,2019,1,WESTERN EUROPE-EU,SPAIN,1,HEATHROW,MALAGA,120345,120345,0,106567,106567,0,12.92896
17/03/2020 10:48,2019,1,WESTERN EUROPE-EU,SPAIN,1,HEATHROW,MURCIA SAN JAVIER,0,0,0,17334,17334,0,-100
17/03/2020 10:48,2019,1,WESTERN EUROPE-EU,SPAIN,1,HEATHROW,PALMA DE MALLORCA,141246,141246,0,127862,127862,0,10.46754
17/03/2020 10:48,2019,1,WESTERN EUROPE-EU,SPAIN,1,HEATHROW,SANTIAGO DE COMPOSTELA (SPAIN),204,204,0,0,0,0,0
17/03/2020 10:48,2019,1,WESTERN EUROPE-EU,SPAIN,1,HEATHROW,VALENCIA,99320,99320,0,0,0,0,0
17/03/2020 10:48,2019,1,WESTERN EUROPE-EU,SPAIN,1,LONDON CITY,GRANADA,14832,14832,0,14641,14641,0,1.30456
17/03/2020 10:48,2019,1,WESTERN EUROPE-EU,SPAIN,1,LONDON CITY,IBIZA,95785,95785,0,87787,87691,96,9.11069
17/03/2020 10:48,2019,1,WESTERN EUROPE-EU,SPAIN,1,LONDON CITY,MADRID,0,0,0,99,99,0,-100
17/03/2020 10:48,2019,1,WESTERN EUROPE-EU,SPAIN,1,LONDON CITY,MAHON,3278,3278,0,2854,2854,0,14.85634
17/03/2020 10:48,2019,1,WESTERN EUROPE-EU,SPAIN,1,LONDON CITY,MALAGA,60396,60396,0,62870,62870,0,-3.9351
17/03/2020 10:48,2019,1,WESTERN EUROPE-EU,SPAIN,1,LONDON CITY,PALMA DE MALLORCA,44714,44714,0,44903,44903,0,-0.42091
17/03/2020 10:48,2019,1,WESTERN EUROPE-EU,SPAIN,1,LUTON,ALICANTE,317161,317161,0,211781,211344,437,49.75895
17/03/2020 10:48,2019,1,WESTERN EUROPE-EU,SPAIN,1,LUTON,ALMERIA,0,0,0,123,0,123,-100
17/03/2020 10:48,2019,1,WESTERN EUROPE-EU,SPAIN,1,LUTON,BARCELONA,468761,468761,0,403426,403271,155,16.19504
17/03/2020 10:48,2019,1,WESTERN EUROPE-EU,SPAIN,1,LUTON,CASTELLON COSTA AZAHAR,1349,1349,0,0,0,0,0
17/03/2020 10:48,2019,1,WESTERN EUROPE-EU,SPAIN,1,LUTON,CASTELLON DE LA PLANA AIRPORT,559,559,0,0,0,0,0
17/03/2020 10:48,2019,1,WESTERN EUROPE-EU,SPAIN,1,LUTON,GIRONA,29914,29914,0,30002,30002,0,-0.29331
17/03/2020 10:48,2019,1,WESTERN EUROPE-EU,SPAIN,1,LUTON,IBIZA,86686,75764,10922,94316,73422,20894,-8.08983
17/03/2020 10:48,2019,1,WESTERN EUROPE-EU,SPAIN,1,LUTON,MADRID,134769,132905,1864,132794,132253,541,1.48727
17/03/2020 10:48,2019,1,WESTERN EUROPE-EU,SPAIN,1,LUTON,MAHON,47508,45460,2048,60100,45490,14610,-20.95175
17/03/2020 10:48,2019,1,WESTERN EUROPE-EU,SPAIN,1,LUTON,MALAGA,381836,377588,4248,303037,283091,19946,26.0031
17/03/2020 10:48,2019,1,WESTERN EUROPE-EU,SPAIN,1,LUTON,MURCIA INTERNATIONAL,81037,81037,0,0,0,0,0
17/03/2020 10:48,2019,1,WESTERN EUROPE-EU,SPAIN,1,LUTON,MURCIA SAN JAVIER,1827,1827,0,95447,95447,0,-98.08585
17/03/2020 10:48,2019,1,WESTERN EUROPE-EU,SPAIN,1,LUTON,PALMA DE MALLORCA,235183,209199,25984,239991,199709,40282,-2.00341
17/03/2020 10:48,2019,1,WESTERN EUROPE-EU,SPAIN,1,LUTON,REUS,19744,17682,2062,25850,16273,9577,-23.62089
17/03/2020 10:48,2019,1,WESTERN EUROPE-EU,SPAIN,1,LUTON,SEVILLE,55223,55223,0,50381,50381,0,9.61077
17/03/2020 10:48,2019,1,WESTERN EUROPE-EU,SPAIN,1,LUTON,VALENCIA,42781,42640,141,45698,45698,0,-6.38321
17/03/2020 10:48,2019,1,WESTERN EUROPE-EU,SPAIN,1,LUTON,VIGO,0,0,0,2442,2442,0,-100
17/03/2020 10:48,2019,1,WESTERN EUROPE-EU,SPAIN,1,LUTON,VITORIA,90,0,90,0,0,0,0
17/03/2020 10:48,2019,1,WESTERN EUROPE-EU,SPAIN,1,SOUTHEND,ALICANTE,199397,199397,0,109963,109963,0,81.33099
17/03/2020 10:48,2019,1,WESTERN EUROPE-EU,SPAIN,1,SOUTHEND,BARCELONA,49125,49125,0,45974,45974,0,6.85387
17/03/2020 10:48,2019,1,WESTERN EUROPE-EU,SPAIN,1,SOUTHEND,BILBAO,41500,41500,0,0,0,0,0
17/03/2020 10:48,2019,1,WESTERN EUROPE-EU,SPAIN,1,SOUTHEND,GIRONA,13,13,0,4,4,0,225
17/03/2020 10:48,2019,1,WESTERN EUROPE-EU,SPAIN,1,SOUTHEND,IBIZA,24569,24569,0,21004,21004,0,16.97296
17/03/2020 10:48,2019,1,WESTERN EUROPE-EU,SPAIN,1,SOUTHEND,MAHON,17254,17254,0,16529,16529,0,4.38623
17/03/2020 10:48,2019,1,WESTERN EUROPE-EU,SPAIN,1,SOUTHEND,MALAGA,163639,163639,0,95413,95413,0,71.50598
17/03/2020 10:48,2019,1,WESTERN EUROPE-EU,SPAIN,1,SOUTHEND,MURCIA INTERNATIONAL,28500,28500,0,0,0,0,0
17/03/2020 10:48,2019,1,WESTERN EUROPE-EU,SPAIN,1,SOUTHEND,MURCIA SAN JAVIER,967,967,0,22255,22255,0,-95.65491
17/03/2020 10:48,2019,1,WESTERN EUROPE-EU,SPAIN,1,SOUTHEND,PALMA DE MALLORCA,143888,143888,0,66485,66485,0,116.42175
17/03/2020 10:48,2019,1,WESTERN EUROPE-EU,SPAIN,1,SOUTHEND,REUS,20214,20214,0,0,0,0,0
17/03/2020 10:48,2019,1,WESTERN EUROPE-EU,SPAIN,1,STANSTED,ALICANTE,372931,372931,0,412693,412693,0,-9.63476
17/03/2020 10:48,2019,1,WESTERN EUROPE-EU,SPAIN,1,STANSTED,ALMERIA,39417,39417,0,38504,38504,0,2.37118
17/03/2020 10:48,2019,1,WESTERN EUROPE-EU,SPAIN,1,STANSTED,ASTURIAS,0,0,0,46688,46688,0,-100
17/03/2020 10:48,2019,1,WESTERN EUROPE-EU,SPAIN,1,STANSTED,BARCELONA,519495,519038,457,480917,479439,1478,8.02176
17/03/2020 10:48,2019,1,WESTERN EUROPE-EU,SPAIN,1,STANSTED,BILBAO,119782,119782,0,126710,125461,1249,-5.4676
17/03/2020 10:48,2019,1,WESTERN EUROPE-EU,SPAIN,1,STANSTED,CASTELLON COSTA AZAHAR,31944,31944,0,35082,35082,0,-8.94476
17/03/2020 10:48,2019,1,WESTERN EUROPE-EU,SPAIN,1,STANSTED,CASTELLON DE LA PLANA AIRPORT,15004,15004,0,14783,14783,0,1.49496
17/03/2020 10:48,2019,1,WESTERN EUROPE-EU,SPAIN,1,STANSTED,GIRONA,80751,80751,0,81411,81347,64,-0.8107
17/03/2020 10:48,2019,1,WESTERN EUROPE-EU,SPAIN,1,STANSTED,IBIZA,281760,266563,15197,282312,265770,16542,-0.19553
17/03/2020 10:48,2019,1,WESTERN EUROPE-EU,SPAIN,1,STANSTED,JEREZ,56249,56249,0,57649,57649,0,-2.42849
17/03/2020 10:48,2019,1,WESTERN EUROPE-EU,SPAIN,1,STANSTED,LEON,0,0,0,499,0,499,-100
17/03/2020 10:48,2019,1,WESTERN EUROPE-EU,SPAIN,1,STANSTED,LIEIDA,3546,3546,0,3115,0,3115,13.83628
17/03/2020 10:48,2019,1,WESTERN EUROPE-EU,SPAIN,1,STANSTED,MADRID,500640,496200,4440,470157,470157,0,6.48358
17/03/2020 10:48,2019,1,WESTERN EUROPE-EU,SPAIN,1,STANSTED,MAHON,88944,71627,17317,82877,64690,18187,7.32049
17/03/2020 10:48,2019,1,WESTERN EUROPE-EU,SPAIN,1,STANSTED,MALAGA,492948,492948,0,541450,541450,0,-8.9578
17/03/2020 10:48,2019,1,WESTERN EUROPE-EU,SPAIN,1,STANSTED,MURCIA INTERNATIONAL,129163,125766,3397,0,0,0,0
17/03/2020 10:48,2019,1,WESTERN EUROPE-EU,SPAIN,1,STANSTED,MURCIA SAN JAVIER,2778,2778,0,130582,130582,0,-97.8726
17/03/2020 10:48,2019,1,WESTERN EUROPE-EU,SPAIN,1,STANSTED,PALMA DE MALLORCA,478128,453661,24467,479582,460795,18787,-0.30318
17/03/2020 10:48,2019,1,WESTERN EUROPE-EU,SPAIN,1,STANSTED,REUS,80611,80611,0,83613,83448,165,-3.59035
17/03/2020 10:48,2019,1,WESTERN EUROPE-EU,SPAIN,1,STANSTED,SALAMANCA,0,0,0,315,0,315,-100
17/03/2020 10:48,2019,1,WESTERN EUROPE-EU,SPAIN,1,STANSTED,SANTANDER,86110,86110,0,81988,81988,0,5.02757
17/03/2020 10:48,2019,1,WESTERN EUROPE-EU,SPAIN,1,STANSTED,SANTIAGO DE COMPOSTELA (SPAIN),115128,115128,0,76599,76599,0,50.29961
17/03/2020 10:48,2019,1,WESTERN EUROPE-EU,SPAIN,1,STANSTED,SEVILLE,164094,163998,96,142478,142292,186,15.17147
17/03/2020 10:48,2019,1,WESTERN EUROPE-EU,SPAIN,1,STANSTED,VALENCIA,166276,166276,0,134314,134314,0,23.79648
17/03/2020 10:48,2019,1,WESTERN EUROPE-EU,SPAIN,1,STANSTED,VALLADOLID,0,0,0,1218,0,1218,-100
17/03/2020 10:48,2019,1,WESTERN EUROPE-EU,SPAIN,1,STANSTED,VIGO,3325,3325,0,0,0,0,0
17/03/2020 10:48,2019,1,WESTERN EUROPE-EU,SPAIN,1,STANSTED,ZARAGOZA,91724,91724,0,88202,88202,0,3.99311
17/03/2020 10:48,2019,1,WESTERN EUROPE-EU,SPAIN,2,ABERDEEN,ALICANTE,35968,35968,0,35536,35536,0,1.21567
17/03/2020 10:48,2019,1,WESTERN EUROPE-EU,SPAIN,2,ABERDEEN,BILBAO,116,0,116,0,0,0,0
17/03/2020 10:48,2019,1,WESTERN EUROPE-EU,SPAIN,2,ABERDEEN,IBIZA,6946,0,6946,8309,0,8309,-16.4039
17/03/2020 10:48,2019,1,WESTERN EUROPE-EU,SPAIN,2,ABERDEEN,MALAGA,20797,20797,0,29247,29247,0,-28.89185
17/03/2020 10:48,2019,1,WESTERN EUROPE-EU,SPAIN,2,ABERDEEN,PALMA DE MALLORCA,25557,0,25557,23886,0,23886,6.99573
17/03/2020 10:48,2019,1,WESTERN EUROPE-EU,SPAIN,2,ABERDEEN,REUS,9161,0,9161,9203,0,9203,-0.45637
17/03/2020 10:48,2019,1,WESTERN EUROPE-EU,SPAIN,2,BELFAST CITY (GEORGE BEST),MALAGA,36482,36482,0,41041,40979,62,-11.1084
17/03/2020 10:48,2019,1,WESTERN EUROPE-EU,SPAIN,2,BELFAST INTERNATIONAL,ALICANTE,245898,245862,36,243475,243475,0,0.99517
17/03/2020 10:48,2019,1,WESTERN EUROPE-EU,SPAIN,2,BELFAST INTERNATIONAL,ALMERIA,5061,5061,0,9963,9963,0,-49.20205
17/03/2020 10:48,2019,1,WESTERN EUROPE-EU,SPAIN,2,BELFAST INTERNATIONAL,BARCELONA,47708,47708,0,48012,48012,0,-0.63318
17/03/2020 10:48,2019,1,WESTERN EUROPE-EU,SPAIN,2,BELFAST INTERNATIONAL,GIRONA,31363,31363,0,29909,29909,0,4.86141
17/03/2020 10:48,2019,1,WESTERN EUROPE-EU,SPAIN,2,BELFAST INTERNATIONAL,IBIZA,42207,35304,6903,42141,35250,6891,0.15662
17/03/2020 10:48,2019,1,WESTERN EUROPE-EU,SPAIN,2,BELFAST INTERNATIONAL,MADRID,34,0,34,0,0,0,0
17/03/2020 10:48,2019,1,WESTERN EUROPE-EU,SPAIN,2,BELFAST INTERNATIONAL,MAHON,17488,11320,6168,17142,10833,6309,2.01843
17/03/2020 10:48,2019,1,WESTERN EUROPE-EU,SPAIN,2,BELFAST INTERNATIONAL,MALAGA,216060,208015,8045,219439,212200,7239,-1.53984
17/03/2020 10:48,2019,1,WESTERN EUROPE-EU,SPAIN,2,BELFAST INTERNATIONAL,PALMA DE MALLORCA,183936,158011,25925,195911,153916,41995,-6.11247
17/03/2020 10:48,2019,1,WESTERN EUROPE-EU,SPAIN,2,BELFAST INTERNATIONAL,REUS,62649,33912,28737,62647,22996,39651,0.00319
17/03/2020 10:48,2019,1,WESTERN EUROPE-EU,SPAIN,2,BELFAST INTERNATIONAL,SANTIAGO DE COMPOSTELA (SPAIN),275,275,0,0,0,0,0
17/03/2020 10:48,2019,1,WESTERN EUROPE-EU,SPAIN,2,BELFAST INTERNATIONAL,SEVILLE,0,0,0,73,0,73,-100
17/03/2020 10:48,2019,1,WESTERN EUROPE-EU,SPAIN,2,BELFAST INTERNATIONAL,VALENCIA,19567,19567,0,12077,12077,0,62.01871
17/03/2020 10:48,2019,1,WESTERN EUROPE-EU,SPAIN,2,BIGGIN HILL,BARCELONA,11,0,11,47,0,47,-76.59574
17/03/2020 10:48,2019,1,WESTERN EUROPE-EU,SPAIN,2,BIGGIN HILL,GIRONA,0,0,0,2,0,2,-100
17/03/2020 10:48,2019,1,WESTERN EUROPE-EU,SPAIN,2,BIGGIN HILL,IBIZA,40,0,40,60,0,60,-33.33333
17/03/2020 10:48,2019,1,WESTERN EUROPE-EU,SPAIN,2,BIGGIN HILL,MADRID,4,0,4,13,0,13,-69.23077
17/03/2020 10:48,2019,1,WESTERN EUROPE-EU,SPAIN,2,BIGGIN HILL,MAHON,30,0,30,29,0,29,3.44828
17/03/2020 10:48,2019,1,WESTERN EUROPE-EU,SPAIN,2,BIGGIN HILL,MALAGA,59,0,59,15,0,15,293.33333
17/03/2020 10:48,2019,1,WESTERN EUROPE-EU,SPAIN,2,BIGGIN HILL,MURCIA INTERNATIONAL,17,0,17,0,0,0,0
17/03/2020 10:48,2019,1,WESTERN EUROPE-EU,SPAIN,2,BIGGIN HILL,MURCIA SAN JAVIER,0,0,0,9,0,9,-100
17/03/2020 10:48,2019,1,WESTERN EUROPE-EU,SPAIN,2,BIGGIN HILL,PALMA DE MALLORCA,5,0,5,10,0,10,-50
17/03/2020 10:48,2019,1,WESTERN EUROPE-EU,SPAIN,2,BIRMINGHAM,ALICANTE,406783,371857,34926,357780,323082,34698,13.69641
17/03/2020 10:48,2019,1,WESTERN EUROPE-EU,SPAIN,2,BIRMINGHAM,ALMERIA,32644,32309,335,34832,34832,0,-6.28158
17/03/2020 10:48,2019,1,WESTERN EUROPE-EU,SPAIN,2,BIRMINGHAM,BARCELONA,239662,239316,346,218425,218425,0,9.72279
17/03/2020 10:48,2019,1,WESTERN EUROPE-EU,SPAIN,2,BIRMINGHAM,GIRONA,65963,53619,12344,75176,61787,13389,-12.25524
17/03/2020 10:48,2019,1,WESTERN EUROPE-EU,SPAIN,2,BIRMINGHAM,IBIZA,137451,94662,42789,141764,91706,50058,-3.04238
17/03/2020 10:48,2019,1,WESTERN EUROPE-EU,SPAIN,2,BIRMINGHAM,LIEIDA,1956,0,1956,174,0,174,1024.13793
17/03/2020 10:48,2019,1,WESTERN EUROPE-EU,SPAIN,2,BIRMINGHAM,MADRID,121902,121902,0,124071,124071,0,-1.74819
17/03/2020 10:48,2019,1,WESTERN EUROPE-EU,SPAIN,2,BIRMINGHAM,MAHON,87147,53252,33895,88627,49777,38850,-1.66992
17/03/2020 10:48,2019,1,WESTERN EUROPE-EU,SPAIN,2,BIRMINGHAM,MALAGA,369610,330893,38717,367867,309624,58243,0.47381
17/03/2020 10:48,2019,1,WESTERN EUROPE-EU,SPAIN,2,BIRMINGHAM,MURCIA INTERNATIONAL,56509,56509,0,0,0,0,0
17/03/2020 10:48,2019,1,WESTERN EUROPE-EU,SPAIN,2,BIRMINGHAM,MURCIA SAN JAVIER,1556,1556,0,58642,58642,0,-97.34661
17/03/2020 10:48,2019,1,WESTERN EUROPE-EU,SPAIN,2,BIRMINGHAM,PALMA DE MALLORCA,414665,308652,106013,383348,292266,91082,8.16934
17/03/2020 10:48,2019,1,WESTERN EUROPE-EU,SPAIN,2,BIRMINGHAM,REUS,64871,46627,18244,62119,43908,18211,4.43021
17/03/2020 10:48,2019,1,WESTERN EUROPE-EU,SPAIN,2,BIRMINGHAM,SANTANDER,0,0,0,185,185,0,-100
17/03/2020 10:48,2019,1,WESTERN EUROPE-EU,SPAIN,2,BIRMINGHAM,SEVILLE,309,309,0,268,268,0,15.29851
17/03/2020 10:48,2019,1,WESTERN EUROPE-EU,SPAIN,2,BIRMINGHAM,VALENCIA,648,0,648,45,0,45,1340
17/03/2020 10:48,2019,1,WESTERN EUROPE-EU,SPAIN,2,BOURNEMOUTH,ALICANTE,69921,69921,0,61093,61093,0,14.4501
17/03/2020 10:48,2019,1,WESTERN EUROPE-EU,SPAIN,2,BOURNEMOUTH,BARCELONA,153,0,153,0,0,0,0
17/03/2020 10:48,2019,1,WESTERN EUROPE-EU,SPAIN,2,BOURNEMOUTH,GIRONA,41992,41992,0,41641,41641,0,0.84292
17/03/2020 10:48,2019,1,WESTERN EUROPE-EU,SPAIN,2,BOURNEMOUTH,IBIZA,9260,3,9257,9116,189,8927,1.57964
17/03/2020 10:48,2019,1,WESTERN EUROPE-EU,SPAIN,2,BOURNEMOUTH,MAHON,8937,372,8565,9177,0,9177,-2.61523
17/03/2020 10:48,2019,1,WESTERN EUROPE-EU,SPAIN,2,BOURNEMOUTH,MALAGA,77585,77585,0,78862,78862,0,-1.61928
17/03/2020 10:48,2019,1,WESTERN EUROPE-EU,SPAIN,2,BOURNEMOUTH,MURCIA INTERNATIONAL,40496,40496,0,0,0,0,0
17/03/2020 10:48,2019,1,WESTERN EUROPE-EU,SPAIN,2,BOURNEMOUTH,MURCIA SAN JAVIER,0,0,0,41517,41517,0,-100
17/03/2020 10:48,2019,1,WESTERN EUROPE-EU,SPAIN,2,BOURNEMOUTH,PALMA DE MALLORCA,112459,74489,37970,103608,66432,37176,8.54278
17/03/2020 10:48,2019,1,WESTERN EUROPE-EU,SPAIN,2,BOURNEMOUTH,SANTIAGO DE COMPOSTELA (SPAIN),0,0,0,43,0,43,-100
17/03/2020 10:48,2019,1,WESTERN EUROPE-EU,SPAIN,2,BOURNEMOUTH,SEVILLE,0,0,0,156,0,156,-100
17/03/2020 10:48,2019,1,WESTERN EUROPE-EU,SPAIN,2,BRISTOL,ALICANTE,366145,353214,12931,342241,327269,14972,6.98455
17/03/2020 10:48,2019,1,WESTERN EUROPE-EU,SPAIN,2,BRISTOL,ALMERIA,7560,7412,148,8162,8162,0,-7.37564
17/03/2020 10:48,2019,1,WESTERN EUROPE-EU,SPAIN,2,BRISTOL,BARCELONA,204019,204019,0,201233,201233,0,1.38446
17/03/2020 10:48,2019,1,WESTERN EUROPE-EU,SPAIN,2,BRISTOL,BILBAO,36157,36157,0,35828,35828,0,0.91828
17/03/2020 10:48,2019,1,WESTERN EUROPE-EU,SPAIN,2,BRISTOL,GIRONA,71456,64520,6936,65666,59221,6445,8.81735
17/03/2020 10:48,2019,1,WESTERN EUROPE-EU,SPAIN,2,BRISTOL,IBIZA,93063,64040,29023,96917,66423,30494,-3.9766
17/03/2020 10:48,2019,1,WESTERN EUROPE-EU,SPAIN,2,BRISTOL,LIEIDA,1622,0,1622,88,0,88,1743.18182
17/03/2020 10:48,2019,1,WESTERN EUROPE-EU,SPAIN,2,BRISTOL,MADRID,108514,108514,0,105874,105874,0,2.49353
17/03/2020 10:48,2019,1,WESTERN EUROPE-EU,SPAIN,2,BRISTOL,MAHON,65562,50016,15546,66704,48359,18345,-1.71204
17/03/2020 10:48,2019,1,WESTERN EUROPE-EU,SPAIN,2,BRISTOL,MALAGA,346205,322022,24183,356989,328469,28520,-3.02082
17/03/2020 10:48,2019,1,WESTERN EUROPE-EU,SPAIN,2,BRISTOL,MURCIA INTERNATIONAL,85448,85448,0,0,0,0,0
17/03/2020 10:48,2019,1,WESTERN EUROPE-EU,SPAIN,2,BRISTOL,MURCIA SAN JAVIER,1584,1584,0,88795,88795,0,-98.21612
17/03/2020 10:48,2019,1,WESTERN EUROPE-EU,SPAIN,2,BRISTOL,PALMA DE MALLORCA,363704,323585,40119,356625,308536,48089,1.985
17/03/2020 10:48,2019,1,WESTERN EUROPE-EU,SPAIN,2,BRISTOL,REUS,9714,0,9714,12086,2770,9316,-19.62601
17/03/2020 10:48,2019,1,WESTERN EUROPE-EU,SPAIN,2,BRISTOL,SANTIAGO DE COMPOSTELA (SPAIN),151,151,0,0,0,0,0
17/03/2020 10:48,2019,1,WESTERN EUROPE-EU,SPAIN,2,BRISTOL,SEVILLE,79409,79409,0,27095,27095,0,193.07621
17/03/2020 10:48,2019,1,WESTERN EUROPE-EU,SPAIN,2,BRISTOL,VALENCIA,34626,34626,0,26989,26989,0,28.29671
17/03/2020 10:48,2019,1,WESTERN EUROPE-EU,SPAIN,2,CARDIFF WALES,ALICANTE,116001,77648,38353,104211,66323,37888,11.31358
17/03/2020 10:48,2019,1,WESTERN EUROPE-EU,SPAIN,2,CARDIFF WALES,BARCELONA,20239,20028,211,24385,24361,24,-17.00226
17/03/2020 10:48,2019,1,WESTERN EUROPE-EU,SPAIN,2,CARDIFF WALES,BILBAO,0,0,0,347,0,347,-100
17/03/2020 10:48,2019,1,WESTERN EUROPE-EU,SPAIN,2,CARDIFF WALES,IBIZA,23029,0,23029,32568,0,32568,-29.28949
17/03/2020 10:48,2019,1,WESTERN EUROPE-EU,SPAIN,2,CARDIFF WALES,MADRID,0,0,0,7654,7429,225,-100
17/03/2020 10:48,2019,1,WESTERN EUROPE-EU,SPAIN,2,CARDIFF WALES,MAHON,25010,0,25010,15957,0,15957,56.73372
17/03/2020 10:48,2019,1,WESTERN EUROPE-EU,SPAIN,2,CARDIFF WALES,MALAGA,103341,74801,28540,88740,60774,27966,16.45368
17/03/2020 10:48,2019,1,WESTERN EUROPE-EU,SPAIN,2,CARDIFF WALES,PALMA DE MALLORCA,107360,35905,71455,108313,33121,75192,-0.87986
17/03/2020 10:48,2019,1,WESTERN EUROPE-EU,SPAIN,2,CARDIFF WALES,REUS,16593,0,16593,15509,0,15509,6.98949
17/03/2020 10:48,2019,1,WESTERN EUROPE-EU,SPAIN,2,CARDIFF WALES,SANTIAGO DE COMPOSTELA (SPAIN),272,0,272,0,0,0,0
17/03/2020 10:48,2019,1,WESTERN EUROPE-EU,SPAIN,2,CARDIFF WALES,SEVILLE,0,0,0,139,0,139,-100
17/03/2020 10:48,2019,1,WESTERN EUROPE-EU,SPAIN,2,CARDIFF WALES,VALENCIA,0,0,0,108,108,0,-100
17/03/2020 10:48,2019,1,WESTERN EUROPE-EU,SPAIN,2,CARDIFF WALES,VITORIA,0,0,0,265,0,265,-100
17/03/2020 10:48,2019,1,WESTERN EUROPE-EU,SPAIN,2,CITY OF DERRY (EGLINTON),PALMA DE MALLORCA,0,0,0,2436,0,2436,-100
17/03/2020 10:48,2019,1,WESTERN EUROPE-EU,SPAIN,2,CITY OF DERRY (EGLINTON),SEVILLE,0,0,0,108,0,108,-100
17/03/2020 10:48,2019,1,WESTERN EUROPE-EU,SPAIN,2,DONCASTER SHEFFIELD,ALICANTE,68583,18567,50016,62529,22331,40198,9.68191
17/03/2020 10:48,2019,1,WESTERN EUROPE-EU,SPAIN,2,DONCASTER SHEFFIELD,BARCELONA,85,0,85,0,0,0,0
17/03/2020 10:48,2019,1,WESTERN EUROPE-EU,SPAIN,2,DONCASTER SHEFFIELD,GIRONA,0,0,0,49,0,49,-100
17/03/2020 10:48,2019,1,WESTERN EUROPE-EU,SPAIN,2,DONCASTER SHEFFIELD,IBIZA,9548,0,9548,14326,0,14326,-33.35195
17/03/2020 10:48,2019,1,WESTERN EUROPE-EU,SPAIN,2,DONCASTER SHEFFIELD,MAHON,18920,0,18920,16830,0,16830,12.4183
17/03/2020 10:48,2019,1,WESTERN EUROPE-EU,SPAIN,2,DONCASTER SHEFFIELD,MALAGA,42299,8931,33368,48350,13845,34505,-12.51499
17/03/2020 10:48,2019,1,WESTERN EUROPE-EU,SPAIN,2,DONCASTER SHEFFIELD,PALMA DE MALLORCA,55197,2402,52795,52863,5547,47316,4.41519
17/03/2020 10:48,2019,1,WESTERN EUROPE-EU,SPAIN,2,DONCASTER SHEFFIELD,REUS,9417,0,9417,9233,0,9233,1.99285
17/03/2020 10:48,2019,1,WESTERN EUROPE-EU,SPAIN,2,DONCASTER SHEFFIELD,SEVILLE,0,0,0,139,139,0,-100
17/03/2020 10:48,2019,1,WESTERN EUROPE-EU,SPAIN,2,EAST MIDLANDS INTERNATIONAL,ALICANTE,401402,369378,32024,401789,370580,31209,-0.09632
17/03/2020 10:48,2019,1,WESTERN EUROPE-EU,SPAIN,2,EAST MIDLANDS INTERNATIONAL,ALMERIA,13624,13624,0,13122,13122,0,3.82564
17/03/2020 10:48,2019,1,WESTERN EUROPE-EU,SPAIN,2,EAST MIDLANDS INTERNATIONAL,BARCELONA,70644,70644,0,74471,74471,0,-5.13891
17/03/2020 10:48,2019,1,WESTERN EUROPE-EU,SPAIN,2,EAST MIDLANDS INTERNATIONAL,GIRONA,32633,32633,0,33710,33382,328,-3.1949
17/03/2020 10:48,2019,1,WESTERN EUROPE-EU,SPAIN,2,EAST MIDLANDS INTERNATIONAL,IBIZA,98933,80657,18276,101587,83136,18451,-2.61254
17/03/2020 10:48,2019,1,WESTERN EUROPE-EU,SPAIN,2,EAST MIDLANDS INTERNATIONAL,LIEIDA,0,0,0,1714,133,1581,-100
17/03/2020 10:48,2019,1,WESTERN EUROPE-EU,SPAIN,2,EAST MIDLANDS INTERNATIONAL,MADRID,146,0,146,327,327,0,-55.35168
17/03/2020 10:48,2019,1,WESTERN EUROPE-EU,SPAIN,2,EAST MIDLANDS INTERNATIONAL,MAHON,79538,62969,16569,83643,66330,17313,-4.90776
17/03/2020 10:48,2019,1,WESTERN EUROPE-EU,SPAIN,2,EAST MIDLANDS INTERNATIONAL,MALAGA,299731,270004,29727,297758,267948,29810,0.66262
17/03/2020 10:48,2019,1,WESTERN EUROPE-EU,SPAIN,2,EAST MIDLANDS INTERNATIONAL,MURCIA INTERNATIONAL,73885,73885,0,0,0,0,0
17/03/2020 10:48,2019,1,WESTERN EUROPE-EU,SPAIN,2,EAST MIDLANDS INTERNATIONAL,MURCIA SAN JAVIER,2083,2083,0,98824,98824,0,-97.89221
17/03/2020 10:48,2019,1,WESTERN EUROPE-EU,SPAIN,2,EAST MIDLANDS INTERNATIONAL,PALMA DE MALLORCA,318585,281315,37270,326367,292453,33914,-2.38443
17/03/2020 10:48,2019,1,WESTERN EUROPE-EU,SPAIN,2,EAST MIDLANDS INTERNATIONAL,REUS,40166,40166,0,40513,40227,286,-0.85652
17/03/2020 10:48,2019,1,WESTERN EUROPE-EU,SPAIN,2,EAST MIDLANDS INTERNATIONAL,SEVILLE,29028,29028,0,32214,32214,0,-9.89011
17/03/2020 10:48,2019,1,WESTERN EUROPE-EU,SPAIN,2,EAST MIDLANDS INTERNATIONAL,VALENCIA,40811,40811,0,43132,43132,0,-5.38116
17/03/2020 10:48,2019,1,WESTERN EUROPE-EU,SPAIN,2,EDINBURGH,ALICANTE,224091,224091,0,209016,209016,0,7.21237
17/03/2020 10:48,2019,1,WESTERN EUROPE-EU,SPAIN,2,EDINBURGH,ALMERIA,8605,8605,0,13496,13496,0,-36.24037
17/03/2020 10:48,2019,1,WESTERN EUROPE-EU,SPAIN,2,EDINBURGH,ASTURIAS,0,0,0,323,0,323,-100
17/03/2020 10:48,2019,1,WESTERN EUROPE-EU,SPAIN,2,EDINBURGH,BARCELONA,171536,171536,0,186766,186766,0,-8.15459
17/03/2020 10:48,2019,1,WESTERN EUROPE-EU,SPAIN,2,EDINBURGH,BILBAO,21814,21442,372,31105,31105,0,-29.8698
17/03/2020 10:48,2019,1,WESTERN EUROPE-EU,SPAIN,2,EDINBURGH,GIRONA,31213,31213,0,34106,34106,0,-8.48238
17/03/2020 10:48,2019,1,WESTERN EUROPE-EU,SPAIN,2,EDINBURGH,IBIZA,47965,47965,0,44917,44917,0,6.78585
17/03/2020 10:48,2019,1,WESTERN EUROPE-EU,SPAIN,2,EDINBURGH,MADRID,176142,175167,975,169522,169192,330,3.9051
17/03/2020 10:48,2019,1,WESTERN EUROPE-EU,SPAIN,2,EDINBURGH,MAHON,15820,12466,3354,16328,12985,3343,-3.11122
17/03/2020 10:48,2019,1,WESTERN EUROPE-EU,SPAIN,2,EDINBURGH,MALAGA,184774,181052,3722,172196,168520,3676,7.30447
17/03/2020 10:48,2019,1,WESTERN EUROPE-EU,SPAIN,2,EDINBURGH,MURCIA SAN JAVIER,0,0,0,17030,17030,0,-100
17/03/2020 10:48,2019,1,WESTERN EUROPE-EU,SPAIN,2,EDINBURGH,PALMA DE MALLORCA,214479,180759,33720,200566,162188,38378,6.93687
17/03/2020 10:48,2019,1,WESTERN EUROPE-EU,SPAIN,2,EDINBURGH,PAMPLONA,124,0,124,0,0,0,0
17/03/2020 10:48,2019,1,WESTERN EUROPE-EU,SPAIN,2,EDINBURGH,REUS,21293,21293,0,16917,16917,0,25.86747
17/03/2020 10:48,2019,1,WESTERN EUROPE-EU,SPAIN,2,EDINBURGH,SANTANDER,34471,34471,0,33846,33846,0,1.8466
17/03/2020 10:48,2019,1,WESTERN EUROPE-EU,SPAIN,2,EDINBURGH,SEVILLE,71397,71397,0,32782,32782,0,117.7933
17/03/2020 10:48,2019,1,WESTERN EUROPE-EU,SPAIN,2,EDINBURGH,VALENCIA,45473,44600,873,50730,50643,87,-10.3627
17/03/2020 10:48,2019,1,WESTERN EUROPE-EU,SPAIN,2,EDINBURGH,VIGO,0,0,0,20766,20766,0,-100
17/03/2020 10:48,2019,1,WESTERN EUROPE-EU,SPAIN,2,EDINBURGH,ZARAGOZA,704,0,704,378,0,378,86.24339
17/03/2020 10:48,2019,1,WESTERN EUROPE-EU,SPAIN,2,EXETER,ALICANTE,37151,36991,160,37380,37380,0,-0.61263
17/03/2020 10:48,2019,1,WESTERN EUROPE-EU,SPAIN,2,EXETER,IBIZA,8866,0,8866,8571,0,8571,3.44184
17/03/2020 10:48,2019,1,WESTERN EUROPE-EU,SPAIN,2,EXETER,MAHON,15696,0,15696,15684,0,15684,0.07651
17/03/2020 10:48,2019,1,WESTERN EUROPE-EU,SPAIN,2,EXETER,MALAGA,55815,55815,0,35957,35957,0,55.22708
17/03/2020 10:48,2019,1,WESTERN EUROPE-EU,SPAIN,2,EXETER,PALMA DE MALLORCA,49158,16012,33146,51719,15552,36167,-4.95176
17/03/2020 10:48,2019,1,WESTERN EUROPE-EU,SPAIN,2,GLASGOW,ALICANTE,289547,261696,27851,296363,278235,18128,-2.29988
17/03/2020 10:48,2019,1,WESTERN EUROPE-EU,SPAIN,2,GLASGOW,BARCELONA,40076,36067,4009,44853,41201,3652,-10.65035
17/03/2020 10:48,2019,1,WESTERN EUROPE-EU,SPAIN,2,GLASGOW,CASTELLON COSTA AZAHAR,0,0,0,902,0,902,-100
17/03/2020 10:48,2019,1,WESTERN EUROPE-EU,SPAIN,2,GLASGOW,GIRONA,14016,14016,0,16731,16731,0,-16.22736
17/03/2020 10:48,2019,1,WESTERN EUROPE-EU,SPAIN,2,GLASGOW,IBIZA,76040,57556,18484,79526,60250,19276,-4.38347
17/03/2020 10:48,2019,1,WESTERN EUROPE-EU,SPAIN,2,GLASGOW,MADRID,0,0,0,55363,55187,176,-100
17/03/2020 10:48,2019,1,WESTERN EUROPE-EU,SPAIN,2,GLASGOW,MAHON,31730,28376,3354,34570,31212,3358,-8.21522
17/03/2020 10:48,2019,1,WESTERN EUROPE-EU,SPAIN,2,GLASGOW,MALAGA,223553,207927,15626,231524,214583,16941,-3.44284
17/03/2020 10:48,2019,1,WESTERN EUROPE-EU,SPAIN,2,GLASGOW,PALMA DE MALLORCA,199577,159771,39806,206673,164188,42485,-3.43344
17/03/2020 10:48,2019,1,WESTERN EUROPE-EU,SPAIN,2,GLASGOW,REUS,65899,44385,21514,62409,50116,12293,5.59214
17/03/2020 10:48,2019,1,WESTERN EUROPE-EU,SPAIN,2,GLASGOW,VALENCIA,1124,374,750,28059,28059,0,-95.99416
17/03/2020 10:48,2019,1,WESTERN EUROPE-EU,SPAIN,2,GUERNSEY,CASTELLON COSTA AZAHAR,48,0,48,0,0,0,0
17/03/2020 10:48,2019,1,WESTERN EUROPE-EU,SPAIN,2,GUERNSEY,IBIZA,33,0,33,0,0,0,0
17/03/2020 10:48,2019,1,WESTERN EUROPE-EU,SPAIN,2,GUERNSEY,MALAGA,0,0,0,102,102,0,-100
17/03/2020 10:48,2019,1,WESTERN EUROPE-EU,SPAIN,2,HUMBERSIDE,PALMA DE MALLORCA,8988,0,8988,9292,0,9292,-3.27163
17/03/2020 10:48,2019,1,WESTERN EUROPE-EU,SPAIN,2,HUMBERSIDE,SEVILLE,0,0,0,133,0,133,-100
17/03/2020 10:48,2019,1,WESTERN EUROPE-EU,SPAIN,2,INVERNESS,PALMA DE MALLORCA,2778,0,2778,2042,0,2042,36.0431
17/03/2020 10:48,2019,1,WESTERN EUROPE-EU,SPAIN,2,ISLE OF MAN,MAHON,843,0,843,836,0,836,0.83732
17/03/2020 10:48,2019,1,WESTERN EUROPE-EU,SPAIN,2,ISLE OF MAN,PALMA DE MALLORCA,1384,0,1384,2108,75,2033,-34.34535
17/03/2020 10:48,2019,1,WESTERN EUROPE-EU,SPAIN,2,JERSEY,BARCELONA,0,0,0,267,0,267,-100
17/03/2020 10:48,2019,1,WESTERN EUROPE-EU,SPAIN,2,JERSEY,IBIZA,58,58,0,0,0,0,0
17/03/2020 10:48,2019,1,WESTERN EUROPE-EU,SPAIN,2,JERSEY,MADRID,0,0,0,174,0,174,-100
17/03/2020 10:48,2019,1,WESTERN EUROPE-EU,SPAIN,2,JERSEY,MALAGA,1319,0,1319,1191,0,1191,10.74727
17/03/2020 10:48,2019,1,WESTERN EUROPE-EU,SPAIN,2,JERSEY,PALMA DE MALLORCA,3727,0,3727,4101,0,4101,-9.11973
17/03/2020 10:48,2019,1,WESTERN EUROPE-EU,SPAIN,2,JERSEY,SEVILLE,30,0,30,0,0,0,0
17/03/2020 10:48,2019,1,WESTERN EUROPE-EU,SPAIN,2,LEEDS BRADFORD,ALICANTE,326891,326891,0,317280,317280,0,3.02919
17/03/2020 10:48,2019,1,WESTERN EUROPE-EU,SPAIN,2,LEEDS BRADFORD,ALMERIA,13608,13608,0,13348,13348,0,1.94786
17/03/2020 10:48,2019,1,WESTERN EUROPE-EU,SPAIN,2,LEEDS BRADFORD,BARCELONA,51048,51048,0,54732,54732,0,-6.73098
17/03/2020 10:48,2019,1,WESTERN EUROPE-EU,SPAIN,2,LEEDS BRADFORD,GIRONA,39503,39503,0,39327,39327,0,0.44753
17/03/2020 10:48,2019,1,WESTERN EUROPE-EU,SPAIN,2,LEEDS BRADFORD,IBIZA,93160,93160,0,94053,85618,8435,-0.94946
17/03/2020 10:48,2019,1,WESTERN EUROPE-EU,SPAIN,2,LEEDS BRADFORD,MAHON,39361,39361,0,42019,33438,8581,-6.32571
17/03/2020 10:48,2019,1,WESTERN EUROPE-EU,SPAIN,2,LEEDS BRADFORD,MALAGA,277622,277622,0,282430,273156,9274,-1.70237
17/03/2020 10:48,2019,1,WESTERN EUROPE-EU,SPAIN,2,LEEDS BRADFORD,MURCIA INTERNATIONAL,50900,50900,0,0,0,0,0
17/03/2020 10:48,2019,1,WESTERN EUROPE-EU,SPAIN,2,LEEDS BRADFORD,MURCIA SAN JAVIER,1362,1362,0,66225,66225,0,-97.94337
17/03/2020 10:48,2019,1,WESTERN EUROPE-EU,SPAIN,2,LEEDS BRADFORD,PALMA DE MALLORCA,238748,220660,18088,253567,206257,47310,-5.84421
17/03/2020 10:48,2019,1,WESTERN EUROPE-EU,SPAIN,2,LEEDS BRADFORD,REUS,22821,22821,0,22603,22603,0,0.96447
17/03/2020 10:48,2019,1,WESTERN EUROPE-EU,SPAIN,2,LIVERPOOL (JOHN LENNON),ALICANTE,266698,266698,0,287207,287207,0,-7.14084
17/03/2020 10:48,2019,1,WESTERN EUROPE-EU,SPAIN,2,LIVERPOOL (JOHN LENNON),BARCELONA,231726,228417,3309,240513,240513,0,-3.65344
17/03/2020 10:48,2019,1,WESTERN EUROPE-EU,SPAIN,2,LIVERPOOL (JOHN LENNON),GIRONA,20492,20492,0,20679,20679,0,-0.9043
17/03/2020 10:48,2019,1,WESTERN EUROPE-EU,SPAIN,2,LIVERPOOL (JOHN LENNON),IBIZA,28693,28693,0,36756,29469,7287,-21.93655
17/03/2020 10:48,2019,1,WESTERN EUROPE-EU,SPAIN,2,LIVERPOOL (JOHN LENNON),MADRID,82890,71373,11517,67557,67557,0,22.69639
17/03/2020 10:48,2019,1,WESTERN EUROPE-EU,SPAIN,2,LIVERPOOL (JOHN LENNON),MALAGA,267732,267445,287,268490,268329,161,-0.28232
17/03/2020 10:48,2019,1,WESTERN EUROPE-EU,SPAIN,2,LIVERPOOL (JOHN LENNON),MURCIA INTERNATIONAL,139,139,0,0,0,0,0
17/03/2020 10:48,2019,1,WESTERN EUROPE-EU,SPAIN,2,LIVERPOOL (JOHN LENNON),PALMA DE MALLORCA,208094,208094,0,225682,216725,8957,-7.79327
17/03/2020 10:48,2019,1,WESTERN EUROPE-EU,SPAIN,2,LIVERPOOL (JOHN LENNON),REUS,20168,20168,0,20543,20543,0,-1.82544
17/03/2020 10:48,2019,1,WESTERN EUROPE-EU,SPAIN,2,LIVERPOOL (JOHN LENNON),VALENCIA,0,0,0,48,0,48,-100
17/03/2020 10:48,2019,1,WESTERN EUROPE-EU,SPAIN,2,MANCHESTER,A CORUNA,2,2,0,0,0,0,0
17/03/2020 10:48,2019,1,WESTERN EUROPE-EU,SPAIN,2,MANCHESTER,ALICANTE,738976,681429,57547,748982,665785,83197,-1.33595
17/03/2020 10:48,2019,1,WESTERN EUROPE-EU,SPAIN,2,MANCHESTER,ALMERIA,72012,63811,8201,79770,70956,8814,-9.72546
17/03/2020 10:48,2019,1,WESTERN EUROPE-EU,SPAIN,2,MANCHESTER,BARCELONA,502592,497192,5400,391506,391450,56,28.37402
17/03/2020 10:48,2019,1,WESTERN EUROPE-EU,SPAIN,2,MANCHESTER,BILBAO,79286,79286,0,74933,74933,0,5.80919
17/03/2020 10:48,2019,1,WESTERN EUROPE-EU,SPAIN,2,MANCHESTER,GIRONA,86554,70257,16297,86944,70629,16315,-0.44856
17/03/2020 10:48,2019,1,WESTERN EUROPE-EU,SPAIN,2,MANCHESTER,GRANADA,32915,32915,0,34116,34116,0,-3.52034
17/03/2020 10:48,2019,1,WESTERN EUROPE-EU,SPAIN,2,MANCHESTER,IBIZA,276233,210705,65528,297771,224103,73668,-7.23308
17/03/2020 10:48,2019,1,WESTERN EUROPE-EU,SPAIN,2,MANCHESTER,JEREZ,11555,11555,0,0,0,0,0
17/03/2020 10:48,2019,1,WESTERN EUROPE-EU,SPAIN,2,MANCHESTER,LIEIDA,6087,653,5434,6859,6008,851,-11.25529
17/03/2020 10:48,2019,1,WESTERN EUROPE-EU,SPAIN,2,MANCHESTER,MADRID,184845,184397,448,164358,164265,93,12.46486
17/03/2020 10:48,2019,1,WESTERN EUROPE-EU,SPAIN,2,MANCHESTER,MAHON,144001,78420,65581,152318,72410,79908,-5.46029
17/03/2020 10:48,2019,1,WESTERN EUROPE-EU,SPAIN,2,MANCHESTER,MALAGA,581821,526281,55540,567747,491139,76608,2.47892
17/03/2020 10:48,2019,1,WESTERN EUROPE-EU,SPAIN,2,MANCHESTER,MURCIA INTERNATIONAL,120342,120342,0,0,0,0,0
17/03/2020 10:48,2019,1,WESTERN EUROPE-EU,SPAIN,2,MANCHESTER,MURCIA SAN JAVIER,2336,2336,0,140937,140937,0,-98.34252
17/03/2020 10:48,2019,1,WESTERN EUROPE-EU,SPAIN,2,MANCHESTER,PALMA DE MALLORCA,770538,650272,120266,720393,600465,119928,6.96078
17/03/2020 10:48,2019,1,WESTERN EUROPE-EU,SPAIN,2,MANCHESTER,REUS,114110,79561,34549,110129,73678,36451,3.61485
17/03/2020 10:48,2019,1,WESTERN EUROPE-EU,SPAIN,2,MANCHESTER,SEVILLE,54404,54144,260,50582,49269,1313,7.55605
17/03/2020 10:48,2019,1,WESTERN EUROPE-EU,SPAIN,2,MANCHESTER,VALENCIA,48167,47977,190,49219,48084,1135,-2.13739
17/03/2020 10:48,2019,1,WESTERN EUROPE-EU,SPAIN,2,NEWCASTLE,ALICANTE,375876,375876,0,368256,367664,592,2.06921
17/03/2020 10:48,2019,1,WESTERN EUROPE-EU,SPAIN,2,NEWCASTLE,ALMERIA,15462,15462,0,12035,12035,0,28.47528
17/03/2020 10:48,2019,1,WESTERN EUROPE-EU,SPAIN,2,NEWCASTLE,BARCELONA,73992,73992,0,72099,72099,0,2.62556
17/03/2020 10:48,2019,1,WESTERN EUROPE-EU,SPAIN,2,NEWCASTLE,GIRONA,38839,38839,0,34540,34540,0,12.44644
17/03/2020 10:48,2019,1,WESTERN EUROPE-EU,SPAIN,2,NEWCASTLE,IBIZA,86872,86872,0,83820,83820,0,3.64114
17/03/2020 10:48,2019,1,WESTERN EUROPE-EU,SPAIN,2,NEWCASTLE,MADRID,0,0,0,29119,29119,0,-100
17/03/2020 10:48,2019,1,WESTERN EUROPE-EU,SPAIN,2,NEWCASTLE,MAHON,31527,31527,0,40707,40707,0,-22.5514
17/03/2020 10:48,2019,1,WESTERN EUROPE-EU,SPAIN,2,NEWCASTLE,MALAGA,263447,263447,0,269622,269261,361,-2.29024
17/03/2020 10:48,2019,1,WESTERN EUROPE-EU,SPAIN,2,NEWCASTLE,MURCIA SAN JAVIER,0,0,0,16885,16800,85,-100
17/03/2020 10:48,2019,1,WESTERN EUROPE-EU,SPAIN,2,NEWCASTLE,PALMA DE MALLORCA,320387,320387,0,304453,304453,0,5.23365
17/03/2020 10:48,2019,1,WESTERN EUROPE-EU,SPAIN,2,NEWCASTLE,REUS,47216,47216,0,56347,56347,0,-16.20494
17/03/2020 10:48,2019,1,WESTERN EUROPE-EU,SPAIN,2,NEWQUAY,ALICANTE,34724,34724,0,27163,27163,0,27.83566
17/03/2020 10:48,2019,1,WESTERN EUROPE-EU,SPAIN,2,NEWQUAY,SEVILLE,0,0,0,144,0,144,-100
17/03/2020 10:48,2019,1,WESTERN EUROPE-EU,SPAIN,2,NORWICH,ALICANTE,14814,14814,0,18230,18230,0,-18.73834
17/03/2020 10:48,2019,1,WESTERN EUROPE-EU,SPAIN,2,NORWICH,IBIZA,8473,0,8473,8408,0,8408,0.77307
17/03/2020 10:48,2019,1,WESTERN EUROPE-EU,SPAIN,2,NORWICH,MAHON,13461,0,13461,8720,0,8720,54.36927
17/03/2020 10:48,2019,1,WESTERN EUROPE-EU,SPAIN,2,NORWICH,MALAGA,14732,14732,0,17428,17428,0,-15.46936
17/03/2020 10:48,2019,1,WESTERN EUROPE-EU,SPAIN,2,NORWICH,PALMA DE MALLORCA,26236,0,26236,26942,0,26942,-2.62044
17/03/2020 10:48,2019,1,WESTERN EUROPE-EU,SPAIN,2,NORWICH,SEVILLE,0,0,0,234,0,234,-100
17/03/2020 10:48,2019,1,WESTERN EUROPE-EU,SPAIN,2,PRESTWICK,ALICANTE,75750,75604,146,74869,74600,269,1.17672
17/03/2020 10:48,2019,1,WESTERN EUROPE-EU,SPAIN,2,PRESTWICK,BARCELONA,61216,61216,0,80584,80584,0,-24.03455
17/03/2020 10:48,2019,1,WESTERN EUROPE-EU,SPAIN,2,PRESTWICK,GIRONA,18711,18711,0,19677,19677,0,-4.90928
17/03/2020 10:48,2019,1,WESTERN EUROPE-EU,SPAIN,2,PRESTWICK,IBIZA,15813,15813,0,19205,19205,0,-17.66207
17/03/2020 10:48,2019,1,WESTERN EUROPE-EU,SPAIN,2,PRESTWICK,MALAGA,79539,79367,172,77399,77399,0,2.76489
17/03/2020 10:48,2019,1,WESTERN EUROPE-EU,SPAIN,2,PRESTWICK,MURCIA INTERNATIONAL,20973,20973,0,0,0,0,0
17/03/2020 10:48,2019,1,WESTERN EUROPE-EU,SPAIN,2,PRESTWICK,MURCIA SAN JAVIER,0,0,0,21643,21643,0,-100
17/03/2020 10:48,2019,1,WESTERN EUROPE-EU,SPAIN,2,PRESTWICK,PALMA DE MALLORCA,69816,69816,0,61689,61689,0,13.17415
17/03/2020 10:48,2019,1,WESTERN EUROPE-EU,SPAIN,2,SOUTHAMPTON,ALICANTE,31998,31998,0,38637,38637,0,-17.18301
17/03/2020 10:48,2019,1,WESTERN EUROPE-EU,SPAIN,2,SOUTHAMPTON,IBIZA,4219,85,4134,4462,1349,3113,-5.44599
17/03/2020 10:48,2019,1,WESTERN EUROPE-EU,SPAIN,2,SOUTHAMPTON,MAHON,2332,0,2332,2253,74,2179,3.50644
17/03/2020 10:48,2019,1,WESTERN EUROPE-EU,SPAIN,2,SOUTHAMPTON,MALAGA,21823,21783,40,26478,26427,51,-17.58063
17/03/2020 10:48,2019,1,WESTERN EUROPE-EU,SPAIN,2,SOUTHAMPTON,PALMA DE MALLORCA,22166,12486,9680,22768,15866,6902,-2.64406
17/03/2020 10:48,2019,1,WESTERN EUROPE-EU,SPAIN,2,SOUTHAMPTON,VIGO,0,0,0,49,0,49,-100
17/03/2020 10:48,2019,1,WESTERN EUROPE-EU,SPAIN,2,TEESSIDE INTERNATIONAL AIRPORT,SEVILLE,0,0,0,256,0,256,-100
17/03/2020 10:48,2019,1,WESTERN EUROPE-EU,SPAIN(CANARY ISLANDS),1,GATWICK,ARRECIFE,354946,279998,74948,377218,301068,76150,-5.90428
17/03/2020 10:48,2019,1,WESTERN EUROPE-EU,SPAIN(CANARY ISLANDS),1,GATWICK,FUERTEVENTURA,201762,150087,51675,231702,177386,54316,-12.92177
17/03/2020 10:48,2019,1,WESTERN EUROPE-EU,SPAIN(CANARY ISLANDS),1,GATWICK,LAS PALMAS,259755,181387,78368,290729,204201,86528,-10.65391
17/03/2020 10:48,2019,1,WESTERN EUROPE-EU,SPAIN(CANARY ISLANDS),1,GATWICK,SANTA CRUZ DE LA PALMA,31845,13984,17861,40349,22633,17716,-21.07611
17/03/2020 10:48,2019,1,WESTERN EUROPE-EU,SPAIN(CANARY ISLANDS),1,GATWICK,TENERIFE (NORTE LOS RODEOS),142,142,0,0,0,0,0
17/03/2020 10:48,2019,1,WESTERN EUROPE-EU,SPAIN(CANARY ISLANDS),1,GATWICK,TENERIFE (SURREINA SOFIA),697879,562917,134962,710343,565026,145317,-1.75465
17/03/2020 10:48,2019,1,WESTERN EUROPE-EU,SPAIN(CANARY ISLANDS),1,HEATHROW,LAS PALMAS,15916,15916,0,16584,16584,0,-4.02798
17/03/2020 10:48,2019,1,WESTERN EUROPE-EU,SPAIN(CANARY ISLANDS),1,HEATHROW,TENERIFE (SURREINA SOFIA),14408,14408,0,14382,14382,0,0.18078
17/03/2020 10:48,2019,1,WESTERN EUROPE-EU,SPAIN(CANARY ISLANDS),1,LUTON,ARRECIFE,108892,75763,33129,107480,76943,30537,1.31373
17/03/2020 10:48,2019,1,WESTERN EUROPE-EU,SPAIN(CANARY ISLANDS),1,LUTON,FUERTEVENTURA,31033,29938,1095,49197,34087,15110,-36.92095
17/03/2020 10:48,2019,1,WESTERN EUROPE-EU,SPAIN(CANARY ISLANDS),1,LUTON,LAS PALMAS,38739,22542,16197,41482,22510,18972,-6.61251
17/03/2020 10:48,2019,1,WESTERN EUROPE-EU,SPAIN(CANARY ISLANDS),1,LUTON,TENERIFE (SURREINA SOFIA),127321,95075,32246,129868,90372,39496,-1.96122
17/03/2020 10:48,2019,1,WESTERN EUROPE-EU,SPAIN(CANARY ISLANDS),1,SOUTHEND,ARRECIFE,14653,14653,0,13430,13430,0,9.10648
17/03/2020 10:48,2019,1,WESTERN EUROPE-EU,SPAIN(CANARY ISLANDS),1,SOUTHEND,TENERIFE (SURREINA SOFIA),15042,15042,0,13589,13589,0,10.69247
17/03/2020 10:48,2019,1,WESTERN EUROPE-EU,SPAIN(CANARY ISLANDS),1,STANSTED,ARRECIFE,249481,241588,7893,239165,228685,10480,4.31334
17/03/2020 10:48,2019,1,WESTERN EUROPE-EU,SPAIN(CANARY ISLANDS),1,STANSTED,FUERTEVENTURA,146059,140482,5577,162361,143587,18774,-10.04059
17/03/2020 10:48,2019,1,WESTERN EUROPE-EU,SPAIN(CANARY ISLANDS),1,STANSTED,LAS PALMAS,202055,183776,18279,189866,170890,18976,6.41979
17/03/2020 10:48,2019,1,WESTERN EUROPE-EU,SPAIN(CANARY ISLANDS),1,STANSTED,TENERIFE (SURREINA SOFIA),404079,376286,27793,352782,323346,29436,14.54071
17/03/2020 10:48,2019,1,WESTERN EUROPE-EU,SPAIN(CANARY ISLANDS),2,ABERDEEN,LAS PALMAS,0,0,0,8960,0,8960,-100
17/03/2020 10:48,2019,1,WESTERN EUROPE-EU,SPAIN(CANARY ISLANDS),2,ABERDEEN,TENERIFE (SURREINA SOFIA),30155,0,30155,29807,0,29807,1.16751
17/03/2020 10:48,2019,1,WESTERN EUROPE-EU,SPAIN(CANARY ISLANDS),2,BELFAST INTERNATIONAL,ARRECIFE,111284,91127,20157,132403,90762,41641,-15.95054
17/03/2020 10:48,2019,1,WESTERN EUROPE-EU,SPAIN(CANARY ISLANDS),2,BELFAST INTERNATIONAL,FUERTEVENTURA,43075,43075,0,30013,30013,0,43.52114
17/03/2020 10:48,2019,1,WESTERN EUROPE-EU,SPAIN(CANARY ISLANDS),2,BELFAST INTERNATIONAL,LAS PALMAS,41271,29961,11310,40059,28303,11756,3.02554
17/03/2020 10:48,2019,1,WESTERN EUROPE-EU,SPAIN(CANARY ISLANDS),2,BELFAST INTERNATIONAL,TENERIFE (SURREINA SOFIA),122936,90501,32435,130667,72824,57843,-5.91657
17/03/2020 10:48,2019,1,WESTERN EUROPE-EU,SPAIN(CANARY ISLANDS),2,BIGGIN HILL,LAS PALMAS,0,0,0,9,0,9,-100
17/03/2020 10:48,2019,1,WESTERN EUROPE-EU,SPAIN(CANARY ISLANDS),2,BIGGIN HILL,TENERIFE (SURREINA SOFIA),2,0,2,0,0,0,0
17/03/2020 10:48,2019,1,WESTERN EUROPE-EU,SPAIN(CANARY ISLANDS),2,BIRMINGHAM,ARRECIFE,259299,202384,56915,249657,190351,59306,3.8621
17/03/2020 10:48,2019,1,WESTERN EUROPE-EU,SPAIN(CANARY ISLANDS),2,BIRMINGHAM,FUERTEVENTURA,161576,119496,42080,149776,112437,37339,7.87843
17/03/2020 10:48,2019,1,WESTERN EUROPE-EU,SPAIN(CANARY ISLANDS),2,BIRMINGHAM,LAS PALMAS,172478,117718,54760,176874,120271,56603,-2.48539
17/03/2020 10:48,2019,1,WESTERN EUROPE-EU,SPAIN(CANARY ISLANDS),2,BIRMINGHAM,TENERIFE (SURREINA SOFIA),377488,295827,81661,333931,253436,80495,13.04371
17/03/2020 10:48,2019,1,WESTERN EUROPE-EU,SPAIN(CANARY ISLANDS),2,BOURNEMOUTH,ARRECIFE,36842,187,36655,36679,0,36679,0.4444
17/03/2020 10:48,2019,1,WESTERN EUROPE-EU,SPAIN(CANARY ISLANDS),2,BOURNEMOUTH,LAS PALMAS,30853,12884,17969,29089,10865,18224,6.06415
17/03/2020 10:48,2019,1,WESTERN EUROPE-EU,SPAIN(CANARY ISLANDS),2,BOURNEMOUTH,TENERIFE (NORTE LOS RODEOS),297,0,297,0,0,0,0
17/03/2020 10:48,2019,1,WESTERN EUROPE-EU,SPAIN(CANARY ISLANDS),2,BOURNEMOUTH,TENERIFE (SURREINA SOFIA),48082,18145,29937,46812,18096,28716,2.71298
17/03/2020 10:48,2019,1,WESTERN EUROPE-EU,SPAIN(CANARY ISLANDS),2,BRISTOL,ARRECIFE,159881,101907,57974,169185,122093,47092,-5.49931
17/03/2020 10:48,2019,1,WESTERN EUROPE-EU,SPAIN(CANARY ISLANDS),2,BRISTOL,FUERTEVENTURA,68239,36154,32085,76933,48448,28485,-11.30074
17/03/2020 10:48,2019,1,WESTERN EUROPE-EU,SPAIN(CANARY ISLANDS),2,BRISTOL,LAS PALMAS,86650,54823,31827,95164,59051,36113,-8.94666
17/03/2020 10:48,2019,1,WESTERN EUROPE-EU,SPAIN(CANARY ISLANDS),2,BRISTOL,TENERIFE (SURREINA SOFIA),203820,144359,59461,204778,152948,51830,-0.46782
17/03/2020 10:48,2019,1,WESTERN EUROPE-EU,SPAIN(CANARY ISLANDS),2,CARDIFF WALES,ARRECIFE,39664,0,39664,46465,0,46465,-14.63682
17/03/2020 10:48,2019,1,WESTERN EUROPE-EU,SPAIN(CANARY ISLANDS),2,CARDIFF WALES,FUERTEVENTURA,2,0,2,130,130,0,-98.46154
17/03/2020 10:48,2019,1,WESTERN EUROPE-EU,SPAIN(CANARY ISLANDS),2,CARDIFF WALES,LAS PALMAS,18975,0,18975,18996,0,18996,-0.11055
17/03/2020 10:48,2019,1,WESTERN EUROPE-EU,SPAIN(CANARY ISLANDS),2,CARDIFF WALES,TENERIFE (SURREINA SOFIA),95628,25267,70361,88771,23608,65163,7.72437
17/03/2020 10:48,2019,1,WESTERN EUROPE-EU,SPAIN(CANARY ISLANDS),2,DONCASTER SHEFFIELD,ARRECIFE,39993,0,39993,39395,0,39395,1.51796
17/03/2020 10:48,2019,1,WESTERN EUROPE-EU,SPAIN(CANARY ISLANDS),2,DONCASTER SHEFFIELD,LAS PALMAS,19650,0,19650,20042,0,20042,-1.95589
17/03/2020 10:48,2019,1,WESTERN EUROPE-EU,SPAIN(CANARY ISLANDS),2,DONCASTER SHEFFIELD,TENERIFE (SURREINA SOFIA),51309,0,51309,51592,577,51015,-0.54853
17/03/2020 10:48,2019,1,WESTERN EUROPE-EU,SPAIN(CANARY ISLANDS),2,EAST MIDLANDS INTERNATIONAL,ARRECIFE,195187,176368,18819,197317,178805,18512,-1.07948
17/03/2020 10:48,2019,1,WESTERN EUROPE-EU,SPAIN(CANARY ISLANDS),2,EAST MIDLANDS INTERNATIONAL,FUERTEVENTURA,114145,95130,19015,117558,99429,18129,-2.90325
17/03/2020 10:48,2019,1,WESTERN EUROPE-EU,SPAIN(CANARY ISLANDS),2,EAST MIDLANDS INTERNATIONAL,LAS PALMAS,88825,83442,5383,98683,89404,9279,-9.98956
17/03/2020 10:48,2019,1,WESTERN EUROPE-EU,SPAIN(CANARY ISLANDS),2,EAST MIDLANDS INTERNATIONAL,TENERIFE (NORTE LOS RODEOS),0,0,0,171,171,0,-100
17/03/2020 10:48,2019,1,WESTERN EUROPE-EU,SPAIN(CANARY ISLANDS),2,EAST MIDLANDS INTERNATIONAL,TENERIFE (SURREINA SOFIA),325002,268103,56899,326095,272092,54003,-0.33518
17/03/2020 10:48,2019,1,WESTERN EUROPE-EU,SPAIN(CANARY ISLANDS),2,EDINBURGH,ARRECIFE,116917,97676,19241,97546,82204,15342,19.85832
17/03/2020 10:48,2019,1,WESTERN EUROPE-EU,SPAIN(CANARY ISLANDS),2,EDINBURGH,FUERTEVENTURA,69860,69860,0,69591,69591,0,0.38654
17/03/2020 10:48,2019,1,WESTERN EUROPE-EU,SPAIN(CANARY ISLANDS),2,EDINBURGH,LAS PALMAS,76089,70459,5630,82729,69749,12980,-8.02621
17/03/2020 10:48,2019,1,WESTERN EUROPE-EU,SPAIN(CANARY ISLANDS),2,EDINBURGH,TENERIFE (SURREINA SOFIA),244812,206739,38073,256238,218611,37627,-4.45914
17/03/2020 10:48,2019,1,WESTERN EUROPE-EU,SPAIN(CANARY ISLANDS),2,EXETER,ARRECIFE,38009,0,38009,36955,0,36955,2.85212
17/03/2020 10:48,2019,1,WESTERN EUROPE-EU,SPAIN(CANARY ISLANDS),2,EXETER,LAS PALMAS,9815,0,9815,18824,0,18824,-47.85912
17/03/2020 10:48,2019,1,WESTERN EUROPE-EU,SPAIN(CANARY ISLANDS),2,EXETER,TENERIFE (SURREINA SOFIA),39286,0,39286,38877,0,38877,1.05204
17/03/2020 10:48,2019,1,WESTERN EUROPE-EU,SPAIN(CANARY ISLANDS),2,GLASGOW,ARRECIFE,128356,110719,17637,158155,135986,22169,-18.84164
17/03/2020 10:48,2019,1,WESTERN EUROPE-EU,SPAIN(CANARY ISLANDS),2,GLASGOW,FUERTEVENTURA,63757,63757,0,71706,71706,0,-11.08554
17/03/2020 10:48,2019,1,WESTERN EUROPE-EU,SPAIN(CANARY ISLANDS),2,GLASGOW,LAS PALMAS,89083,73588,15495,96615,84608,12007,-7.79589
17/03/2020 10:48,2019,1,WESTERN EUROPE-EU,SPAIN(CANARY ISLANDS),2,GLASGOW,TENERIFE (SURREINA SOFIA),229483,190916,38567,226515,195499,31016,1.31029
17/03/2020 10:48,2019,1,WESTERN EUROPE-EU,SPAIN(CANARY ISLANDS),2,JERSEY,TENERIFE (SURREINA SOFIA),2294,0,2294,1681,612,1069,36.46639
17/03/2020 10:48,2019,1,WESTERN EUROPE-EU,SPAIN(CANARY ISLANDS),2,LEEDS BRADFORD,ARRECIFE,142744,142744,0,141012,141012,0,1.22826
17/03/2020 10:48,2019,1,WESTERN EUROPE-EU,SPAIN(CANARY ISLANDS),2,LEEDS BRADFORD,FUERTEVENTURA,75956,75956,0,73080,73080,0,3.93541
17/03/2020 10:48,2019,1,WESTERN EUROPE-EU,SPAIN(CANARY ISLANDS),2,LEEDS BRADFORD,LAS PALMAS,91488,91488,0,93472,93472,0,-2.12256
17/03/2020 10:48,2019,1,WESTERN EUROPE-EU,SPAIN(CANARY ISLANDS),2,LEEDS BRADFORD,TENERIFE (SURREINA SOFIA),201057,201057,0,200690,187440,13250,0.18287
17/03/2020 10:48,2019,1,WESTERN EUROPE-EU,SPAIN(CANARY ISLANDS),2,LIVERPOOL (JOHN LENNON),ARRECIFE,76489,76489,0,74595,74595,0,2.53904
17/03/2020 10:48,2019,1,WESTERN EUROPE-EU,SPAIN(CANARY ISLANDS),2,LIVERPOOL (JOHN LENNON),FUERTEVENTURA,43068,43068,0,52538,52538,0,-18.02505
17/03/2020 10:48,2019,1,WESTERN EUROPE-EU,SPAIN(CANARY ISLANDS),2,LIVERPOOL (JOHN LENNON),LAS PALMAS,20511,20511,0,21112,21112,0,-2.84672
17/03/2020 10:48,2019,1,WESTERN EUROPE-EU,SPAIN(CANARY ISLANDS),2,LIVERPOOL (JOHN LENNON),TENERIFE (SURREINA SOFIA),46545,46545,0,40861,40665,196,13.91057
17/03/2020 10:48,2019,1,WESTERN EUROPE-EU,SPAIN(CANARY ISLANDS),2,MANCHESTER,ARRECIFE,488001,394991,93010,455422,355888,99534,7.15359
17/03/2020 10:48,2019,1,WESTERN EUROPE-EU,SPAIN(CANARY ISLANDS),2,MANCHESTER,FUERTEVENTURA,242821,182563,60258,259029,199938,59091,-6.25721
17/03/2020 10:48,2019,1,WESTERN EUROPE-EU,SPAIN(CANARY ISLANDS),2,MANCHESTER,LAS PALMAS,277007,188005,89002,302812,210479,92333,-8.52179
17/03/2020 10:48,2019,1,WESTERN EUROPE-EU,SPAIN(CANARY ISLANDS),2,MANCHESTER,SANTA CRUZ DE LA PALMA,21774,0,21774,24039,0,24039,-9.42219
17/03/2020 10:48,2019,1,WESTERN EUROPE-EU,SPAIN(CANARY ISLANDS),2,MANCHESTER,TENERIFE (SURREINA SOFIA),856421,700218,156203,798954,630357,168597,7.19278
17/03/2020 10:48,2019,1,WESTERN EUROPE-EU,SPAIN(CANARY ISLANDS),2,NEWCASTLE,ARRECIFE,143750,143750,0,151213,150984,229,-4.93542
17/03/2020 10:48,2019,1,WESTERN EUROPE-EU,SPAIN(CANARY ISLANDS),2,NEWCASTLE,FUERTEVENTURA,48834,48834,0,62430,62095,335,-21.77799
17/03/2020 10:48,2019,1,WESTERN EUROPE-EU,SPAIN(CANARY ISLANDS),2,NEWCASTLE,LAS PALMAS,55509,55509,0,64863,64699,164,-14.42116
17/03/2020 10:48,2019,1,WESTERN EUROPE-EU,SPAIN(CANARY ISLANDS),2,NEWCASTLE,TENERIFE (SURREINA SOFIA),226116,226116,0,246944,246944,0,-8.4343
17/03/2020 10:48,2019,1,WESTERN EUROPE-EU,SPAIN(CANARY ISLANDS),2,NORWICH,LAS PALMAS,0,0,0,8252,0,8252,-100
17/03/2020 10:48,2019,1,WESTERN EUROPE-EU,SPAIN(CANARY ISLANDS),2,NORWICH,TENERIFE (NORTE LOS RODEOS),0,0,0,12667,0,12667,-100
17/03/2020 10:48,2019,1,WESTERN EUROPE-EU,SPAIN(CANARY ISLANDS),2,NORWICH,TENERIFE (SURREINA SOFIA),19055,0,19055,11723,173,11550,62.54372
17/03/2020 10:48,2019,1,WESTERN EUROPE-EU,SPAIN(CANARY ISLANDS),2,PRESTWICK,ARRECIFE,36060,36060,0,34499,34499,0,4.52477
17/03/2020 10:48,2019,1,WESTERN EUROPE-EU,SPAIN(CANARY ISLANDS),2,PRESTWICK,FUERTEVENTURA,4069,4069,0,16988,16988,0,-76.0478
17/03/2020 10:48,2019,1,WESTERN EUROPE-EU,SPAIN(CANARY ISLANDS),2,PRESTWICK,LAS PALMAS,21349,21349,0,23749,23749,0,-10.10569
17/03/2020 10:48,2019,1,WESTERN EUROPE-EU,SPAIN(CANARY ISLANDS),2,PRESTWICK,TENERIFE (SURREINA SOFIA),96982,96640,342,95226,95226,0,1.84403
17/03/2020 10:48,2019,1,WESTERN EUROPE-EU,SPAIN(CANARY ISLANDS),2,SOUTHAMPTON,TENERIFE (NORTE LOS RODEOS),4,0,4,0,0,0,0
17/03/2020 10:48,2019,1,WESTERN EUROPE-EU,SPAIN(CANARY ISLANDS),2,SOUTHAMPTON,TENERIFE (SURREINA SOFIA),60,60,0,0,0,0,0
17/03/2020 10:48,2019,1,WESTERN EUROPE-EU,SWEDEN,1,GATWICK,GOTEBORG (LANDVETTER),172358,172358,0,183873,183873,0,-6.26247
17/03/2020 10:48,2019,1,WESTERN EUROPE-EU,SWEDEN,1,GATWICK,KIRUNA,0,0,0,101,0,101,-100
17/03/2020 10:48,2019,1,WESTERN EUROPE-EU,SWEDEN,1,GATWICK,MALMO,222,0,222,0,0,0,0
17/03/2020 10:48,2019,1,WESTERN EUROPE-EU,SWEDEN,1,GATWICK,OSTERSUND / FROSON,9641,9641,0,6582,6582,0,46.47524
17/03/2020 10:48,2019,1,WESTERN EUROPE-EU,SWEDEN,1,GATWICK,PAJALA YLLAS,376,0,376,0,0,0,0
17/03/2020 10:48,2019,1,WESTERN EUROPE-EU,SWEDEN,1,GATWICK,STOCKHOLM (ARLANDA),436077,436067,10,498756,498646,110,-12.56707
17/03/2020 10:48,2019,1,WESTERN EUROPE-EU,SWEDEN,1,HEATHROW,GOTEBORG (LANDVETTER),247369,247369,0,254676,254676,0,-2.86914
17/03/2020 10:48,2019,1,WESTERN EUROPE-EU,SWEDEN,1,HEATHROW,KIRUNA,2101,0,2101,2238,0,2238,-6.12154
17/03/2020 10:48,2019,1,WESTERN EUROPE-EU,SWEDEN,1,HEATHROW,STOCKHOLM (ARLANDA),959928,959928,0,970622,970622,0,-1.10177
17/03/2020 10:48,2019,1,WESTERN EUROPE-EU,SWEDEN,1,LUTON,HALMSTAD,174,0,174,0,0,0,0
17/03/2020 10:48,2019,1,WESTERN EUROPE-EU,SWEDEN,1,LUTON,MALMO,165,0,165,0,0,0,0
17/03/2020 10:48,2019,1,WESTERN EUROPE-EU,SWEDEN,1,LUTON,OSTERSUND / FROSON,0,0,0,808,0,808,-100
17/03/2020 10:48,2019,1,WESTERN EUROPE-EU,SWEDEN,1,LUTON,STOCKHOLM (ARLANDA),22549,22549,0,49243,49243,0,-54.20872
17/03/2020 10:48,2019,1,WESTERN EUROPE-EU,SWEDEN,1,STANSTED,GOTEBORG (LANDVETTER),159137,159137,0,155673,155602,71,2.22518
17/03/2020 10:48,2019,1,WESTERN EUROPE-EU,SWEDEN,1,STANSTED,HALMSTAD,0,0,0,312,0,312,-100
17/03/2020 10:48,2019,1,WESTERN EUROPE-EU,SWEDEN,1,STANSTED,MALMO,0,0,0,179,179,0,-100
17/03/2020 10:48,2019,1,WESTERN EUROPE-EU,SWEDEN,1,STANSTED,NORRKOPING,0,0,0,174,174,0,-100
17/03/2020 10:48,2019,1,WESTERN EUROPE-EU,SWEDEN,1,STANSTED,OSTERSUND / FROSON,0,0,0,87,0,87,-100
17/03/2020 10:48,2019,1,WESTERN EUROPE-EU,SWEDEN,1,STANSTED,PAJALA YLLAS,0,0,0,378,0,378,-100
17/03/2020 10:48,2019,1,WESTERN EUROPE-EU,SWEDEN,1,STANSTED,STOCKHOLM (ARLANDA),909,0,909,1169,477,692,-22.24123
17/03/2020 10:48,2019,1,WESTERN EUROPE-EU,SWEDEN,1,STANSTED,STOCKHOLM (SKAVSTA),214869,214869,0,256482,256482,0,-16.22453
17/03/2020 10:48,2019,1,WESTERN EUROPE-EU,SWEDEN,1,STANSTED,VASTERAS,63525,63525,0,69382,69382,0,-8.44167
17/03/2020 10:48,2019,1,WESTERN EUROPE-EU,SWEDEN,2,BELFAST INTERNATIONAL,LULEA,131,0,131,0,0,0,0
17/03/2020 10:48,2019,1,WESTERN EUROPE-EU,SWEDEN,2,BELFAST INTERNATIONAL,MALMO,219,0,219,0,0,0,0
17/03/2020 10:48,2019,1,WESTERN EUROPE-EU,SWEDEN,2,BELFAST INTERNATIONAL,UMEA,213,0,213,0,0,0,0
17/03/2020 10:48,2019,1,WESTERN EUROPE-EU,SWEDEN,2,BIGGIN HILL,MALMO,0,0,0,6,0,6,-100
17/03/2020 10:48,2019,1,WESTERN EUROPE-EU,SWEDEN,2,BIGGIN HILL,STOCKHOLM (BROMMA),0,0,0,5,0,5,-100
17/03/2020 10:48,2019,1,WESTERN EUROPE-EU,SWEDEN,2,BIGGIN HILL,VAXJO,0,0,0,3,0,3,-100
17/03/2020 10:48,2019,1,WESTERN EUROPE-EU,SWEDEN,2,BIRMINGHAM,ARVIDSJAUR,0,0,0,324,0,324,-100
17/03/2020 10:48,2019,1,WESTERN EUROPE-EU,SWEDEN,2,BIRMINGHAM,GOTEBORG (LANDVETTER),0,0,0,3054,2896,158,-100
17/03/2020 10:48,2019,1,WESTERN EUROPE-EU,SWEDEN,2,BIRMINGHAM,KIRUNA,0,0,0,105,0,105,-100
17/03/2020 10:48,2019,1,WESTERN EUROPE-EU,SWEDEN,2,BIRMINGHAM,PAJALA YLLAS,376,0,376,378,0,378,-0.5291
17/03/2020 10:48,2019,1,WESTERN EUROPE-EU,SWEDEN,2,BIRMINGHAM,STOCKHOLM (ARLANDA),1083,809,274,2917,2896,21,-62.87281
17/03/2020 10:48,2019,1,WESTERN EUROPE-EU,SWEDEN,2,BIRMINGHAM,VAXJO,0,0,0,338,0,338,-100
17/03/2020 10:48,2019,1,WESTERN EUROPE-EU,SWEDEN,2,BOURNEMOUTH,PAJALA YLLAS,376,0,376,378,0,378,-0.5291
17/03/2020 10:48,2019,1,WESTERN EUROPE-EU,SWEDEN,2,BRISTOL,GOTEBORG (LANDVETTER),0,0,0,2211,2211,0,-100
17/03/2020 10:48,2019,1,WESTERN EUROPE-EU,SWEDEN,2,BRISTOL,OSTERSUND / FROSON,1217,1217,0,522,522,0,133.14176
17/03/2020 10:48,2019,1,WESTERN EUROPE-EU,SWEDEN,2,BRISTOL,STOCKHOLM (ARLANDA),19994,19994,0,28885,28885,0,-30.78068
17/03/2020 10:48,2019,1,WESTERN EUROPE-EU,SWEDEN,2,BRISTOL,VAXJO,0,0,0,310,0,310,-100
17/03/2020 10:48,2019,1,WESTERN EUROPE-EU,SWEDEN,2,CAMBRIDGE,GOTEBORG (LANDVETTER),0,0,0,10,10,0,-100
17/03/2020 10:48,2019,1,WESTERN EUROPE-EU,SWEDEN,2,CARDIFF WALES,PAJALA YLLAS,378,0,378,374,0,374,1.06952
17/03/2020 10:48,2019,1,WESTERN EUROPE-EU,SWEDEN,2,CARDIFF WALES,VAXJO,0,0,0,136,0,136,-100
17/03/2020 10:48,2019,1,WESTERN EUROPE-EU,SWEDEN,2,DUNDEE,VISBY,0,0,0,5,0,5,-100
17/03/2020 10:48,2019,1,WESTERN EUROPE-EU,SWEDEN,2,EAST MIDLANDS INTERNATIONAL,GOTEBORG (LANDVETTER),0,0,0,7,7,0,-100
17/03/2020 10:48,2019,1,WESTERN EUROPE-EU,SWEDEN,2,EAST MIDLANDS INTERNATIONAL,PAJALA YLLAS,186,0,186,0,0,0,0
17/03/2020 10:48,2019,1,WESTERN EUROPE-EU,SWEDEN,2,EDINBURGH,GOTEBORG (LANDVETTER),35966,35966,0,27191,27191,0,32.27171
17/03/2020 10:48,2019,1,WESTERN EUROPE-EU,SWEDEN,2,EDINBURGH,STOCKHOLM (ARLANDA),115505,115505,0,130330,130330,0,-11.37497
17/03/2020 10:48,2019,1,WESTERN EUROPE-EU,SWEDEN,2,EDINBURGH,STOCKHOLM (SKAVSTA),27028,27028,0,6522,6522,0,314.41276
17/03/2020 10:48,2019,1,WESTERN EUROPE-EU,SWEDEN,2,EXETER,PAJALA YLLAS,376,0,376,0,0,0,0
17/03/2020 10:48,2019,1,WESTERN EUROPE-EU,SWEDEN,2,GLASGOW,PAJALA YLLAS,378,0,378,375,0,375,0.8
17/03/2020 10:48,2019,1,WESTERN EUROPE-EU,SWEDEN,2,GLASGOW,STOCKHOLM (ARLANDA),458,0,458,0,0,0,0
17/03/2020 10:48,2019,1,WESTERN EUROPE-EU,SWEDEN,2,HUMBERSIDE,PAJALA YLLAS,372,0,372,376,0,376,-1.06383
17/03/2020 10:48,2019,1,WESTERN EUROPE-EU,SWEDEN,2,ISLE OF MAN,PAJALA YLLAS,0,0,0,308,0,308,-100
17/03/2020 10:48,2019,1,WESTERN EUROPE-EU,SWEDEN,2,ISLE OF MAN,STOCKHOLM (ARLANDA),166,0,166,201,0,201,-17.41294
17/03/2020 10:48,2019,1,WESTERN EUROPE-EU,SWEDEN,2,LEEDS BRADFORD,PAJALA YLLAS,376,0,376,374,0,374,0.53476
17/03/2020 10:48,2019,1,WESTERN EUROPE-EU,SWEDEN,2,LEEDS BRADFORD,STOCKHOLM (ARLANDA),0,0,0,37,0,37,-100
17/03/2020 10:48,2019,1,WESTERN EUROPE-EU,SWEDEN,2,LIVERPOOL (JOHN LENNON),OREBRO,259,0,259,0,0,0,0
17/03/2020 10:48,2019,1,WESTERN EUROPE-EU,SWEDEN,2,LIVERPOOL (JOHN LENNON),PAJALA YLLAS,376,0,376,374,0,374,0.53476
17/03/2020 10:48,2019,1,WESTERN EUROPE-EU,SWEDEN,2,LIVERPOOL (JOHN LENNON),STOCKHOLM (ARLANDA),0,0,0,168,168,0,-100
17/03/2020 10:48,2019,1,WESTERN EUROPE-EU,SWEDEN,2,MANCHESTER,GOTEBORG (LANDVETTER),28052,28052,0,2862,2862,0,880.15374
17/03/2020 10:48,2019,1,WESTERN EUROPE-EU,SWEDEN,2,MANCHESTER,STOCKHOLM (ARLANDA),168785,168512,273,165046,165046,0,2.26543
17/03/2020 10:48,2019,1,WESTERN EUROPE-EU,SWEDEN,2,NORWICH,PAJALA YLLAS,360,0,360,374,0,374,-3.74332
17/03/2020 10:48,2019,1,WESTERN EUROPE-EU,SWEDEN,2,TEESSIDE INTERNATIONAL AIRPORT,PAJALA YLLAS,0,0,0,374,0,374,-100
17/03/2020 10:48,2019,2,WESTERN EUROPE-OTHER,BOSNIA-HERZEGOVINA,1,LUTON,SARAJEVO,2174,2174,0,0,0,0,0
17/03/2020 10:48,2019,2,WESTERN EUROPE-OTHER,BOSNIA-HERZEGOVINA,2,BELFAST INTERNATIONAL,SARAJEVO,0,0,0,197,0,197,-100
17/03/2020 10:48,2019,2,WESTERN EUROPE-OTHER,BOSNIA-HERZEGOVINA,2,GLASGOW,SARAJEVO,122,0,122,0,0,0,0
17/03/2020 10:48,2019,2,WESTERN EUROPE-OTHER,FAROE ISLANDS,2,ABERDEEN,VAGAR,174,0,174,289,0,289,-39.79239
17/03/2020 10:48,2019,2,WESTERN EUROPE-OTHER,FAROE ISLANDS,2,BELFAST INTERNATIONAL,VAGAR,398,0,398,0,0,0,0
17/03/2020 10:48,2019,2,WESTERN EUROPE-OTHER,FAROE ISLANDS,2,CARDIFF WALES,VAGAR,0,0,0,285,0,285,-100
17/03/2020 10:48,2019,2,WESTERN EUROPE-OTHER,FAROE ISLANDS,2,EDINBURGH,VAGAR,14816,14816,0,15236,14749,487,-2.75663
17/03/2020 10:48,2019,2,WESTERN EUROPE-OTHER,FAROE ISLANDS,2,GLASGOW,VAGAR,230,0,230,0,0,0,0
17/03/2020 10:48,2019,2,WESTERN EUROPE-OTHER,ICELAND,1,GATWICK,KEFLAVIK,242035,226805,15230,467058,452688,14370,-48.17881
17/03/2020 10:48,2019,2,WESTERN EUROPE-OTHER,ICELAND,1,HEATHROW,KEFLAVIK,353509,353509,0,378205,378205,0,-6.52979
17/03/2020 10:48,2019,2,WESTERN EUROPE-OTHER,ICELAND,1,LONDON CITY,KEFLAVIK,3207,3207,0,5034,5034,0,-36.29321
17/03/2020 10:48,2019,2,WESTERN EUROPE-OTHER,ICELAND,1,LUTON,KEFLAVIK,256908,256908,0,196481,196426,55,30.75463
17/03/2020 10:48,2019,2,WESTERN EUROPE-OTHER,ICELAND,1,SOUTHEND,AKUREYRI,402,402,0,0,0,0,0
17/03/2020 10:48,2019,2,WESTERN EUROPE-OTHER,ICELAND,1,STANSTED,AKUREYRI,0,0,0,160,0,160,-100
17/03/2020 10:48,2019,2,WESTERN EUROPE-OTHER,ICELAND,1,STANSTED,KEFLAVIK,10579,10579,0,88414,88282,132,-88.0347
17/03/2020 10:48,2019,2,WESTERN EUROPE-OTHER,ICELAND,2,ABERDEEN,KEFLAVIK,1,1,0,3338,3338,0,-99.97004
17/03/2020 10:48,2019,2,WESTERN EUROPE-OTHER,ICELAND,2,BELFAST CITY (GEORGE BEST),KEFLAVIK,0,0,0,2447,2447,0,-100
17/03/2020 10:48,2019,2,WESTERN EUROPE-OTHER,ICELAND,2,BELFAST INTERNATIONAL,KEFLAVIK,13203,13203,0,16206,16039,167,-18.53017
17/03/2020 10:48,2019,2,WESTERN EUROPE-OTHER,ICELAND,2,BIRMINGHAM,KEFLAVIK,1846,1846,0,1590,1438,152,16.10063
17/03/2020 10:48,2019,2,WESTERN EUROPE-OTHER,ICELAND,2,BOURNEMOUTH,AKUREYRI,511,0,511,648,0,648,-21.14198
17/03/2020 10:48,2019,2,WESTERN EUROPE-OTHER,ICELAND,2,BRISTOL,KEFLAVIK,18842,18842,0,19154,19154,0,-1.6289
17/03/2020 10:48,2019,2,WESTERN EUROPE-OTHER,ICELAND,2,CARDIFF WALES,AKUREYRI,266,0,266,1061,0,1061,-74.92931
17/03/2020 10:48,2019,2,WESTERN EUROPE-OTHER,ICELAND,2,CARDIFF WALES,KEFLAVIK,0,0,0,4,0,4,-100
17/03/2020 10:48,2019,2,WESTERN EUROPE-OTHER,ICELAND,2,CITY OF DERRY (EGLINTON),AKUREYRI,366,0,366,0,0,0,0
17/03/2020 10:48,2019,2,WESTERN EUROPE-OTHER,ICELAND,2,EAST MIDLANDS INTERNATIONAL,AKUREYRI,398,0,398,96,0,96,314.58333
17/03/2020 10:48,2019,2,WESTERN EUROPE-OTHER,ICELAND,2,EAST MIDLANDS INTERNATIONAL,KEFLAVIK,5018,1115,3903,3799,0,3799,32.08739
17/03/2020 10:48,2019,2,WESTERN EUROPE-OTHER,ICELAND,2,EDINBURGH,AKUREYRI,0,0,0,395,162,233,-100
17/03/2020 10:48,2019,2,WESTERN EUROPE-OTHER,ICELAND,2,EDINBURGH,KEFLAVIK,52676,52317,359,101889,101837,52,-48.3006
17/03/2020 10:48,2019,2,WESTERN EUROPE-OTHER,ICELAND,2,EDINBURGH,REYKJAVIK,406,0,406,0,0,0,0
17/03/2020 10:48,2019,2,WESTERN EUROPE-OTHER,ICELAND,2,EXETER,AKUREYRI,395,0,395,615,0,615,-35.77236
17/03/2020 10:48,2019,2,WESTERN EUROPE-OTHER,ICELAND,2,GLASGOW,AKUREYRI,49,0,49,0,0,0,0
17/03/2020 10:48,2019,2,WESTERN EUROPE-OTHER,ICELAND,2,GLASGOW,EGILSSTADIR,0,0,0,338,0,338,-100
17/03/2020 10:48,2019,2,WESTERN EUROPE-OTHER,ICELAND,2,GLASGOW,KEFLAVIK,107751,107751,0,107299,107247,52,0.42125
17/03/2020 10:48,2019,2,WESTERN EUROPE-OTHER,ICELAND,2,HUMBERSIDE,AKUREYRI,1072,0,1072,669,0,669,60.23916
17/03/2020 10:48,2019,2,WESTERN EUROPE-OTHER,ICELAND,2,HUMBERSIDE,KEFLAVIK,0,0,0,93,0,93,-100
17/03/2020 10:48,2019,2,WESTERN EUROPE-OTHER,ICELAND,2,INVERNESS,AKUREYRI,351,0,351,0,0,0,0
17/03/2020 10:48,2019,2,WESTERN EUROPE-OTHER,ICELAND,2,ISLE OF MAN,AKUREYRI,756,0,756,0,0,0,0
17/03/2020 10:48,2019,2,WESTERN EUROPE-OTHER,ICELAND,2,JERSEY,AKUREYRI,386,0,386,0,0,0,0
17/03/2020 10:48,2019,2,WESTERN EUROPE-OTHER,ICELAND,2,LEEDS BRADFORD,AKUREYRI,525,0,525,508,0,508,3.34646
17/03/2020 10:48,2019,2,WESTERN EUROPE-OTHER,ICELAND,2,LEEDS BRADFORD,KEFLAVIK,1851,1851,0,0,0,0,0
17/03/2020 10:48,2019,2,WESTERN EUROPE-OTHER,ICELAND,2,LIVERPOOL (JOHN LENNON),AKUREYRI,0,0,0,479,0,479,-100
17/03/2020 10:48,2019,2,WESTERN EUROPE-OTHER,ICELAND,2,LIVERPOOL (JOHN LENNON),KEFLAVIK,0,0,0,170,170,0,-100
17/03/2020 10:48,2019,2,WESTERN EUROPE-OTHER,ICELAND,2,MANCHESTER,AKUREYRI,0,0,0,233,0,233,-100
17/03/2020 10:48,2019,2,WESTERN EUROPE-OTHER,ICELAND,2,MANCHESTER,EGILSSTADIR,0,0,0,249,0,249,-100
17/03/2020 10:48,2019,2,WESTERN EUROPE-OTHER,ICELAND,2,MANCHESTER,KEFLAVIK,184805,169783,15022,203385,189290,14095,-9.13538
17/03/2020 10:48,2019,2,WESTERN EUROPE-OTHER,ICELAND,2,NEWCASTLE,AKUREYRI,559,559,0,364,364,0,53.57143
17/03/2020 10:48,2019,2,WESTERN EUROPE-OTHER,ICELAND,2,NEWCASTLE,KEFLAVIK,2227,2227,0,0,0,0,0
17/03/2020 10:48,2019,2,WESTERN EUROPE-OTHER,ICELAND,2,NEWCASTLE,REYKJAVIK,0,0,0,145,0,145,-100
17/03/2020 10:48,2019,2,WESTERN EUROPE-OTHER,ICELAND,2,NEWQUAY,AKUREYRI,614,0,614,0,0,0,0
17/03/2020 10:48,2019,2,WESTERN EUROPE-OTHER,ICELAND,2,NORWICH,AKUREYRI,294,0,294,511,0,511,-42.46575
17/03/2020 10:48,2019,2,WESTERN EUROPE-OTHER,ICELAND,2,NORWICH,KEFLAVIK,15,0,15,224,0,224,-93.30357
17/03/2020 10:48,2019,2,WESTERN EUROPE-OTHER,ICELAND,2,TEESSIDE INTERNATIONAL AIRPORT,AKUREYRI,378,0,378,0,0,0,0
17/03/2020 10:48,2019,2,WESTERN EUROPE-OTHER,KOSOVO,1,GATWICK,PRISTINA,64,0,64,430,430,0,-85.11628
17/03/2020 10:48,2019,2,WESTERN EUROPE-OTHER,KOSOVO,1,LUTON,PRISTINA,72440,72440,0,55944,55944,0,29.48663
17/03/2020 10:48,2019,2,WESTERN EUROPE-OTHER,KOSOVO,1,STANSTED,PRISTINA,294,0,294,0,0,0,0
17/03/2020 10:48,2019,2,WESTERN EUROPE-OTHER,KOSOVO,2,BOURNEMOUTH,PRISTINA,138,0,138,0,0,0,0
17/03/2020 10:48,2019,2,WESTERN EUROPE-OTHER,MACEDONIA,1,GATWICK,SKOPJE,0,0,0,1,1,0,-100
17/03/2020 10:48,2019,2,WESTERN EUROPE-OTHER,MACEDONIA,1,LUTON,OHRID,22917,22917,0,17087,17087,0,34.11951
17/03/2020 10:48,2019,2,WESTERN EUROPE-OTHER,MACEDONIA,1,LUTON,SKOPJE,61539,61539,0,67868,67868,0,-9.32546
17/03/2020 10:48,2019,2,WESTERN EUROPE-OTHER,MACEDONIA,2,GLASGOW,SKOPJE,0,0,0,188,0,188,-100
17/03/2020 10:48,2019,2,WESTERN EUROPE-OTHER,MACEDONIA,2,MANCHESTER,SKOPJE,0,0,0,186,186,0,-100
17/03/2020 10:48,2019,2,WESTERN EUROPE-OTHER,NORWAY,1,GATWICK,ANDENES,0,0,0,1,0,1,-100
17/03/2020 10:48,2019,2,WESTERN EUROPE-OTHER,NORWAY,1,GATWICK,BERGEN,208585,205917,2668,210922,209419,1503,-1.10799
17/03/2020 10:48,2019,2,WESTERN EUROPE-OTHER,NORWAY,1,GATWICK,FAGERNES/LEIRIN,0,0,0,1730,0,1730,-100
17/03/2020 10:48,2019,2,WESTERN EUROPE-OTHER,NORWAY,1,GATWICK,MOLDE,249,145,104,0,0,0,0
17/03/2020 10:48,2019,2,WESTERN EUROPE-OTHER,NORWAY,1,GATWICK,OSLO (GARDERMOEN),410482,410311,171,458875,458529,346,-10.54601
17/03/2020 10:48,2019,2,WESTERN EUROPE-OTHER,NORWAY,1,GATWICK,STAVANGER,87056,87056,0,108200,107843,357,-19.54159
17/03/2020 10:48,2019,2,WESTERN EUROPE-OTHER,NORWAY,1,GATWICK,TROMSOE,27297,27297,0,23477,22365,1112,16.27124
17/03/2020 10:48,2019,2,WESTERN EUROPE-OTHER,NORWAY,1,GATWICK,TRONDHEIM (VAERNES),62719,62719,0,64382,64382,0,-2.58302
17/03/2020 10:48,2019,2,WESTERN EUROPE-OTHER,NORWAY,1,HEATHROW,OSLO (GARDERMOEN),685981,685981,0,668983,668983,0,2.54087
17/03/2020 10:48,2019,2,WESTERN EUROPE-OTHER,NORWAY,1,HEATHROW,STAVANGER,68605,68605,0,98250,98250,0,-30.17303
17/03/2020 10:48,2019,2,WESTERN EUROPE-OTHER,NORWAY,1,LUTON,BERGEN,33276,33276,0,0,0,0,0
17/03/2020 10:48,2019,2,WESTERN EUROPE-OTHER,NORWAY,1,LUTON,OSLO (GARDERMOEN),27653,27653,0,0,0,0,0
17/03/2020 10:48,2019,2,WESTERN EUROPE-OTHER,NORWAY,1,LUTON,STAVANGER,12003,12003,0,0,0,0,0
17/03/2020 10:48,2019,2,WESTERN EUROPE-OTHER,NORWAY,1,LUTON,TROMSOE,10104,10104,0,1586,1586,0,537.0744
17/03/2020 10:48,2019,2,WESTERN EUROPE-OTHER,NORWAY,1,STANSTED,KRISTIANSAND (KJEVIK),25155,25155,0,7637,7637,0,229.38327
17/03/2020 10:48,2019,2,WESTERN EUROPE-OTHER,NORWAY,1,STANSTED,KRISTIANSUND (KUERNBERGET),86,0,86,0,0,0,0
17/03/2020 10:48,2019,2,WESTERN EUROPE-OTHER,NORWAY,1,STANSTED,OSLO (GARDERMOEN),291754,291652,102,307973,307973,0,-5.26637
17/03/2020 10:48,2019,2,WESTERN EUROPE-OTHER,NORWAY,1,STANSTED,RYGGE,0,0,0,135,135,0,-100
17/03/2020 10:48,2019,2,WESTERN EUROPE-OTHER,NORWAY,1,STANSTED,SANDEFJORD(TORP),56020,56020,0,56510,56510,0,-0.8671
17/03/2020 10:48,2019,2,WESTERN EUROPE-OTHER,NORWAY,1,STANSTED,TROMSOE,0,0,0,80,0,80,-100
17/03/2020 10:48,2019,2,WESTERN EUROPE-OTHER,NORWAY,2,ABERDEEN,ALESUND,0,0,0,21,21,0,-100
17/03/2020 10:48,2019,2,WESTERN EUROPE-OTHER,NORWAY,2,ABERDEEN,BERGEN,42880,42814,66,43068,42914,154,-0.43652
17/03/2020 10:48,2019,2,WESTERN EUROPE-OTHER,NORWAY,2,ABERDEEN,HAUGESUND,44,0,44,33,0,33,33.33333
17/03/2020 10:48,2019,2,WESTERN EUROPE-OTHER,NORWAY,2,ABERDEEN,OSLO (GARDERMOEN),25491,25491,0,29122,29122,0,-12.46824
17/03/2020 10:48,2019,2,WESTERN EUROPE-OTHER,NORWAY,2,ABERDEEN,SANDEFJORD(TORP),24,24,0,0,0,0,0
17/03/2020 10:48,2019,2,WESTERN EUROPE-OTHER,NORWAY,2,ABERDEEN,STAVANGER,105860,105860,0,96135,96135,0,10.11598
17/03/2020 10:48,2019,2,WESTERN EUROPE-OTHER,NORWAY,2,BELFAST INTERNATIONAL,HAUGESUND,228,0,228,0,0,0,0
17/03/2020 10:48,2019,2,WESTERN EUROPE-OTHER,NORWAY,2,BELFAST INTERNATIONAL,TRONDHEIM (VAERNES),230,0,230,0,0,0,0
17/03/2020 10:48,2019,2,WESTERN EUROPE-OTHER,NORWAY,2,BIGGIN HILL,OSLO (GARDERMOEN),3,0,3,0,0,0,0
17/03/2020 10:48,2019,2,WESTERN EUROPE-OTHER,NORWAY,2,BIRMINGHAM,ALESUND,0,0,0,54,0,54,-100
17/03/2020 10:48,2019,2,WESTERN EUROPE-OTHER,NORWAY,2,BIRMINGHAM,BERGEN,976,0,976,561,0,561,73.97504
17/03/2020 10:48,2019,2,WESTERN EUROPE-OTHER,NORWAY,2,BIRMINGHAM,OSLO (GARDERMOEN),205,205,0,0,0,0,0
17/03/2020 10:48,2019,2,WESTERN EUROPE-OTHER,NORWAY,2,BIRMINGHAM,TROMSOE,0,0,0,139,139,0,-100
17/03/2020 10:48,2019,2,WESTERN EUROPE-OTHER,NORWAY,2,BOURNEMOUTH,BERGEN,709,0,709,247,0,247,187.04453
17/03/2020 10:48,2019,2,WESTERN EUROPE-OTHER,NORWAY,2,BOURNEMOUTH,TROMSOE,0,0,0,232,0,232,-100
17/03/2020 10:48,2019,2,WESTERN EUROPE-OTHER,NORWAY,2,BRISTOL,BERGEN,992,0,992,618,0,618,60.5178
17/03/2020 10:48,2019,2,WESTERN EUROPE-OTHER,NORWAY,2,BRISTOL,LONGYEARBYEN (SVALBARD),0,0,0,60,0,60,-100
17/03/2020 10:48,2019,2,WESTERN EUROPE-OTHER,NORWAY,2,BRISTOL,OSLO (GARDERMOEN),240,240,0,0,0,0,0
17/03/2020 10:48,2019,2,WESTERN EUROPE-OTHER,NORWAY,2,BRISTOL,TROMSOE,0,0,0,292,0,292,-100
17/03/2020 10:48,2019,2,WESTERN EUROPE-OTHER,NORWAY,2,CARDIFF WALES,BERGEN,272,0,272,278,0,278,-2.15827
17/03/2020 10:48,2019,2,WESTERN EUROPE-OTHER,NORWAY,2,CARDIFF WALES,LONGYEARBYEN (SVALBARD),0,0,0,57,0,57,-100
17/03/2020 10:48,2019,2,WESTERN EUROPE-OTHER,NORWAY,2,CARDIFF WALES,OSLO (GARDERMOEN),0,0,0,4,0,4,-100
17/03/2020 10:48,2019,2,WESTERN EUROPE-OTHER,NORWAY,2,DUNDEE,OSLO (GARDERMOEN),81,0,81,57,0,57,42.10526
17/03/2020 10:48,2019,2,WESTERN EUROPE-OTHER,NORWAY,2,EAST MIDLANDS INTERNATIONAL,TROMSOE,0,0,0,287,0,287,-100
17/03/2020 10:48,2019,2,WESTERN EUROPE-OTHER,NORWAY,2,EDINBURGH,ALESUND,262,0,262,0,0,0,0
17/03/2020 10:48,2019,2,WESTERN EUROPE-OTHER,NORWAY,2,EDINBURGH,BERGEN,5360,5236,124,1139,1139,0,370.58824
17/03/2020 10:48,2019,2,WESTERN EUROPE-OTHER,NORWAY,2,EDINBURGH,KRISTIANSAND (KJEVIK),0,0,0,194,0,194,-100
17/03/2020 10:48,2019,2,WESTERN EUROPE-OTHER,NORWAY,2,EDINBURGH,MOLDE,0,0,0,506,0,506,-100
17/03/2020 10:48,2019,2,WESTERN EUROPE-OTHER,NORWAY,2,EDINBURGH,OSLO (GARDERMOEN),133337,133159,178,119418,119257,161,11.6557
17/03/2020 10:48,2019,2,WESTERN EUROPE-OTHER,NORWAY,2,EDINBURGH,SANDEFJORD(TORP),2,2,0,0,0,0,0
17/03/2020 10:48,2019,2,WESTERN EUROPE-OTHER,NORWAY,2,EDINBURGH,STAVANGER,7223,7223,0,0,0,0,0
17/03/2020 10:48,2019,2,WESTERN EUROPE-OTHER,NORWAY,2,EDINBURGH,TRONDHEIM (VAERNES),0,0,0,202,0,202,-100
17/03/2020 10:48,2019,2,WESTERN EUROPE-OTHER,NORWAY,2,EXETER,BARDUFOSS,231,0,231,82,0,82,181.70732
17/03/2020 10:48,2019,2,WESTERN EUROPE-OTHER,NORWAY,2,GLASGOW,BERGEN,0,0,0,2060,1622,438,-100
17/03/2020 10:48,2019,2,WESTERN EUROPE-OTHER,NORWAY,2,GLASGOW,OSLO (GARDERMOEN),0,0,0,20,20,0,-100
17/03/2020 10:48,2019,2,WESTERN EUROPE-OTHER,NORWAY,2,GLASGOW,TRONDHEIM (VAERNES),0,0,0,1041,0,1041,-100
17/03/2020 10:48,2019,2,WESTERN EUROPE-OTHER,NORWAY,2,INVERNESS,ALESUND,0,0,0,92,0,92,-100
17/03/2020 10:48,2019,2,WESTERN EUROPE-OTHER,NORWAY,2,INVERNESS,BERGEN,868,868,0,3078,3078,0,-71.79987
17/03/2020 10:48,2019,2,WESTERN EUROPE-OTHER,NORWAY,2,KIRKWALL,BERGEN,355,355,0,410,410,0,-13.41463
17/03/2020 10:48,2019,2,WESTERN EUROPE-OTHER,NORWAY,2,LEEDS BRADFORD,BERGEN,338,0,338,276,0,276,22.46377
17/03/2020 10:48,2019,2,WESTERN EUROPE-OTHER,NORWAY,2,LEEDS BRADFORD,KRISTIANSAND (KJEVIK),257,0,257,0,0,0,0
17/03/2020 10:48,2019,2,WESTERN EUROPE-OTHER,NORWAY,2,LEEDS BRADFORD,OSLO (GARDERMOEN),3,3,0,0,0,0,0
17/03/2020 10:48,2019,2,WESTERN EUROPE-OTHER,NORWAY,2,LIVERPOOL (JOHN LENNON),BERGEN,7202,7202,0,2878,2878,0,150.24322
17/03/2020 10:48,2019,2,WESTERN EUROPE-OTHER,NORWAY,2,LIVERPOOL (JOHN LENNON),EVENES,230,0,230,0,0,0,0
17/03/2020 10:48,2019,2,WESTERN EUROPE-OTHER,NORWAY,2,LIVERPOOL (JOHN LENNON),MOLDE,337,0,337,0,0,0,0
17/03/2020 10:48,2019,2,WESTERN EUROPE-OTHER,NORWAY,2,LIVERPOOL (JOHN LENNON),OSLO (GARDERMOEN),4358,156,4202,1955,0,1955,122.9156
17/03/2020 10:48,2019,2,WESTERN EUROPE-OTHER,NORWAY,2,LIVERPOOL (JOHN LENNON),STAVANGER,704,0,704,621,0,621,13.36554
17/03/2020 10:48,2019,2,WESTERN EUROPE-OTHER,NORWAY,2,MANCHESTER,BERGEN,20593,18347,2246,19432,17685,1747,5.97468
17/03/2020 10:48,2019,2,WESTERN EUROPE-OTHER,NORWAY,2,MANCHESTER,KRISTIANSUND (KUERNBERGET),362,0,362,0,0,0,0
17/03/2020 10:48,2019,2,WESTERN EUROPE-OTHER,NORWAY,2,MANCHESTER,OSLO (GARDERMOEN),144201,144201,0,139770,139770,0,3.17021
17/03/2020 10:48,2019,2,WESTERN EUROPE-OTHER,NORWAY,2,MANCHESTER,SANDEFJORD(TORP),63873,63873,0,68488,68488,0,-6.73841
17/03/2020 10:48,2019,2,WESTERN EUROPE-OTHER,NORWAY,2,MANCHESTER,STAVANGER,24229,24229,0,24720,24720,0,-1.98625
17/03/2020 10:48,2019,2,WESTERN EUROPE-OTHER,NORWAY,2,MANCHESTER,TROMSOE,0,0,0,676,0,676,-100
17/03/2020 10:48,2019,2,WESTERN EUROPE-OTHER,NORWAY,2,NEWCASTLE,BERGEN,190,0,190,266,0,266,-28.57143
17/03/2020 10:48,2019,2,WESTERN EUROPE-OTHER,NORWAY,2,NEWCASTLE,STAVANGER,12124,12124,0,11232,11232,0,7.9416
17/03/2020 10:48,2019,2,WESTERN EUROPE-OTHER,NORWAY,2,NORWICH,BERGEN,24,24,0,0,0,0,0
17/03/2020 10:48,2019,2,WESTERN EUROPE-OTHER,NORWAY,2,NORWICH,STAVANGER,49,49,0,0,0,0,0
17/03/2020 10:48,2019,2,WESTERN EUROPE-OTHER,NORWAY,2,NORWICH,TROMSOE,0,0,0,288,0,288,-100
17/03/2020 10:48,2019,2,WESTERN EUROPE-OTHER,NORWAY,2,PRESTWICK,BARDUFOSS,0,0,0,66,0,66,-100
17/03/2020 10:48,2019,2,WESTERN EUROPE-OTHER,NORWAY,2,PRESTWICK,OSLO (GARDERMOEN),0,0,0,70,0,70,-100
17/03/2020 10:48,2019,2,WESTERN EUROPE-OTHER,NORWAY,2,SUMBURGH,ALESUND,197,0,197,200,0,200,-1.5
17/03/2020 10:48,2019,2,WESTERN EUROPE-OTHER,NORWAY,2,SUMBURGH,BERGEN,1581,1581,0,1445,1367,78,9.41176
17/03/2020 10:48,2019,2,WESTERN EUROPE-OTHER,REPUBLIC OF MONTENEGRO,1,GATWICK,PODGORICA,14885,112,14773,12408,0,12408,19.96293
17/03/2020 10:48,2019,2,WESTERN EUROPE-OTHER,REPUBLIC OF MONTENEGRO,1,GATWICK,TIVAT,34930,34930,0,33153,33153,0,5.36
17/03/2020 10:48,2019,2,WESTERN EUROPE-OTHER,REPUBLIC OF MONTENEGRO,1,STANSTED,PODGORICA,37265,36866,399,36291,36291,0,2.68386
17/03/2020 10:48,2019,2,WESTERN EUROPE-OTHER,REPUBLIC OF MONTENEGRO,1,STANSTED,TIVAT,0,0,0,1625,1625,0,-100
17/03/2020 10:48,2019,2,WESTERN EUROPE-OTHER,REPUBLIC OF MONTENEGRO,2,BIRMINGHAM,PODGORICA,3749,0,3749,5718,0,5718,-34.43512
17/03/2020 10:48,2019,2,WESTERN EUROPE-OTHER,REPUBLIC OF MONTENEGRO,2,MANCHESTER,PODGORICA,13549,0,13549,6460,0,6460,109.73684
17/03/2020 10:48,2019,2,WESTERN EUROPE-OTHER,REPUBLIC OF MONTENEGRO,2,MANCHESTER,TIVAT,20049,20049,0,19206,19206,0,4.38925
17/03/2020 10:48,2019,2,WESTERN EUROPE-OTHER,REPUBLIC OF SERBIA,1,HEATHROW,BELGRADE,102600,102600,0,93419,93419,0,9.82777
17/03/2020 10:48,2019,2,WESTERN EUROPE-OTHER,REPUBLIC OF SERBIA,1,LUTON,BELGRADE,70119,69843,276,51608,51346,262,35.86847
17/03/2020 10:48,2019,2,WESTERN EUROPE-OTHER,REPUBLIC OF SERBIA,1,STANSTED,BELGRADE,288,0,288,0,0,0,0
17/03/2020 10:48,2019,2,WESTERN EUROPE-OTHER,REPUBLIC OF SERBIA,2,LIVERPOOL (JOHN LENNON),BELGRADE,0,0,0,568,0,568,-100
17/03/2020 10:48,2019,2,WESTERN EUROPE-OTHER,REPUBLIC OF SERBIA,2,MANCHESTER,BELGRADE,690,0,690,648,0,648,6.48148
17/03/2020 10:48,2019,2,WESTERN EUROPE-OTHER,SWITZERLAND,1,GATWICK,ALTENRHEIN,0,0,0,43,0,43,-100
17/03/2020 10:48,2019,2,WESTERN EUROPE-OTHER,SWITZERLAND,1,GATWICK,BALE MULHOUSE,288862,288862,0,286579,286579,0,0.79664
17/03/2020 10:48,2019,2,WESTERN EUROPE-OTHER,SWITZERLAND,1,GATWICK,GENEVA,833621,817139,16482,828602,798350,30252,0.60572
17/03/2020 10:48,2019,2,WESTERN EUROPE-OTHER,SWITZERLAND,1,GATWICK,ZURICH,157026,157026,0,158771,158505,266,-1.09907
17/03/2020 10:48,2019,2,WESTERN EUROPE-OTHER,SWITZERLAND,1,HEATHROW,BALE MULHOUSE,278482,278482,0,280223,280223,0,-0.62129
17/03/2020 10:48,2019,2,WESTERN EUROPE-OTHER,SWITZERLAND,1,HEATHROW,GENEVA,1070524,1070524,0,1056453,1056453,0,1.33191
17/03/2020 10:48,2019,2,WESTERN EUROPE-OTHER,SWITZERLAND,1,HEATHROW,SION,515,515,0,1121,1121,0,-54.05888
17/03/2020 10:48,2019,2,WESTERN EUROPE-OTHER,SWITZERLAND,1,HEATHROW,ZURICH,1188545,1187935,610,1167980,1167388,592,1.76073
17/03/2020 10:48,2019,2,WESTERN EUROPE-OTHER,SWITZERLAND,1,LONDON CITY,BERNE,0,0,0,7197,7197,0,-100
17/03/2020 10:48,2019,2,WESTERN EUROPE-OTHER,SWITZERLAND,1,LONDON CITY,GENEVA,192170,192170,0,196756,196756,0,-2.33081
17/03/2020 10:48,2019,2,WESTERN EUROPE-OTHER,SWITZERLAND,1,LONDON CITY,SION,143,143,0,172,172,0,-16.86047
17/03/2020 10:48,2019,2,WESTERN EUROPE-OTHER,SWITZERLAND,1,LONDON CITY,ZURICH,431401,431401,0,422734,422734,0,2.05023
17/03/2020 10:48,2019,2,WESTERN EUROPE-OTHER,SWITZERLAND,1,LUTON,BALE MULHOUSE,88662,88662,0,85937,85937,0,3.17093
17/03/2020 10:48,2019,2,WESTERN EUROPE-OTHER,SWITZERLAND,1,LUTON,GENEVA,325624,325624,0,317049,317049,0,2.70463
17/03/2020 10:48,2019,2,WESTERN EUROPE-OTHER,SWITZERLAND,1,LUTON,ZURICH,174970,174970,0,176957,176957,0,-1.12287
17/03/2020 10:48,2019,2,WESTERN EUROPE-OTHER,SWITZERLAND,1,SOUTHEND,GENEVA,29418,29418,0,31321,31321,0,-6.0758
17/03/2020 10:48,2019,2,WESTERN EUROPE-OTHER,SWITZERLAND,1,SOUTHEND,ZURICH,54,54,0,0,0,0,0
17/03/2020 10:48,2019,2,WESTERN EUROPE-OTHER,SWITZERLAND,1,STANSTED,BALE MULHOUSE,0,0,0,88673,88673,0,-100
17/03/2020 10:48,2019,2,WESTERN EUROPE-OTHER,SWITZERLAND,1,STANSTED,GENEVA,96509,96010,499,88800,88800,0,8.68131
17/03/2020 10:48,2019,2,WESTERN EUROPE-OTHER,SWITZERLAND,1,STANSTED,ZURICH,171,40,131,1062,61,1001,-83.89831
17/03/2020 10:48,2019,2,WESTERN EUROPE-OTHER,SWITZERLAND,2,ABERDEEN,GENEVA,4513,4513,0,7877,7877,0,-42.70661
17/03/2020 10:48,2019,2,WESTERN EUROPE-OTHER,SWITZERLAND,2,BELFAST CITY (GEORGE BEST),GENEVA,0,0,0,1,0,1,-100
17/03/2020 10:48,2019,2,WESTERN EUROPE-OTHER,SWITZERLAND,2,BELFAST INTERNATIONAL,GENEVA,19633,19633,0,21238,21238,0,-7.55721
17/03/2020 10:48,2019,2,WESTERN EUROPE-OTHER,SWITZERLAND,2,BIGGIN HILL,BERNE,27,0,27,17,0,17,58.82353
17/03/2020 10:48,2019,2,WESTERN EUROPE-OTHER,SWITZERLAND,2,BIGGIN HILL,GENEVA,63,0,63,68,0,68,-7.35294
17/03/2020 10:48,2019,2,WESTERN EUROPE-OTHER,SWITZERLAND,2,BIGGIN HILL,SION,1,0,1,17,0,17,-94.11765
17/03/2020 10:48,2019,2,WESTERN EUROPE-OTHER,SWITZERLAND,2,BIGGIN HILL,ZURICH,164,0,164,25,0,25,556
17/03/2020 10:48,2019,2,WESTERN EUROPE-OTHER,SWITZERLAND,2,BIRMINGHAM,BALE MULHOUSE,0,0,0,143,143,0,-100
17/03/2020 10:48,2019,2,WESTERN EUROPE-OTHER,SWITZERLAND,2,BIRMINGHAM,GENEVA,109286,106260,3026,114907,109853,5054,-4.89178
17/03/2020 10:48,2019,2,WESTERN EUROPE-OTHER,SWITZERLAND,2,BIRMINGHAM,ZURICH,97967,97967,0,103561,103332,229,-5.40165
17/03/2020 10:48,2019,2,WESTERN EUROPE-OTHER,SWITZERLAND,2,BOURNEMOUTH,GENEVA,25035,25035,0,28656,28606,50,-12.6361
17/03/2020 10:48,2019,2,WESTERN EUROPE-OTHER,SWITZERLAND,2,BRISTOL,BALE MULHOUSE,52879,52879,0,50349,50131,218,5.02493
17/03/2020 10:48,2019,2,WESTERN EUROPE-OTHER,SWITZERLAND,2,BRISTOL,GENEVA,215953,205303,10650,220956,212354,8602,-2.26425
17/03/2020 10:48,2019,2,WESTERN EUROPE-OTHER,SWITZERLAND,2,BRISTOL,ZURICH,0,0,0,324,0,324,-100
17/03/2020 10:48,2019,2,WESTERN EUROPE-OTHER,SWITZERLAND,2,CARDIFF WALES,BALE MULHOUSE,0,0,0,43,0,43,-100
17/03/2020 10:48,2019,2,WESTERN EUROPE-OTHER,SWITZERLAND,2,CARDIFF WALES,GENEVA,3181,3181,0,3213,3213,0,-0.99595
17/03/2020 10:48,2019,2,WESTERN EUROPE-OTHER,SWITZERLAND,2,DUNDEE,ZURICH,0,0,0,4,0,4,-100
17/03/2020 10:48,2019,2,WESTERN EUROPE-OTHER,SWITZERLAND,2,EAST MIDLANDS INTERNATIONAL,BERNE,0,0,0,20,0,20,-100
17/03/2020 10:48,2019,2,WESTERN EUROPE-OTHER,SWITZERLAND,2,EAST MIDLANDS INTERNATIONAL,GENEVA,4373,4373,0,10867,10775,92,-59.7589
17/03/2020 10:48,2019,2,WESTERN EUROPE-OTHER,SWITZERLAND,2,EDINBURGH,BALE MULHOUSE,107857,107857,0,104473,104473,0,3.23911
17/03/2020 10:48,2019,2,WESTERN EUROPE-OTHER,SWITZERLAND,2,EDINBURGH,BERNE,147,0,147,0,0,0,0
17/03/2020 10:48,2019,2,WESTERN EUROPE-OTHER,SWITZERLAND,2,EDINBURGH,GENEVA,193353,189084,4269,188379,183920,4459,2.64042
17/03/2020 10:48,2019,2,WESTERN EUROPE-OTHER,SWITZERLAND,2,EDINBURGH,ZURICH,44311,42911,1400,38054,36187,1867,16.44242
17/03/2020 10:48,2019,2,WESTERN EUROPE-OTHER,SWITZERLAND,2,EXETER,GENEVA,2366,2366,0,2323,2323,0,1.85105
17/03/2020 10:48,2019,2,WESTERN EUROPE-OTHER,SWITZERLAND,2,GLASGOW,BALE MULHOUSE,299,0,299,0,0,0,0
17/03/2020 10:48,2019,2,WESTERN EUROPE-OTHER,SWITZERLAND,2,GLASGOW,BERNE,351,0,351,0,0,0,0
17/03/2020 10:48,2019,2,WESTERN EUROPE-OTHER,SWITZERLAND,2,GLASGOW,GENEVA,16323,16323,0,14960,14960,0,9.11096
17/03/2020 10:48,2019,2,WESTERN EUROPE-OTHER,SWITZERLAND,2,GLASGOW,ZURICH,55,0,55,0,0,0,0
17/03/2020 10:48,2019,2,WESTERN EUROPE-OTHER,SWITZERLAND,2,GUERNSEY,ZURICH,779,779,0,510,510,0,52.7451
17/03/2020 10:48,2019,2,WESTERN EUROPE-OTHER,SWITZERLAND,2,INVERNESS,ZURICH,1918,0,1918,1756,0,1756,9.22551
17/03/2020 10:48,2019,2,WESTERN EUROPE-OTHER,SWITZERLAND,2,ISLE OF MAN,GENEVA,2023,1760,263,2186,338,1848,-7.45654
17/03/2020 10:48,2019,2,WESTERN EUROPE-OTHER,SWITZERLAND,2,ISLE OF MAN,ZURICH,0,0,0,24,0,24,-100
17/03/2020 10:48,2019,2,WESTERN EUROPE-OTHER,SWITZERLAND,2,JERSEY,ALTENRHEIN,300,0,300,0,0,0,0
17/03/2020 10:48,2019,2,WESTERN EUROPE-OTHER,SWITZERLAND,2,JERSEY,BALE MULHOUSE,0,0,0,214,0,214,-100
17/03/2020 10:48,2019,2,WESTERN EUROPE-OTHER,SWITZERLAND,2,JERSEY,BERNE,0,0,0,1225,1225,0,-100
17/03/2020 10:48,2019,2,WESTERN EUROPE-OTHER,SWITZERLAND,2,JERSEY,GENEVA,2115,2115,0,2179,2179,0,-2.93713
17/03/2020 10:48,2019,2,WESTERN EUROPE-OTHER,SWITZERLAND,2,JERSEY,ZURICH,947,947,0,834,747,87,13.54916
17/03/2020 10:48,2019,2,WESTERN EUROPE-OTHER,SWITZERLAND,2,LEEDS BRADFORD,GENEVA,35193,35193,0,31912,31912,0,10.2814
17/03/2020 10:48,2019,2,WESTERN EUROPE-OTHER,SWITZERLAND,2,LIVERPOOL (JOHN LENNON),BERNE,0,0,0,27,0,27,-100
17/03/2020 10:48,2019,2,WESTERN EUROPE-OTHER,SWITZERLAND,2,LIVERPOOL (JOHN LENNON),GENEVA,133415,133415,0,124449,124390,59,7.20456
17/03/2020 10:48,2019,2,WESTERN EUROPE-OTHER,SWITZERLAND,2,LIVERPOOL (JOHN LENNON),SION,171,0,171,0,0,0,0
17/03/2020 10:48,2019,2,WESTERN EUROPE-OTHER,SWITZERLAND,2,MANCHESTER,BALE MULHOUSE,95244,95244,0,97636,96208,1428,-2.44992
17/03/2020 10:48,2019,2,WESTERN EUROPE-OTHER,SWITZERLAND,2,MANCHESTER,BERNE,0,0,0,736,0,736,-100
17/03/2020 10:48,2019,2,WESTERN EUROPE-OTHER,SWITZERLAND,2,MANCHESTER,GENEVA,276134,271050,5084,280917,271694,9223,-1.70264
17/03/2020 10:48,2019,2,WESTERN EUROPE-OTHER,SWITZERLAND,2,MANCHESTER,ZURICH,144644,144644,0,140511,140078,433,2.94141
17/03/2020 10:48,2019,2,WESTERN EUROPE-OTHER,SWITZERLAND,2,NEWCASTLE,GENEVA,56352,56352,0,59330,58937,393,-5.01938
17/03/2020 10:48,2019,2,WESTERN EUROPE-OTHER,SWITZERLAND,2,SOUTHAMPTON,GENEVA,16578,16578,0,19970,19920,50,-16.98548
17/03/2020 10:48,2019,2,WESTERN EUROPE-OTHER,TURKEY,1,GATWICK,ANKARA (ESENBOGA),21791,21791,0,10,0,10,217810
17/03/2020 10:48,2019,2,WESTERN EUROPE-OTHER,TURKEY,1,GATWICK,ANTALYA,331860,246502,85358,318113,239708,78405,4.32142
17/03/2020 10:48,2019,2,WESTERN EUROPE-OTHER,TURKEY,1,GATWICK,BODRUM (MILAS),114243,97470,16773,99937,83915,16022,14.31502
17/03/2020 10:48,2019,2,WESTERN EUROPE-OTHER,TURKEY,1,GATWICK,DALAMAN,359520,283147,76373,339519,281723,57796,5.89098
17/03/2020 10:48,2019,2,WESTERN EUROPE-OTHER,TURKEY,1,GATWICK,ISTANBUL,219243,218471,772,0,0,0,0
17/03/2020 10:48,2019,2,WESTERN EUROPE-OTHER,TURKEY,1,GATWICK,ISTANBUL (SABIHA GOKCEN),77274,77274,0,81237,81237,0,-4.87832
17/03/2020 10:48,2019,2,WESTERN EUROPE-OTHER,TURKEY,1,GATWICK,ISTANBUL ATATURK,4534,4534,0,228777,228777,0,-98.01816
17/03/2020 10:48,2019,2,WESTERN EUROPE-OTHER,TURKEY,1,GATWICK,IZMIR (ADNAN MENDERES),61554,43169,18385,57277,47102,10175,7.46722
17/03/2020 10:48,2019,2,WESTERN EUROPE-OTHER,TURKEY,1,HEATHROW,ANTALYA,423,423,0,0,0,0,0
17/03/2020 10:48,2019,2,WESTERN EUROPE-OTHER,TURKEY,1,HEATHROW,ISTANBUL,1026032,1026032,0,171040,171040,0,499.87839
17/03/2020 10:48,2019,2,WESTERN EUROPE-OTHER,TURKEY,1,HEATHROW,ISTANBUL (SABIHA GOKCEN),0,0,0,151,151,0,-100
17/03/2020 10:48,2019,2,WESTERN EUROPE-OTHER,TURKEY,1,HEATHROW,ISTANBUL ATATURK,45806,45806,0,903357,903357,0,-94.92936
17/03/2020 10:48,2019,2,WESTERN EUROPE-OTHER,TURKEY,1,HEATHROW,IZMIR (ADNAN MENDERES),7373,0,7373,0,0,0,0
17/03/2020 10:48,2019,2,WESTERN EUROPE-OTHER,TURKEY,1,LUTON,ANKARA (ESENBOGA),5001,5001,0,8755,8755,0,-42.87836
17/03/2020 10:48,2019,2,WESTERN EUROPE-OTHER,TURKEY,1,LUTON,ANTALYA,43777,37499,6278,57367,52383,4984,-23.68958
17/03/2020 10:48,2019,2,WESTERN EUROPE-OTHER,TURKEY,1,LUTON,BODRUM (MILAS),31725,31725,0,31078,31078,0,2.08186
17/03/2020 10:48,2019,2,WESTERN EUROPE-OTHER,TURKEY,1,LUTON,DALAMAN,28163,21667,6496,48439,41353,7086,-41.85883
17/03/2020 10:48,2019,2,WESTERN EUROPE-OTHER,TURKEY,1,LUTON,GAZIANTEP,3911,3911,0,2964,2964,0,31.95007
17/03/2020 10:48,2019,2,WESTERN EUROPE-OTHER,TURKEY,1,LUTON,ISTANBUL ATATURK,140,140,0,0,0,0,0
17/03/2020 10:48,2019,2,WESTERN EUROPE-OTHER,TURKEY,1,LUTON,IZMIR (ADNAN MENDERES),11286,11286,0,10010,10010,0,12.74725
17/03/2020 10:48,2019,2,WESTERN EUROPE-OTHER,TURKEY,1,STANSTED,ANKARA (ESENBOGA),313,313,0,0,0,0,0
17/03/2020 10:48,2019,2,WESTERN EUROPE-OTHER,TURKEY,1,STANSTED,ANTALYA,169964,154095,15869,129302,120131,9171,31.44731
17/03/2020 10:48,2019,2,WESTERN EUROPE-OTHER,TURKEY,1,STANSTED,BODRUM (MILAS),54211,54211,0,46285,46285,0,17.12434
17/03/2020 10:48,2019,2,WESTERN EUROPE-OTHER,TURKEY,1,STANSTED,DALAMAN,194321,176029,18292,154140,137127,17013,26.06786
17/03/2020 10:48,2019,2,WESTERN EUROPE-OTHER,TURKEY,1,STANSTED,ISTANBUL,104610,104610,0,0,0,0,0
17/03/2020 10:48,2019,2,WESTERN EUROPE-OTHER,TURKEY,1,STANSTED,ISTANBUL (SABIHA GOKCEN),472590,472590,0,373221,373221,0,26.62471
17/03/2020 10:48,2019,2,WESTERN EUROPE-OTHER,TURKEY,1,STANSTED,ISTANBUL ATATURK,0,0,0,90543,90543,0,-100
17/03/2020 10:48,2019,2,WESTERN EUROPE-OTHER,TURKEY,1,STANSTED,IZMIR (ADNAN MENDERES),75472,75472,0,53043,53043,0,42.28456
17/03/2020 10:48,2019,2,WESTERN EUROPE-OTHER,TURKEY,2,ABERDEEN,DALAMAN,8635,0,8635,7078,0,7078,21.99774
17/03/2020 10:48,2019,2,WESTERN EUROPE-OTHER,TURKEY,2,BELFAST INTERNATIONAL,ANTALYA,27878,17430,10448,19745,8781,10964,41.19017
17/03/2020 10:48,2019,2,WESTERN EUROPE-OTHER,TURKEY,2,BELFAST INTERNATIONAL,DALAMAN,34881,18706,16175,24112,4588,19524,44.66241
17/03/2020 10:48,2019,2,WESTERN EUROPE-OTHER,TURKEY,2,BELFAST INTERNATIONAL,ISTANBUL (SABIHA GOKCEN),74,0,74,0,0,0,0
17/03/2020 10:48,2019,2,WESTERN EUROPE-OTHER,TURKEY,2,BIGGIN HILL,BODRUM (MILAS),6,0,6,3,0,3,100
17/03/2020 10:48,2019,2,WESTERN EUROPE-OTHER,TURKEY,2,BIGGIN HILL,DALAMAN,0,0,0,24,0,24,-100
17/03/2020 10:48,2019,2,WESTERN EUROPE-OTHER,TURKEY,2,BIGGIN HILL,IZMIR (ADNAN MENDERES),9,0,9,0,0,0,0
17/03/2020 10:48,2019,2,WESTERN EUROPE-OTHER,TURKEY,2,BIRMINGHAM,ANTALYA,150649,116083,34566,136462,108534,27928,10.3963
17/03/2020 10:48,2019,2,WESTERN EUROPE-OTHER,TURKEY,2,BIRMINGHAM,BODRUM (MILAS),29434,19699,9735,22955,17868,5087,28.22479
17/03/2020 10:48,2019,2,WESTERN EUROPE-OTHER,TURKEY,2,BIRMINGHAM,DALAMAN,136813,94093,42720,134457,99161,35296,1.75223
17/03/2020 10:48,2019,2,WESTERN EUROPE-OTHER,TURKEY,2,BIRMINGHAM,ISTANBUL,121080,121080,0,0,0,0,0
17/03/2020 10:48,2019,2,WESTERN EUROPE-OTHER,TURKEY,2,BIRMINGHAM,ISTANBUL (SABIHA GOKCEN),204,1,203,0,0,0,0
17/03/2020 10:48,2019,2,WESTERN EUROPE-OTHER,TURKEY,2,BIRMINGHAM,ISTANBUL ATATURK,34676,34676,0,145539,145514,25,-76.17408
17/03/2020 10:48,2019,2,WESTERN EUROPE-OTHER,TURKEY,2,BIRMINGHAM,IZMIR (ADNAN MENDERES),23318,14439,8879,5743,5743,0,306.02473
17/03/2020 10:48,2019,2,WESTERN EUROPE-OTHER,TURKEY,2,BOURNEMOUTH,ANTALYA,5744,0,5744,0,0,0,0
17/03/2020 10:48,2019,2,WESTERN EUROPE-OTHER,TURKEY,2,BOURNEMOUTH,DALAMAN,6083,0,6083,6009,0,6009,1.23149
17/03/2020 10:48,2019,2,WESTERN EUROPE-OTHER,TURKEY,2,BRISTOL,ANTALYA,60299,41289,19010,52019,42517,9502,15.91726
17/03/2020 10:48,2019,2,WESTERN EUROPE-OTHER,TURKEY,2,BRISTOL,BODRUM (MILAS),39968,33665,6303,32133,27287,4846,24.38303
17/03/2020 10:48,2019,2,WESTERN EUROPE-OTHER,TURKEY,2,BRISTOL,DALAMAN,97058,68833,28225,95714,82038,13676,1.40418
17/03/2020 10:48,2019,2,WESTERN EUROPE-OTHER,TURKEY,2,BRISTOL,IZMIR (ADNAN MENDERES),0,0,0,7,7,0,-100
17/03/2020 10:48,2019,2,WESTERN EUROPE-OTHER,TURKEY,2,CARDIFF WALES,ANTALYA,18967,0,18967,16527,0,16527,14.76372
17/03/2020 10:48,2019,2,WESTERN EUROPE-OTHER,TURKEY,2,CARDIFF WALES,DALAMAN,45956,0,45956,41162,0,41162,11.64666
17/03/2020 10:48,2019,2,WESTERN EUROPE-OTHER,TURKEY,2,DONCASTER SHEFFIELD,ANTALYA,9620,175,9445,6022,0,6022,59.74759
17/03/2020 10:48,2019,2,WESTERN EUROPE-OTHER,TURKEY,2,DONCASTER SHEFFIELD,BODRUM (MILAS),9266,0,9266,0,0,0,0
17/03/2020 10:48,2019,2,WESTERN EUROPE-OTHER,TURKEY,2,DONCASTER SHEFFIELD,DALAMAN,15777,0,15777,15255,0,15255,3.42183
17/03/2020 10:48,2019,2,WESTERN EUROPE-OTHER,TURKEY,2,EAST MIDLANDS INTERNATIONAL,ANTALYA,41434,41434,0,41608,32937,8671,-0.41819
17/03/2020 10:48,2019,2,WESTERN EUROPE-OTHER,TURKEY,2,EAST MIDLANDS INTERNATIONAL,BODRUM (MILAS),8502,8351,151,1752,1752,0,385.27397
17/03/2020 10:48,2019,2,WESTERN EUROPE-OTHER,TURKEY,2,EAST MIDLANDS INTERNATIONAL,DALAMAN,71646,56736,14910,53846,45032,8814,33.05724
17/03/2020 10:48,2019,2,WESTERN EUROPE-OTHER,TURKEY,2,EDINBURGH,ANTALYA,25504,25504,0,24494,24494,0,4.12346
17/03/2020 10:48,2019,2,WESTERN EUROPE-OTHER,TURKEY,2,EDINBURGH,BODRUM (MILAS),28971,28971,0,18780,18780,0,54.26518
17/03/2020 10:48,2019,2,WESTERN EUROPE-OTHER,TURKEY,2,EDINBURGH,DALAMAN,55250,39612,15638,41213,32184,9029,34.05964
17/03/2020 10:48,2019,2,WESTERN EUROPE-OTHER,TURKEY,2,EDINBURGH,ISTANBUL,63581,63581,0,129,129,0,49187.5969
17/03/2020 10:48,2019,2,WESTERN EUROPE-OTHER,TURKEY,2,EDINBURGH,ISTANBUL ATATURK,21345,21345,0,85653,85653,0,-75.07968
17/03/2020 10:48,2019,2,WESTERN EUROPE-OTHER,TURKEY,2,EXETER,ANTALYA,2120,0,2120,0,0,0,0
17/03/2020 10:48,2019,2,WESTERN EUROPE-OTHER,TURKEY,2,EXETER,DALAMAN,12195,0,12195,11640,0,11640,4.76804
17/03/2020 10:48,2019,2,WESTERN EUROPE-OTHER,TURKEY,2,GLASGOW,ANTALYA,100622,90212,10410,81873,81808,65,22.9001
17/03/2020 10:48,2019,2,WESTERN EUROPE-OTHER,TURKEY,2,GLASGOW,BODRUM (MILAS),15139,15139,0,8762,8762,0,72.78019
17/03/2020 10:48,2019,2,WESTERN EUROPE-OTHER,TURKEY,2,GLASGOW,DALAMAN,114505,93734,20771,101390,83292,18098,12.9352
17/03/2020 10:48,2019,2,WESTERN EUROPE-OTHER,TURKEY,2,GLASGOW,IZMIR (ADNAN MENDERES),8267,8267,0,0,0,0,0
17/03/2020 10:48,2019,2,WESTERN EUROPE-OTHER,TURKEY,2,LEEDS BRADFORD,ANTALYA,56630,56630,0,60196,60196,0,-5.92398
17/03/2020 10:48,2019,2,WESTERN EUROPE-OTHER,TURKEY,2,LEEDS BRADFORD,BODRUM (MILAS),10168,10168,0,11236,11236,0,-9.50516
17/03/2020 10:48,2019,2,WESTERN EUROPE-OTHER,TURKEY,2,LEEDS BRADFORD,DALAMAN,50562,50562,0,63847,55998,7849,-20.80756
17/03/2020 10:48,2019,2,WESTERN EUROPE-OTHER,TURKEY,2,LEEDS BRADFORD,IZMIR (ADNAN MENDERES),8325,8325,0,0,0,0,0
17/03/2020 10:48,2019,2,WESTERN EUROPE-OTHER,TURKEY,2,LIVERPOOL (JOHN LENNON),BODRUM (MILAS),20645,20645,0,15084,15084,0,36.86688
17/03/2020 10:48,2019,2,WESTERN EUROPE-OTHER,TURKEY,2,LIVERPOOL (JOHN LENNON),DALAMAN,18625,18625,0,8797,8797,0,111.7199
17/03/2020 10:48,2019,2,WESTERN EUROPE-OTHER,TURKEY,2,LIVERPOOL (JOHN LENNON),ISTANBUL,130,0,130,0,0,0,0
17/03/2020 10:48,2019,2,WESTERN EUROPE-OTHER,TURKEY,2,LIVERPOOL (JOHN LENNON),ISTANBUL ATATURK,120,0,120,0,0,0,0
17/03/2020 10:48,2019,2,WESTERN EUROPE-OTHER,TURKEY,2,MANCHESTER,ANTALYA,370929,302279,68650,321923,264947,56976,15.22289
17/03/2020 10:48,2019,2,WESTERN EUROPE-OTHER,TURKEY,2,MANCHESTER,BODRUM (MILAS),81875,66539,15336,72176,56916,15260,13.43798
17/03/2020 10:48,2019,2,WESTERN EUROPE-OTHER,TURKEY,2,MANCHESTER,DALAMAN,393742,320416,73326,354102,302156,51946,11.19451
17/03/2020 10:48,2019,2,WESTERN EUROPE-OTHER,TURKEY,2,MANCHESTER,ISTANBUL,162352,162352,0,39572,39317,255,310.26989
17/03/2020 10:48,2019,2,WESTERN EUROPE-OTHER,TURKEY,2,MANCHESTER,ISTANBUL (SABIHA GOKCEN),62374,62374,0,0,0,0,0
17/03/2020 10:48,2019,2,WESTERN EUROPE-OTHER,TURKEY,2,MANCHESTER,ISTANBUL ATATURK,75464,75464,0,207954,206316,1638,-63.71121
17/03/2020 10:48,2019,2,WESTERN EUROPE-OTHER,TURKEY,2,MANCHESTER,IZMIR (ADNAN MENDERES),68681,51137,17544,49760,31349,18411,38.02452
17/03/2020 10:48,2019,2,WESTERN EUROPE-OTHER,TURKEY,2,NEWCASTLE,ANTALYA,78426,78426,0,75325,75325,0,4.11683
17/03/2020 10:48,2019,2,WESTERN EUROPE-OTHER,TURKEY,2,NEWCASTLE,BODRUM (MILAS),8933,8933,0,19312,19312,0,-53.74379
17/03/2020 10:48,2019,2,WESTERN EUROPE-OTHER,TURKEY,2,NEWCASTLE,DALAMAN,121233,121233,0,110958,110958,0,9.26026
17/03/2020 10:48,2019,2,WESTERN EUROPE-OTHER,TURKEY,2,NEWCASTLE,IZMIR (ADNAN MENDERES),8973,8973,0,0,0,0,0
17/03/2020 10:48,2019,2,WESTERN EUROPE-OTHER,TURKEY,2,NORWICH,DALAMAN,8815,0,8815,11951,9,11942,-26.24048
17/03/2020 10:48,2019,3,EASTERN EUROPE-EU,BULGARIA,1,GATWICK,BURGAS,49916,15250,34666,58192,17527,40665,-14.22189
17/03/2020 10:48,2019,3,EASTERN EUROPE-EU,BULGARIA,1,GATWICK,SOFIA,129163,120486,8677,130427,121139,9288,-0.96912
17/03/2020 10:48,2019,3,EASTERN EUROPE-EU,BULGARIA,1,GATWICK,VARNA,24274,9316,14958,19110,9770,9340,27.0225
17/03/2020 10:48,2019,3,EASTERN EUROPE-EU,BULGARIA,1,HEATHROW,SOFIA,176292,176292,0,169529,169529,0,3.98929
17/03/2020 10:48,2019,3,EASTERN EUROPE-EU,BULGARIA,1,LUTON,BURGAS,98484,98484,0,100230,100011,219,-1.74199
17/03/2020 10:48,2019,3,EASTERN EUROPE-EU,BULGARIA,1,LUTON,SOFIA,333044,332924,120,314654,314654,0,5.84451
17/03/2020 10:48,2019,3,EASTERN EUROPE-EU,BULGARIA,1,LUTON,VARNA,128440,128440,0,106698,106552,146,20.37714
17/03/2020 10:48,2019,3,EASTERN EUROPE-EU,BULGARIA,1,SOUTHEND,SOFIA,9087,9087,0,1391,1391,0,553.27103
17/03/2020 10:48,2019,3,EASTERN EUROPE-EU,BULGARIA,1,STANSTED,BURGAS,20600,14312,6288,8362,0,8362,146.35255
17/03/2020 10:48,2019,3,EASTERN EUROPE-EU,BULGARIA,1,STANSTED,PLOVDIV,57156,57156,0,55813,55813,0,2.40625
17/03/2020 10:48,2019,3,EASTERN EUROPE-EU,BULGARIA,1,STANSTED,SOFIA,273071,272985,86,260817,260817,0,4.69831
17/03/2020 10:48,2019,3,EASTERN EUROPE-EU,BULGARIA,2,ABERDEEN,BURGAS,6576,0,6576,6950,0,6950,-5.38129
17/03/2020 10:48,2019,3,EASTERN EUROPE-EU,BULGARIA,2,BELFAST CITY (GEORGE BEST),VARNA,0,0,0,99,0,99,-100
17/03/2020 10:48,2019,3,EASTERN EUROPE-EU,BULGARIA,2,BELFAST INTERNATIONAL,BURGAS,21158,4940,16218,21589,0,21589,-1.99639
17/03/2020 10:48,2019,3,EASTERN EUROPE-EU,BULGARIA,2,BELFAST INTERNATIONAL,PLOVDIV,5604,0,5604,6491,0,6491,-13.66507
17/03/2020 10:48,2019,3,EASTERN EUROPE-EU,BULGARIA,2,BELFAST INTERNATIONAL,SOFIA,643,0,643,0,0,0,0
17/03/2020 10:48,2019,3,EASTERN EUROPE-EU,BULGARIA,2,BELFAST INTERNATIONAL,VARNA,0,0,0,96,0,96,-100
17/03/2020 10:48,2019,3,EASTERN EUROPE-EU,BULGARIA,2,BIRMINGHAM,BURGAS,56993,28876,28117,43730,15137,28593,30.32929
17/03/2020 10:48,2019,3,EASTERN EUROPE-EU,BULGARIA,2,BIRMINGHAM,SOFIA,60401,56389,4012,60468,56599,3869,-0.1108
17/03/2020 10:48,2019,3,EASTERN EUROPE-EU,BULGARIA,2,BIRMINGHAM,VARNA,0,0,0,5736,5736,0,-100
17/03/2020 10:48,2019,3,EASTERN EUROPE-EU,BULGARIA,2,BRISTOL,BURGAS,26597,6311,20286,27267,6100,21167,-2.45718
17/03/2020 10:48,2019,3,EASTERN EUROPE-EU,BULGARIA,2,BRISTOL,SOFIA,20972,14858,6114,9753,2813,6940,115.03127
17/03/2020 10:48,2019,3,EASTERN EUROPE-EU,BULGARIA,2,BRISTOL,VARNA,0,0,0,70,0,70,-100
17/03/2020 10:48,2019,3,EASTERN EUROPE-EU,BULGARIA,2,CARDIFF WALES,BURGAS,12468,0,12468,20293,0,20293,-38.56009
17/03/2020 10:48,2019,3,EASTERN EUROPE-EU,BULGARIA,2,DONCASTER SHEFFIELD,BURGAS,18901,0,18901,20010,0,20010,-5.54223
17/03/2020 10:48,2019,3,EASTERN EUROPE-EU,BULGARIA,2,EAST MIDLANDS INTERNATIONAL,BURGAS,27934,13740,14194,24004,7082,16922,16.37227
17/03/2020 10:48,2019,3,EASTERN EUROPE-EU,BULGARIA,2,EAST MIDLANDS INTERNATIONAL,SOFIA,3414,0,3414,3276,0,3276,4.21245
17/03/2020 10:48,2019,3,EASTERN EUROPE-EU,BULGARIA,2,EDINBURGH,BURGAS,18141,7446,10695,12372,0,12372,46.62949
17/03/2020 10:48,2019,3,EASTERN EUROPE-EU,BULGARIA,2,EDINBURGH,SOFIA,47378,47230,148,17690,17690,0,167.82363
17/03/2020 10:48,2019,3,EASTERN EUROPE-EU,BULGARIA,2,GLASGOW,BURGAS,29655,14600,15055,24252,7631,16621,22.27857
17/03/2020 10:48,2019,3,EASTERN EUROPE-EU,BULGARIA,2,GLASGOW,SOFIA,0,0,0,29812,29638,174,-100
17/03/2020 10:48,2019,3,EASTERN EUROPE-EU,BULGARIA,2,HUMBERSIDE,BURGAS,10200,0,10200,6127,0,6127,66.47625
17/03/2020 10:48,2019,3,EASTERN EUROPE-EU,BULGARIA,2,LEEDS BRADFORD,BURGAS,16729,11580,5149,12178,0,12178,37.37067
17/03/2020 10:48,2019,3,EASTERN EUROPE-EU,BULGARIA,2,LIVERPOOL (JOHN LENNON),SOFIA,31333,31333,0,36360,36360,0,-13.82563
17/03/2020 10:48,2019,3,EASTERN EUROPE-EU,BULGARIA,2,LIVERPOOL (JOHN LENNON),VARNA,18586,18586,0,0,0,0,0
17/03/2020 10:48,2019,3,EASTERN EUROPE-EU,BULGARIA,2,MANCHESTER,BURGAS,103609,44501,59108,91730,31481,60249,12.94996
17/03/2020 10:48,2019,3,EASTERN EUROPE-EU,BULGARIA,2,MANCHESTER,SOFIA,73786,65445,8341,74817,65154,9663,-1.37803
17/03/2020 10:48,2019,3,EASTERN EUROPE-EU,BULGARIA,2,MANCHESTER,VARNA,21378,7346,14032,21855,7510,14345,-2.18257
17/03/2020 10:48,2019,3,EASTERN EUROPE-EU,BULGARIA,2,NEWCASTLE,BURGAS,37114,37114,0,36544,36544,0,1.55976
17/03/2020 10:48,2019,3,EASTERN EUROPE-EU,BULGARIA,2,NEWCASTLE,SOFIA,3272,3272,0,3181,3181,0,2.86074
17/03/2020 10:48,2019,3,EASTERN EUROPE-EU,BULGARIA,2,NORWICH,BURGAS,4150,0,4150,5133,0,5133,-19.15059
17/03/2020 10:48,2019,3,EASTERN EUROPE-EU,BULGARIA,2,TEESSIDE INTERNATIONAL AIRPORT,BURGAS,5521,0,5521,0,0,0,0
17/03/2020 10:48,2019,3,EASTERN EUROPE-EU,CZECH REPUBLIC,1,GATWICK,PRAGUE,265909,264648,1261,266986,266986,0,-0.40339
17/03/2020 10:48,2019,3,EASTERN EUROPE-EU,CZECH REPUBLIC,1,HEATHROW,PRAGUE,447235,447235,0,443743,443743,0,0.78694
17/03/2020 10:48,2019,3,EASTERN EUROPE-EU,CZECH REPUBLIC,1,LONDON CITY,PRAGUE,43998,43898,100,40730,40723,7,8.02357
17/03/2020 10:48,2019,3,EASTERN EUROPE-EU,CZECH REPUBLIC,1,LUTON,BRNO (TURANY),0,0,0,1083,1083,0,-100
17/03/2020 10:48,2019,3,EASTERN EUROPE-EU,CZECH REPUBLIC,1,LUTON,PRAGUE,133889,133889,0,123629,123629,0,8.29902
17/03/2020 10:48,2019,3,EASTERN EUROPE-EU,CZECH REPUBLIC,1,SOUTHEND,PRAGUE,50334,50334,0,73341,73341,0,-31.3699
17/03/2020 10:48,2019,3,EASTERN EUROPE-EU,CZECH REPUBLIC,1,STANSTED,BRNO (TURANY),112756,112756,0,112158,112158,0,0.53318
17/03/2020 10:48,2019,3,EASTERN EUROPE-EU,CZECH REPUBLIC,1,STANSTED,OSTRAVA,56525,56525,0,59430,59430,0,-4.8881
17/03/2020 10:48,2019,3,EASTERN EUROPE-EU,CZECH REPUBLIC,1,STANSTED,PARDUBICE,23851,23851,0,40857,40857,0,-41.62322
17/03/2020 10:48,2019,3,EASTERN EUROPE-EU,CZECH REPUBLIC,1,STANSTED,PRAGUE,436400,436106,294,407545,407545,0,7.0802
17/03/2020 10:48,2019,3,EASTERN EUROPE-EU,CZECH REPUBLIC,2,BELFAST CITY (GEORGE BEST),PRAGUE,0,0,0,99,0,99,-100
17/03/2020 10:48,2019,3,EASTERN EUROPE-EU,CZECH REPUBLIC,2,BELFAST INTERNATIONAL,PRAGUE,12415,12375,40,5275,5275,0,135.35545
17/03/2020 10:48,2019,3,EASTERN EUROPE-EU,CZECH REPUBLIC,2,BIGGIN HILL,KUNOVICE,3,0,3,6,0,6,-50
17/03/2020 10:48,2019,3,EASTERN EUROPE-EU,CZECH REPUBLIC,2,BIGGIN HILL,PRAGUE,0,0,0,5,0,5,-100
17/03/2020 10:48,2019,3,EASTERN EUROPE-EU,CZECH REPUBLIC,2,BIRMINGHAM,BRNO (TURANY),0,0,0,173,173,0,-100
17/03/2020 10:48,2019,3,EASTERN EUROPE-EU,CZECH REPUBLIC,2,BIRMINGHAM,PRAGUE,99684,99684,0,80354,80354,0,24.05605
17/03/2020 10:48,2019,3,EASTERN EUROPE-EU,CZECH REPUBLIC,2,BOURNEMOUTH,PRAGUE,26283,26283,0,0,0,0,0
17/03/2020 10:48,2019,3,EASTERN EUROPE-EU,CZECH REPUBLIC,2,BRISTOL,PRAGUE,97483,97483,0,92703,92703,0,5.15625
17/03/2020 10:48,2019,3,EASTERN EUROPE-EU,CZECH REPUBLIC,2,CARDIFF WALES,PRAGUE,22,22,0,279,0,279,-92.1147
17/03/2020 10:48,2019,3,EASTERN EUROPE-EU,CZECH REPUBLIC,2,EAST MIDLANDS INTERNATIONAL,PRAGUE,25624,25624,0,24368,24368,0,5.1543
17/03/2020 10:48,2019,3,EASTERN EUROPE-EU,CZECH REPUBLIC,2,EDINBURGH,PRAGUE,146200,146200,0,149496,149496,0,-2.20474
17/03/2020 10:48,2019,3,EASTERN EUROPE-EU,CZECH REPUBLIC,2,GLASGOW,PRAGUE,35345,35250,95,31709,31709,0,11.46678
17/03/2020 10:48,2019,3,EASTERN EUROPE-EU,CZECH REPUBLIC,2,GUERNSEY,PRAGUE,68,0,68,104,0,104,-34.61538
17/03/2020 10:48,2019,3,EASTERN EUROPE-EU,CZECH REPUBLIC,2,JERSEY,PRAGUE,28,28,0,33,0,33,-15.15152
17/03/2020 10:48,2019,3,EASTERN EUROPE-EU,CZECH REPUBLIC,2,LEEDS BRADFORD,PRAGUE,25875,25875,0,25620,25620,0,0.99532
17/03/2020 10:48,2019,3,EASTERN EUROPE-EU,CZECH REPUBLIC,2,LIVERPOOL (JOHN LENNON),PRAGUE,59778,59778,0,74753,74753,0,-20.03264
17/03/2020 10:48,2019,3,EASTERN EUROPE-EU,CZECH REPUBLIC,2,MANCHESTER,PRAGUE,232147,232147,0,189248,189248,0,22.66814
17/03/2020 10:48,2019,3,EASTERN EUROPE-EU,CZECH REPUBLIC,2,NEWCASTLE,PRAGUE,25159,25159,0,26515,26515,0,-5.11409
17/03/2020 10:48,2019,3,EASTERN EUROPE-EU,CZECH REPUBLIC,2,PRESTWICK,PRAGUE,0,0,0,181,0,181,-100
17/03/2020 10:48,2019,3,EASTERN EUROPE-EU,ESTONIA,1,GATWICK,TALLIN,77678,77678,0,52944,52933,11,46.71729
17/03/2020 10:48,2019,3,EASTERN EUROPE-EU,ESTONIA,1,HEATHROW,TALLIN,7800,7800,0,31350,31350,0,-75.11962
17/03/2020 10:48,2019,3,EASTERN EUROPE-EU,ESTONIA,1,LUTON,TALLIN,38986,38986,0,14500,14500,0,168.86897
17/03/2020 10:48,2019,3,EASTERN EUROPE-EU,ESTONIA,1,STANSTED,TALLIN,70457,70457,0,74199,74199,0,-5.04319
17/03/2020 10:48,2019,3,EASTERN EUROPE-EU,ESTONIA,2,CARDIFF WALES,TALLIN,42,0,42,0,0,0,0
17/03/2020 10:48,2019,3,EASTERN EUROPE-EU,ESTONIA,2,EDINBURGH,TALLIN,34981,34981,0,6616,6528,88,428.73337
17/03/2020 10:48,2019,3,EASTERN EUROPE-EU,ESTONIA,2,GLASGOW,TALLIN,113,0,113,0,0,0,0
17/03/2020 10:48,2019,3,EASTERN EUROPE-EU,ESTONIA,2,LIVERPOOL (JOHN LENNON),TALLIN,0,0,0,176,0,176,-100
17/03/2020 10:48,2019,3,EASTERN EUROPE-EU,HUNGARY,1,GATWICK,BUDAPEST,304980,304884,96,174585,173860,725,74.68855
17/03/2020 10:48,2019,3,EASTERN EUROPE-EU,HUNGARY,1,HEATHROW,BUDAPEST,371847,371847,0,363488,363488,0,2.29966
17/03/2020 10:48,2019,3,EASTERN EUROPE-EU,HUNGARY,1,LONDON CITY,BUDAPEST,60892,60892,0,0,0,0,0
17/03/2020 10:48,2019,3,EASTERN EUROPE-EU,HUNGARY,1,LUTON,BUDAPEST,568670,568670,0,564102,564002,100,0.80978
17/03/2020 10:48,2019,3,EASTERN EUROPE-EU,HUNGARY,1,LUTON,DEBRECEN,155170,155170,0,148516,148516,0,4.48033
17/03/2020 10:48,2019,3,EASTERN EUROPE-EU,HUNGARY,1,SOUTHEND,BUDAPEST,12131,12131,0,26779,26779,0,-54.69958
17/03/2020 10:48,2019,3,EASTERN EUROPE-EU,HUNGARY,1,STANSTED,BUDAPEST,440486,440456,30,427179,427131,48,3.11509
17/03/2020 10:48,2019,3,EASTERN EUROPE-EU,HUNGARY,2,BIGGIN HILL,BUDAPEST,12,0,12,0,0,0,0
17/03/2020 10:48,2019,3,EASTERN EUROPE-EU,HUNGARY,2,BIGGIN HILL,DEBRECEN,19,0,19,0,0,0,0
17/03/2020 10:48,2019,3,EASTERN EUROPE-EU,HUNGARY,2,BIRMINGHAM,BUDAPEST,50454,50454,0,46690,46690,0,8.06168
17/03/2020 10:48,2019,3,EASTERN EUROPE-EU,HUNGARY,2,BIRMINGHAM,DEBRECEN,0,0,0,158,158,0,-100
17/03/2020 10:48,2019,3,EASTERN EUROPE-EU,HUNGARY,2,BRISTOL,BUDAPEST,60526,60526,0,55948,55948,0,8.1826
17/03/2020 10:48,2019,3,EASTERN EUROPE-EU,HUNGARY,2,CARDIFF WALES,BUDAPEST,986,0,986,0,0,0,0
17/03/2020 10:48,2019,3,EASTERN EUROPE-EU,HUNGARY,2,CARDIFF WALES,DEBRECEN,326,0,326,0,0,0,0
17/03/2020 10:48,2019,3,EASTERN EUROPE-EU,HUNGARY,2,DONCASTER SHEFFIELD,BUDAPEST,42116,42116,0,6081,6081,0,592.58346
17/03/2020 10:48,2019,3,EASTERN EUROPE-EU,HUNGARY,2,DONCASTER SHEFFIELD,DEBRECEN,33605,33605,0,1469,1469,0,2187.61062
17/03/2020 10:48,2019,3,EASTERN EUROPE-EU,HUNGARY,2,EAST MIDLANDS INTERNATIONAL,BUDAPEST,75149,75149,0,74095,74095,0,1.4225
17/03/2020 10:48,2019,3,EASTERN EUROPE-EU,HUNGARY,2,EDINBURGH,BUDAPEST,102087,102087,0,97099,96925,174,5.13703
17/03/2020 10:48,2019,3,EASTERN EUROPE-EU,HUNGARY,2,GLASGOW,BUDAPEST,36588,36587,1,34361,34331,30,6.48119
17/03/2020 10:48,2019,3,EASTERN EUROPE-EU,HUNGARY,2,HUMBERSIDE,BUDAPEST,68,34,34,92,0,92,-26.08696
17/03/2020 10:48,2019,3,EASTERN EUROPE-EU,HUNGARY,2,LEEDS BRADFORD,BUDAPEST,29179,29179,0,30693,30693,0,-4.93272
17/03/2020 10:48,2019,3,EASTERN EUROPE-EU,HUNGARY,2,LIVERPOOL (JOHN LENNON),BUDAPEST,49263,49175,88,48478,48478,0,1.61929
17/03/2020 10:48,2019,3,EASTERN EUROPE-EU,HUNGARY,2,MANCHESTER,BUDAPEST,198497,198497,0,156532,156315,217,26.80921
17/03/2020 10:48,2019,3,EASTERN EUROPE-EU,LATVIA,1,GATWICK,RIGA,145412,145412,0,140730,140730,0,3.32694
17/03/2020 10:48,2019,3,EASTERN EUROPE-EU,LATVIA,1,LUTON,RIGA,197632,197632,0,205365,205365,0,-3.76549
17/03/2020 10:48,2019,3,EASTERN EUROPE-EU,LATVIA,1,STANSTED,RIGA,260581,260581,0,255325,255325,0,2.05855
17/03/2020 10:48,2019,3,EASTERN EUROPE-EU,LATVIA,2,ABERDEEN,RIGA,10782,10782,0,7252,7252,0,48.67623
17/03/2020 10:48,2019,3,EASTERN EUROPE-EU,LATVIA,2,BIRMINGHAM,RIGA,175,175,0,59,0,59,196.61017
17/03/2020 10:48,2019,3,EASTERN EUROPE-EU,LATVIA,2,DONCASTER SHEFFIELD,RIGA,43937,43937,0,42419,42419,0,3.57859
17/03/2020 10:48,2019,3,EASTERN EUROPE-EU,LATVIA,2,EAST MIDLANDS INTERNATIONAL,RIGA,56766,56766,0,55227,55227,0,2.78668
17/03/2020 10:48,2019,3,EASTERN EUROPE-EU,LATVIA,2,EDINBURGH,RIGA,24026,24026,0,3269,3269,0,634.96482
17/03/2020 10:48,2019,3,EASTERN EUROPE-EU,LATVIA,2,GLASGOW,RIGA,0,0,0,26819,26819,0,-100
17/03/2020 10:48,2019,3,EASTERN EUROPE-EU,LATVIA,2,INVERNESS,RIGA,72,0,72,0,0,0,0
17/03/2020 10:48,2019,3,EASTERN EUROPE-EU,LATVIA,2,LEEDS BRADFORD,RIGA,36662,36662,0,36055,35779,276,1.68354
17/03/2020 10:48,2019,3,EASTERN EUROPE-EU,LATVIA,2,LIVERPOOL (JOHN LENNON),RIGA,0,0,0,7178,7178,0,-100
17/03/2020 10:48,2019,3,EASTERN EUROPE-EU,LATVIA,2,MANCHESTER,RIGA,50244,50244,0,48969,48969,0,2.60369
17/03/2020 10:48,2019,3,EASTERN EUROPE-EU,LATVIA,2,NORWICH,RIGA,0,0,0,45,0,45,-100
17/03/2020 10:48,2019,3,EASTERN EUROPE-EU,LITHUANIA,1,LONDON CITY,VILNIUS,55252,55252,0,0,0,0,0
17/03/2020 10:48,2019,3,EASTERN EUROPE-EU,LITHUANIA,1,LUTON,KAUNAS,237516,237516,0,244636,244636,0,-2.91045
17/03/2020 10:48,2019,3,EASTERN EUROPE-EU,LITHUANIA,1,LUTON,PALANGA,65751,65751,0,61353,61353,0,7.16835
17/03/2020 10:48,2019,3,EASTERN EUROPE-EU,LITHUANIA,1,LUTON,VILNIUS,303279,303279,0,347688,347688,0,-12.77266
17/03/2020 10:48,2019,3,EASTERN EUROPE-EU,LITHUANIA,1,SOUTHEND,VILNIUS,13652,13652,0,0,0,0,0
17/03/2020 10:48,2019,3,EASTERN EUROPE-EU,LITHUANIA,1,STANSTED,KAUNAS,80308,80308,0,93219,93219,0,-13.85018
17/03/2020 10:48,2019,3,EASTERN EUROPE-EU,LITHUANIA,1,STANSTED,PALANGA,38203,38203,0,37626,37626,0,1.53351
17/03/2020 10:48,2019,3,EASTERN EUROPE-EU,LITHUANIA,1,STANSTED,VILNIUS,127909,127909,0,127393,127393,0,0.40505
17/03/2020 10:48,2019,3,EASTERN EUROPE-EU,LITHUANIA,2,BELFAST INTERNATIONAL,VILNIUS,40247,40247,0,36508,36508,0,10.24159
17/03/2020 10:48,2019,3,EASTERN EUROPE-EU,LITHUANIA,2,BIRMINGHAM,VILNIUS,8960,8960,0,35811,35811,0,-74.97975
17/03/2020 10:48,2019,3,EASTERN EUROPE-EU,LITHUANIA,2,BRISTOL,KAUNAS,37960,37960,0,47439,47143,296,-19.98145
17/03/2020 10:48,2019,3,EASTERN EUROPE-EU,LITHUANIA,2,DONCASTER SHEFFIELD,VILNIUS,58793,58793,0,41032,41032,0,43.28573
17/03/2020 10:48,2019,3,EASTERN EUROPE-EU,LITHUANIA,2,EDINBURGH,KAUNAS,28510,28510,0,22288,22288,0,27.91637
17/03/2020 10:48,2019,3,EASTERN EUROPE-EU,LITHUANIA,2,GLASGOW,KAUNAS,0,0,0,122,0,122,-100
17/03/2020 10:48,2019,3,EASTERN EUROPE-EU,LITHUANIA,2,GLASGOW,PALANGA,0,0,0,15025,15025,0,-100
17/03/2020 10:48,2019,3,EASTERN EUROPE-EU,LITHUANIA,2,LEEDS BRADFORD,VILNIUS,30826,30826,0,34789,34789,0,-11.39153
17/03/2020 10:48,2019,3,EASTERN EUROPE-EU,LITHUANIA,2,LIVERPOOL (JOHN LENNON),VILNIUS,37616,37616,0,36813,36813,0,2.18129
17/03/2020 10:48,2019,3,EASTERN EUROPE-EU,POLAND,1,GATWICK,GDANSK,75980,75980,0,0,0,0,0
17/03/2020 10:48,2019,3,EASTERN EUROPE-EU,POLAND,1,GATWICK,KATOWICE,0,0,0,180,180,0,-100
17/03/2020 10:48,2019,3,EASTERN EUROPE-EU,POLAND,1,GATWICK,KRAKOW,164630,163707,923,147233,145543,1690,11.81597
17/03/2020 10:48,2019,3,EASTERN EUROPE-EU,POLAND,1,GATWICK,LODZ LUBLINEK,185,0,185,0,0,0,0
17/03/2020 10:48,2019,3,EASTERN EUROPE-EU,POLAND,1,GATWICK,WARSAW (CHOPIN),15540,15459,81,10637,10637,0,46.09382
17/03/2020 10:48,2019,3,EASTERN EUROPE-EU,POLAND,1,GATWICK,WROCLAW,0,0,0,109,0,109,-100
17/03/2020 10:48,2019,3,EASTERN EUROPE-EU,POLAND,1,HEATHROW,KRAKOW,112086,112086,0,103347,103347,0,8.45598
17/03/2020 10:48,2019,3,EASTERN EUROPE-EU,POLAND,1,HEATHROW,WARSAW (CHOPIN),453361,453361,0,501117,501117,0,-9.52991
17/03/2020 10:48,2019,3,EASTERN EUROPE-EU,POLAND,1,LONDON CITY,WARSAW (CHOPIN),80034,80034,0,0,0,0,0
17/03/2020 10:48,2019,3,EASTERN EUROPE-EU,POLAND,1,LUTON,BYDGOSZCZ,52399,52399,0,62601,62601,0,-16.29686
17/03/2020 10:48,2019,3,EASTERN EUROPE-EU,POLAND,1,LUTON,GDANSK,310034,310034,0,334909,334909,0,-7.42739
17/03/2020 10:48,2019,3,EASTERN EUROPE-EU,POLAND,1,LUTON,KATOWICE,314704,314478,226,374062,374062,0,-15.86849
17/03/2020 10:48,2019,3,EASTERN EUROPE-EU,POLAND,1,LUTON,KRAKOW,254087,254087,0,11133,10725,408,2182.28689
17/03/2020 10:48,2019,3,EASTERN EUROPE-EU,POLAND,1,LUTON,LUBLIN (PORT LOTNICZY),159239,159239,0,122207,122207,0,30.30268
17/03/2020 10:48,2019,3,EASTERN EUROPE-EU,POLAND,1,LUTON,POZNAN,148574,148574,0,169036,169036,0,-12.10511
17/03/2020 10:48,2019,3,EASTERN EUROPE-EU,POLAND,1,LUTON,RZESZOW,55869,55491,378,56169,56169,0,-0.5341
17/03/2020 10:48,2019,3,EASTERN EUROPE-EU,POLAND,1,LUTON,SZCZECIN (GOLENOW),0,0,0,1556,1556,0,-100
17/03/2020 10:48,2019,3,EASTERN EUROPE-EU,POLAND,1,LUTON,SZYMANY (MAZURY),45342,45342,0,41954,41954,0,8.07551
17/03/2020 10:48,2019,3,EASTERN EUROPE-EU,POLAND,1,LUTON,WARSAW (CHOPIN),478730,478730,0,486006,486006,0,-1.4971
17/03/2020 10:48,2019,3,EASTERN EUROPE-EU,POLAND,1,LUTON,WROCLAW,159536,159536,0,150482,150482,0,6.01667
17/03/2020 10:48,2019,3,EASTERN EUROPE-EU,POLAND,1,SOUTHEND,RZESZOW,0,0,0,31,31,0,-100
17/03/2020 10:48,2019,3,EASTERN EUROPE-EU,POLAND,1,STANSTED,BYDGOSZCZ,113362,113362,0,116763,116763,0,-2.91274
17/03/2020 10:48,2019,3,EASTERN EUROPE-EU,POLAND,1,STANSTED,GDANSK,204425,204425,0,201724,201724,0,1.33896
17/03/2020 10:48,2019,3,EASTERN EUROPE-EU,POLAND,1,STANSTED,KATOWICE,127023,127023,0,126864,126864,0,0.12533
17/03/2020 10:48,2019,3,EASTERN EUROPE-EU,POLAND,1,STANSTED,KRAKOW,358577,357128,1449,345191,344079,1112,3.87785
17/03/2020 10:48,2019,3,EASTERN EUROPE-EU,POLAND,1,STANSTED,LODZ LUBLINEK,108519,108379,140,109485,109485,0,-0.88231
17/03/2020 10:48,2019,3,EASTERN EUROPE-EU,POLAND,1,STANSTED,LUBLIN (PORT LOTNICZY),18056,18056,0,73660,73660,0,-75.48737
17/03/2020 10:48,2019,3,EASTERN EUROPE-EU,POLAND,1,STANSTED,POZNAN,161465,161465,0,157453,157453,0,2.54806
17/03/2020 10:48,2019,3,EASTERN EUROPE-EU,POLAND,1,STANSTED,RZESZOW,136334,136334,0,136922,136548,374,-0.42944
17/03/2020 10:48,2019,3,EASTERN EUROPE-EU,POLAND,1,STANSTED,SZCZECIN (GOLENOW),110550,110550,0,109531,109531,0,0.93033
17/03/2020 10:48,2019,3,EASTERN EUROPE-EU,POLAND,1,STANSTED,SZYMANY (MAZURY),49160,49160,0,49781,49781,0,-1.24746
17/03/2020 10:48,2019,3,EASTERN EUROPE-EU,POLAND,1,STANSTED,WARSAW (CHOPIN),140,0,140,485,0,485,-71.13402
17/03/2020 10:48,2019,3,EASTERN EUROPE-EU,POLAND,1,STANSTED,WARSAW (MODLIN MASOVIA),379209,379209,0,417121,417121,0,-9.08897
17/03/2020 10:48,2019,3,EASTERN EUROPE-EU,POLAND,1,STANSTED,WROCLAW,215414,215414,0,210781,210781,0,2.19802
17/03/2020 10:48,2019,3,EASTERN EUROPE-EU,POLAND,2,ABERDEEN,GDANSK,46105,46105,0,35754,35754,0,28.95061
17/03/2020 10:48,2019,3,EASTERN EUROPE-EU,POLAND,2,ABERDEEN,WARSAW (CHOPIN),0,0,0,1852,1852,0,-100
17/03/2020 10:48,2019,3,EASTERN EUROPE-EU,POLAND,2,BELFAST INTERNATIONAL,GDANSK,29604,29604,0,36076,36076,0,-17.9399
17/03/2020 10:48,2019,3,EASTERN EUROPE-EU,POLAND,2,BELFAST INTERNATIONAL,KATOWICE,0,0,0,76,0,76,-100
17/03/2020 10:48,2019,3,EASTERN EUROPE-EU,POLAND,2,BELFAST INTERNATIONAL,KRAKOW,100320,99969,351,101755,101755,0,-1.41025
17/03/2020 10:48,2019,3,EASTERN EUROPE-EU,POLAND,2,BELFAST INTERNATIONAL,WARSAW (MODLIN MASOVIA),23894,23894,0,35146,35146,0,-32.01502
17/03/2020 10:48,2019,3,EASTERN EUROPE-EU,POLAND,2,BELFAST INTERNATIONAL,WROCLAW,29713,29713,0,35109,35109,0,-15.36928
17/03/2020 10:48,2019,3,EASTERN EUROPE-EU,POLAND,2,BIGGIN HILL,KRAKOW,19,0,19,5,0,5,280
17/03/2020 10:48,2019,3,EASTERN EUROPE-EU,POLAND,2,BIGGIN HILL,WARSAW (CHOPIN),13,0,13,2,0,2,550
17/03/2020 10:48,2019,3,EASTERN EUROPE-EU,POLAND,2,BIRMINGHAM,BYDGOSZCZ,56320,56320,0,55203,55203,0,2.02344
17/03/2020 10:48,2019,3,EASTERN EUROPE-EU,POLAND,2,BIRMINGHAM,GDANSK,37819,37819,0,38267,38267,0,-1.17072
17/03/2020 10:48,2019,3,EASTERN EUROPE-EU,POLAND,2,BIRMINGHAM,KATOWICE,37591,37591,0,36975,36975,0,1.66599
17/03/2020 10:48,2019,3,EASTERN EUROPE-EU,POLAND,2,BIRMINGHAM,KRAKOW,104803,103916,887,70687,69440,1247,48.26347
17/03/2020 10:48,2019,3,EASTERN EUROPE-EU,POLAND,2,BIRMINGHAM,POZNAN,10029,10029,0,32970,32970,0,-69.58144
17/03/2020 10:48,2019,3,EASTERN EUROPE-EU,POLAND,2,BIRMINGHAM,RZESZOW,377,377,0,184,184,0,104.8913
17/03/2020 10:48,2019,3,EASTERN EUROPE-EU,POLAND,2,BIRMINGHAM,WARSAW (CHOPIN),45303,45303,0,48553,48553,0,-6.69372
17/03/2020 10:48,2019,3,EASTERN EUROPE-EU,POLAND,2,BIRMINGHAM,WARSAW (MODLIN MASOVIA),51481,51481,0,53474,53474,0,-3.72704
17/03/2020 10:48,2019,3,EASTERN EUROPE-EU,POLAND,2,BIRMINGHAM,WROCLAW,32481,32481,0,32075,32075,0,1.26578
17/03/2020 10:48,2019,3,EASTERN EUROPE-EU,POLAND,2,BOURNEMOUTH,GDANSK,143,0,143,0,0,0,0
17/03/2020 10:48,2019,3,EASTERN EUROPE-EU,POLAND,2,BOURNEMOUTH,KRAKOW,37707,37707,0,35840,35840,0,5.20926
17/03/2020 10:48,2019,3,EASTERN EUROPE-EU,POLAND,2,BRISTOL,GDANSK,38382,38250,132,43515,43515,0,-11.79593
17/03/2020 10:48,2019,3,EASTERN EUROPE-EU,POLAND,2,BRISTOL,KATOWICE,50474,50474,0,42941,42941,0,17.54267
17/03/2020 10:48,2019,3,EASTERN EUROPE-EU,POLAND,2,BRISTOL,KRAKOW,131605,131605,0,128506,128506,0,2.41156
17/03/2020 10:48,2019,3,EASTERN EUROPE-EU,POLAND,2,BRISTOL,POZNAN,44445,44301,144,40674,40629,45,9.27128
17/03/2020 10:48,2019,3,EASTERN EUROPE-EU,POLAND,2,BRISTOL,RZESZOW,37009,37009,0,35583,35583,0,4.00753
17/03/2020 10:48,2019,3,EASTERN EUROPE-EU,POLAND,2,BRISTOL,WARSAW (MODLIN MASOVIA),75522,75522,0,71276,71276,0,5.95712
17/03/2020 10:48,2019,3,EASTERN EUROPE-EU,POLAND,2,BRISTOL,WROCLAW,38010,38010,0,38378,38378,0,-0.95888
17/03/2020 10:48,2019,3,EASTERN EUROPE-EU,POLAND,2,CARDIFF WALES,KRAKOW,375,0,375,376,0,376,-0.26596
17/03/2020 10:48,2019,3,EASTERN EUROPE-EU,POLAND,2,CARDIFF WALES,POZNAN,0,0,0,182,182,0,-100
17/03/2020 10:48,2019,3,EASTERN EUROPE-EU,POLAND,2,CARDIFF WALES,WROCLAW,0,0,0,54,0,54,-100
17/03/2020 10:48,2019,3,EASTERN EUROPE-EU,POLAND,2,DONCASTER SHEFFIELD,GDANSK,80842,80842,0,73443,73443,0,10.07448
17/03/2020 10:48,2019,3,EASTERN EUROPE-EU,POLAND,2,DONCASTER SHEFFIELD,KATOWICE,82279,82279,0,81381,81381,0,1.10345
17/03/2020 10:48,2019,3,EASTERN EUROPE-EU,POLAND,2,DONCASTER SHEFFIELD,KRAKOW,39345,39345,0,0,0,0,0
17/03/2020 10:48,2019,3,EASTERN EUROPE-EU,POLAND,2,DONCASTER SHEFFIELD,LUBLIN (PORT LOTNICZY),0,0,0,17428,17428,0,-100
17/03/2020 10:48,2019,3,EASTERN EUROPE-EU,POLAND,2,DONCASTER SHEFFIELD,POZNAN,54514,54514,0,50519,50519,0,7.90792
17/03/2020 10:48,2019,3,EASTERN EUROPE-EU,POLAND,2,DONCASTER SHEFFIELD,WARSAW (CHOPIN),67711,67711,0,68754,68754,0,-1.517
17/03/2020 10:48,2019,3,EASTERN EUROPE-EU,POLAND,2,DONCASTER SHEFFIELD,WROCLAW,35194,35194,0,35692,35692,0,-1.39527
17/03/2020 10:48,2019,3,EASTERN EUROPE-EU,POLAND,2,EAST MIDLANDS INTERNATIONAL,KATOWICE,0,0,0,172,172,0,-100
17/03/2020 10:48,2019,3,EASTERN EUROPE-EU,POLAND,2,EAST MIDLANDS INTERNATIONAL,KRAKOW,57637,57227,410,56924,56498,426,1.25255
17/03/2020 10:48,2019,3,EASTERN EUROPE-EU,POLAND,2,EAST MIDLANDS INTERNATIONAL,LODZ LUBLINEK,37810,37810,0,37114,37114,0,1.8753
17/03/2020 10:48,2019,3,EASTERN EUROPE-EU,POLAND,2,EAST MIDLANDS INTERNATIONAL,RZESZOW,55505,55505,0,55310,55310,0,0.35256
17/03/2020 10:48,2019,3,EASTERN EUROPE-EU,POLAND,2,EAST MIDLANDS INTERNATIONAL,WARSAW (MODLIN MASOVIA),43012,43012,0,54340,54340,0,-20.84652
17/03/2020 10:48,2019,3,EASTERN EUROPE-EU,POLAND,2,EAST MIDLANDS INTERNATIONAL,WROCLAW,74358,74358,0,85587,85587,0,-13.11998
17/03/2020 10:48,2019,3,EASTERN EUROPE-EU,POLAND,2,EDINBURGH,GDANSK,66508,66508,0,56317,56317,0,18.09578
17/03/2020 10:48,2019,3,EASTERN EUROPE-EU,POLAND,2,EDINBURGH,KATOWICE,37919,37919,0,36308,36308,0,4.43704
17/03/2020 10:48,2019,3,EASTERN EUROPE-EU,POLAND,2,EDINBURGH,KRAKOW,146918,146454,464,132049,131581,468,11.26021
17/03/2020 10:48,2019,3,EASTERN EUROPE-EU,POLAND,2,EDINBURGH,POZNAN,38641,38641,0,37569,37402,167,2.85342
17/03/2020 10:48,2019,3,EASTERN EUROPE-EU,POLAND,2,EDINBURGH,SZCZECIN (GOLENOW),0,0,0,19761,19761,0,-100
17/03/2020 10:48,2019,3,EASTERN EUROPE-EU,POLAND,2,EDINBURGH,WARSAW (CHOPIN),3073,3054,19,0,0,0,0
17/03/2020 10:48,2019,3,EASTERN EUROPE-EU,POLAND,2,EDINBURGH,WARSAW (MODLIN MASOVIA),80911,80911,0,54934,54934,0,47.28765
17/03/2020 10:48,2019,3,EASTERN EUROPE-EU,POLAND,2,EDINBURGH,WROCLAW,38463,38463,0,36513,36513,0,5.34056
17/03/2020 10:48,2019,3,EASTERN EUROPE-EU,POLAND,2,EXETER,KRAKOW,434,0,434,422,0,422,2.8436
17/03/2020 10:48,2019,3,EASTERN EUROPE-EU,POLAND,2,GLASGOW,BYDGOSZCZ,0,0,0,16641,16641,0,-100
17/03/2020 10:48,2019,3,EASTERN EUROPE-EU,POLAND,2,GLASGOW,GDANSK,0,0,0,1490,1426,64,-100
17/03/2020 10:48,2019,3,EASTERN EUROPE-EU,POLAND,2,GLASGOW,KATOWICE,18373,18373,0,34283,34221,62,-46.40784
17/03/2020 10:48,2019,3,EASTERN EUROPE-EU,POLAND,2,GLASGOW,KRAKOW,40352,39887,465,36564,35937,627,10.35992
17/03/2020 10:48,2019,3,EASTERN EUROPE-EU,POLAND,2,GLASGOW,WARSAW (CHOPIN),477,0,477,0,0,0,0
17/03/2020 10:48,2019,3,EASTERN EUROPE-EU,POLAND,2,GLASGOW,WARSAW (MODLIN MASOVIA),28917,28178,739,40116,40116,0,-27.91654
17/03/2020 10:48,2019,3,EASTERN EUROPE-EU,POLAND,2,GLASGOW,WROCLAW,37360,37360,0,37015,37015,0,0.93205
17/03/2020 10:48,2019,3,EASTERN EUROPE-EU,POLAND,2,LEEDS BRADFORD,GDANSK,64021,64021,0,65182,65182,0,-1.78117
17/03/2020 10:48,2019,3,EASTERN EUROPE-EU,POLAND,2,LEEDS BRADFORD,KRAKOW,101940,101940,0,78726,78267,459,29.48708
17/03/2020 10:48,2019,3,EASTERN EUROPE-EU,POLAND,2,LEEDS BRADFORD,WARSAW (MODLIN MASOVIA),35854,35854,0,35811,35811,0,0.12007
17/03/2020 10:48,2019,3,EASTERN EUROPE-EU,POLAND,2,LEEDS BRADFORD,WROCLAW,35704,35704,0,34519,34519,0,3.43289
17/03/2020 10:48,2019,3,EASTERN EUROPE-EU,POLAND,2,LIVERPOOL (JOHN LENNON),GDANSK,64411,64411,0,56055,56055,0,14.90679
17/03/2020 10:48,2019,3,EASTERN EUROPE-EU,POLAND,2,LIVERPOOL (JOHN LENNON),KATOWICE,41804,41804,0,38867,38867,0,7.55654
17/03/2020 10:48,2019,3,EASTERN EUROPE-EU,POLAND,2,LIVERPOOL (JOHN LENNON),KRAKOW,109542,109542,0,102975,102975,0,6.37728
17/03/2020 10:48,2019,3,EASTERN EUROPE-EU,POLAND,2,LIVERPOOL (JOHN LENNON),LUBLIN (PORT LOTNICZY),0,0,0,14718,14718,0,-100
17/03/2020 10:48,2019,3,EASTERN EUROPE-EU,POLAND,2,LIVERPOOL (JOHN LENNON),POZNAN,36632,36632,0,36137,36137,0,1.36979
17/03/2020 10:48,2019,3,EASTERN EUROPE-EU,POLAND,2,LIVERPOOL (JOHN LENNON),SZCZECIN (GOLENOW),36120,36120,0,35675,35675,0,1.24737
17/03/2020 10:48,2019,3,EASTERN EUROPE-EU,POLAND,2,LIVERPOOL (JOHN LENNON),WARSAW (CHOPIN),54365,54365,0,45505,45505,0,19.47039
17/03/2020 10:48,2019,3,EASTERN EUROPE-EU,POLAND,2,LIVERPOOL (JOHN LENNON),WARSAW (MODLIN MASOVIA),58955,58955,0,70915,70915,0,-16.86526
17/03/2020 10:48,2019,3,EASTERN EUROPE-EU,POLAND,2,LIVERPOOL (JOHN LENNON),WROCLAW,37088,37088,0,48258,48258,0,-23.14642
17/03/2020 10:48,2019,3,EASTERN EUROPE-EU,POLAND,2,MANCHESTER,GDANSK,48973,48973,0,48337,48337,0,1.31576
17/03/2020 10:48,2019,3,EASTERN EUROPE-EU,POLAND,2,MANCHESTER,KATOWICE,9796,9796,0,0,0,0,0
17/03/2020 10:48,2019,3,EASTERN EUROPE-EU,POLAND,2,MANCHESTER,KRAKOW,208686,208018,668,166889,166457,432,25.04479
17/03/2020 10:48,2019,3,EASTERN EUROPE-EU,POLAND,2,MANCHESTER,RZESZOW,38757,38757,0,37789,37789,0,2.56159
17/03/2020 10:48,2019,3,EASTERN EUROPE-EU,POLAND,2,MANCHESTER,WARSAW (CHOPIN),140,0,140,0,0,0,0
17/03/2020 10:48,2019,3,EASTERN EUROPE-EU,POLAND,2,MANCHESTER,WARSAW (MODLIN MASOVIA),52922,52922,0,53955,53955,0,-1.91456
17/03/2020 10:48,2019,3,EASTERN EUROPE-EU,POLAND,2,MANCHESTER,WROCLAW,47978,47978,0,47078,47078,0,1.91172
17/03/2020 10:48,2019,3,EASTERN EUROPE-EU,POLAND,2,NEWCASTLE,GDANSK,20276,20276,0,20521,20521,0,-1.1939
17/03/2020 10:48,2019,3,EASTERN EUROPE-EU,POLAND,2,NEWCASTLE,KRAKOW,36256,36256,0,28454,28454,0,27.41969
17/03/2020 10:48,2019,3,EASTERN EUROPE-EU,POLAND,2,NEWCASTLE,WARSAW (MODLIN MASOVIA),8001,8001,0,33304,33304,0,-75.97586
17/03/2020 10:48,2019,3,EASTERN EUROPE-EU,POLAND,2,NEWCASTLE,WROCLAW,36489,36489,0,33151,33151,0,10.06908
17/03/2020 10:48,2019,3,EASTERN EUROPE-EU,POLAND,2,PRESTWICK,BYDGOSZCZ,21283,21283,0,0,0,0,0
17/03/2020 10:48,2019,3,EASTERN EUROPE-EU,POLAND,2,PRESTWICK,GDANSK,0,0,0,181,0,181,-100
17/03/2020 10:48,2019,3,EASTERN EUROPE-EU,POLAND,2,PRESTWICK,POZNAN,0,0,0,122,0,122,-100
17/03/2020 10:48,2019,3,EASTERN EUROPE-EU,POLAND,2,PRESTWICK,RZESZOW,8697,8697,0,34175,34175,0,-74.55157
17/03/2020 10:48,2019,3,EASTERN EUROPE-EU,POLAND,2,PRESTWICK,WROCLAW,0,0,0,184,0,184,-100
17/03/2020 10:48,2019,3,EASTERN EUROPE-EU,ROMANIA,1,GATWICK,BUCHAREST (OTOPENI),150745,150745,0,141129,141129,0,6.81362
17/03/2020 10:48,2019,3,EASTERN EUROPE-EU,ROMANIA,1,GATWICK,CLUJ NAPOCA,82336,82336,0,0,0,0,0
17/03/2020 10:48,2019,3,EASTERN EUROPE-EU,ROMANIA,1,HEATHROW,BUCHAREST (OTOPENI),267255,267255,0,257371,257371,0,3.84037
17/03/2020 10:48,2019,3,EASTERN EUROPE-EU,ROMANIA,1,LUTON,BACAU,100392,100392,0,97302,97302,0,3.17568
17/03/2020 10:48,2019,3,EASTERN EUROPE-EU,ROMANIA,1,LUTON,BUCHAREST (OTOPENI),677876,677876,0,635685,635685,0,6.63709
17/03/2020 10:48,2019,3,EASTERN EUROPE-EU,ROMANIA,1,LUTON,CLUJ NAPOCA,280134,280134,0,315630,315630,0,-11.24608
17/03/2020 10:48,2019,3,EASTERN EUROPE-EU,ROMANIA,1,LUTON,CONSTANTA,74300,74300,0,60421,60421,0,22.97049
17/03/2020 10:48,2019,3,EASTERN EUROPE-EU,ROMANIA,1,LUTON,CRAIOVA,143578,143578,0,121250,121250,0,18.41485
17/03/2020 10:48,2019,3,EASTERN EUROPE-EU,ROMANIA,1,LUTON,IASI,202567,202567,0,211843,211843,0,-4.37871
17/03/2020 10:48,2019,3,EASTERN EUROPE-EU,ROMANIA,1,LUTON,SATU MARE,52918,52918,0,38649,38649,0,36.91945
17/03/2020 10:48,2019,3,EASTERN EUROPE-EU,ROMANIA,1,LUTON,SIBIU,103577,103577,0,97885,97885,0,5.81499
17/03/2020 10:48,2019,3,EASTERN EUROPE-EU,ROMANIA,1,LUTON,SUCEAVA,159865,159865,0,124144,124144,0,28.77384
17/03/2020 10:48,2019,3,EASTERN EUROPE-EU,ROMANIA,1,LUTON,TIMISOARA,146661,146661,0,121180,121180,0,21.0274
17/03/2020 10:48,2019,3,EASTERN EUROPE-EU,ROMANIA,1,LUTON,TIRGU MURES,51171,51171,0,17626,17626,0,190.31544
17/03/2020 10:48,2019,3,EASTERN EUROPE-EU,ROMANIA,1,SOUTHEND,BUCHAREST (OTOPENI),21861,21861,0,0,0,0,0
17/03/2020 10:48,2019,3,EASTERN EUROPE-EU,ROMANIA,1,SOUTHEND,CLUJ NAPOCA,26726,26726,0,0,0,0,0
17/03/2020 10:48,2019,3,EASTERN EUROPE-EU,ROMANIA,1,SOUTHEND,SIBIU,17371,17371,0,0,0,0,0
17/03/2020 10:48,2019,3,EASTERN EUROPE-EU,ROMANIA,1,STANSTED,BACAU,0,0,0,152,152,0,-100
17/03/2020 10:48,2019,3,EASTERN EUROPE-EU,ROMANIA,1,STANSTED,BUCHAREST (OTOPENI),257972,257972,0,231838,231838,0,11.27253
17/03/2020 10:48,2019,3,EASTERN EUROPE-EU,ROMANIA,1,STANSTED,ORADEA,0,0,0,21496,21496,0,-100
17/03/2020 10:48,2019,3,EASTERN EUROPE-EU,ROMANIA,1,STANSTED,TIMISOARA,0,0,0,27198,27198,0,-100
17/03/2020 10:48,2019,3,EASTERN EUROPE-EU,ROMANIA,2,BIGGIN HILL,BUCHAREST (BANEASA),18,0,18,0,0,0,0
17/03/2020 10:48,2019,3,EASTERN EUROPE-EU,ROMANIA,2,BIGGIN HILL,BUCHAREST (OTOPENI),4,0,4,0,0,0,0
17/03/2020 10:48,2019,3,EASTERN EUROPE-EU,ROMANIA,2,BIGGIN HILL,CLUJ NAPOCA,0,0,0,6,0,6,-100
17/03/2020 10:48,2019,3,EASTERN EUROPE-EU,ROMANIA,2,BIRMINGHAM,BUCHAREST (OTOPENI),125565,125565,0,103222,103222,0,21.64558
17/03/2020 10:48,2019,3,EASTERN EUROPE-EU,ROMANIA,2,BIRMINGHAM,CLUJ NAPOCA,33377,33377,0,14275,14275,0,133.81436
17/03/2020 10:48,2019,3,EASTERN EUROPE-EU,ROMANIA,2,BIRMINGHAM,TIMISOARA,0,0,0,246,0,246,-100
17/03/2020 10:48,2019,3,EASTERN EUROPE-EU,ROMANIA,2,BOURNEMOUTH,CLUJ NAPOCA,164,0,164,0,0,0,0
17/03/2020 10:48,2019,3,EASTERN EUROPE-EU,ROMANIA,2,BRISTOL,BUCHAREST (OTOPENI),35338,35338,0,37622,37622,0,-6.07092
17/03/2020 10:48,2019,3,EASTERN EUROPE-EU,ROMANIA,2,DONCASTER SHEFFIELD,BUCHAREST (OTOPENI),96612,96612,0,63575,63575,0,51.9654
17/03/2020 10:48,2019,3,EASTERN EUROPE-EU,ROMANIA,2,DONCASTER SHEFFIELD,CLUJ NAPOCA,42165,42165,0,36032,36032,0,17.02098
17/03/2020 10:48,2019,3,EASTERN EUROPE-EU,ROMANIA,2,DONCASTER SHEFFIELD,TIMISOARA,13555,13555,0,0,0,0,0
17/03/2020 10:48,2019,3,EASTERN EUROPE-EU,ROMANIA,2,EDINBURGH,BUCHAREST (OTOPENI),8884,8884,0,0,0,0,0
17/03/2020 10:48,2019,3,EASTERN EUROPE-EU,ROMANIA,2,EXETER,CONSTANTA,175,0,175,0,0,0,0
17/03/2020 10:48,2019,3,EASTERN EUROPE-EU,ROMANIA,2,GLASGOW,BUCHAREST (OTOPENI),46652,46652,0,44484,44484,0,4.87366
17/03/2020 10:48,2019,3,EASTERN EUROPE-EU,ROMANIA,2,GLASGOW,CLUJ NAPOCA,938,0,938,0,0,0,0
17/03/2020 10:48,2019,3,EASTERN EUROPE-EU,ROMANIA,2,LIVERPOOL (JOHN LENNON),BACAU,29004,29004,0,27869,27869,0,4.07263
17/03/2020 10:48,2019,3,EASTERN EUROPE-EU,ROMANIA,2,LIVERPOOL (JOHN LENNON),BUCHAREST (OTOPENI),106581,106581,0,68304,68304,0,56.03918
17/03/2020 10:48,2019,3,EASTERN EUROPE-EU,ROMANIA,2,LIVERPOOL (JOHN LENNON),CLUJ NAPOCA,32036,32036,0,26791,26791,0,19.57747
17/03/2020 10:48,2019,3,EASTERN EUROPE-EU,ROMANIA,2,LIVERPOOL (JOHN LENNON),IASI,34407,34407,0,5173,5173,0,565.12662
17/03/2020 10:48,2019,3,EASTERN EUROPE-EU,ROMANIA,2,MANCHESTER,BACAU,214,214,0,0,0,0,0
17/03/2020 10:48,2019,3,EASTERN EUROPE-EU,ROMANIA,2,MANCHESTER,BUCHAREST (OTOPENI),0,0,0,512,186,326,-100
17/03/2020 10:48,2019,3,EASTERN EUROPE-EU,SLOVAK REPUBLIC,1,GATWICK,BRATISLAVA,0,0,0,7,0,7,-100
17/03/2020 10:48,2019,3,EASTERN EUROPE-EU,SLOVAK REPUBLIC,1,LUTON,BRATISLAVA,114364,114364,0,91211,91211,0,25.384
17/03/2020 10:48,2019,3,EASTERN EUROPE-EU,SLOVAK REPUBLIC,1,LUTON,KOSICE,149795,149795,0,140134,140134,0,6.89412
17/03/2020 10:48,2019,3,EASTERN EUROPE-EU,SLOVAK REPUBLIC,1,LUTON,TATRY-POPRAD,55976,55976,0,60820,60820,0,-7.96449
17/03/2020 10:48,2019,3,EASTERN EUROPE-EU,SLOVAK REPUBLIC,1,SOUTHEND,KOSICE,27669,27669,0,0,0,0,0
17/03/2020 10:48,2019,3,EASTERN EUROPE-EU,SLOVAK REPUBLIC,1,STANSTED,BRATISLAVA,196608,196608,0,216383,216383,0,-9.13889
17/03/2020 10:48,2019,3,EASTERN EUROPE-EU,SLOVAK REPUBLIC,2,BIGGIN HILL,BRATISLAVA,57,0,57,22,0,22,159.09091
17/03/2020 10:48,2019,3,EASTERN EUROPE-EU,SLOVAK REPUBLIC,2,BIRMINGHAM,BRATISLAVA,61048,56189,4859,54994,54994,0,11.00847
17/03/2020 10:48,2019,3,EASTERN EUROPE-EU,SLOVAK REPUBLIC,2,CARDIFF WALES,BRATISLAVA,756,0,756,0,0,0,0
17/03/2020 10:48,2019,3,EASTERN EUROPE-EU,SLOVAK REPUBLIC,2,DONCASTER SHEFFIELD,KOSICE,0,0,0,16584,16584,0,-100
17/03/2020 10:48,2019,3,EASTERN EUROPE-EU,SLOVAK REPUBLIC,2,EAST MIDLANDS INTERNATIONAL,BRATISLAVA,160,0,160,294,0,294,-45.57823
17/03/2020 10:48,2019,3,EASTERN EUROPE-EU,SLOVAK REPUBLIC,2,EDINBURGH,BRATISLAVA,37149,37070,79,36267,35903,364,2.43196
17/03/2020 10:48,2019,3,EASTERN EUROPE-EU,SLOVAK REPUBLIC,2,GLASGOW,BRATISLAVA,0,0,0,1751,0,1751,-100
17/03/2020 10:48,2019,3,EASTERN EUROPE-EU,SLOVAK REPUBLIC,2,LEEDS BRADFORD,BRATISLAVA,35288,35288,0,35226,35226,0,0.17601
17/03/2020 10:48,2019,3,EASTERN EUROPE-EU,SLOVAK REPUBLIC,2,LIVERPOOL (JOHN LENNON),BRATISLAVA,310,310,0,0,0,0,0
17/03/2020 10:48,2019,3,EASTERN EUROPE-EU,SLOVAK REPUBLIC,2,MANCHESTER,BRATISLAVA,54203,54203,0,54966,54966,0,-1.38813
17/03/2020 10:48,2019,4,EASTERN EUROPE -OTHER,ALBANIA,1,GATWICK,TIRANA,106224,105866,358,104290,97969,6321,1.85444
17/03/2020 10:48,2019,4,EASTERN EUROPE -OTHER,ALBANIA,1,LUTON,TIRANA,101617,101617,0,43205,43205,0,135.19732
17/03/2020 10:48,2019,4,EASTERN EUROPE -OTHER,ALBANIA,1,STANSTED,TIRANA,15547,15420,127,853,0,853,1722.62603
17/03/2020 10:48,2019,4,EASTERN EUROPE -OTHER,ALBANIA,2,BELFAST CITY (GEORGE BEST),TIRANA,0,0,0,47,0,47,-100
17/03/2020 10:48,2019,4,EASTERN EUROPE -OTHER,ALBANIA,2,CARDIFF WALES,TIRANA,0,0,0,176,0,176,-100
17/03/2020 10:48,2019,4,EASTERN EUROPE -OTHER,ALBANIA,2,EDINBURGH,TIRANA,0,0,0,77,0,77,-100
17/03/2020 10:48,2019,4,EASTERN EUROPE -OTHER,ALBANIA,2,GLASGOW,TIRANA,0,0,0,141,0,141,-100
17/03/2020 10:48,2019,4,EASTERN EUROPE -OTHER,ALBANIA,2,MANCHESTER,TIRANA,0,0,0,124,124,0,-100
17/03/2020 10:48,2019,4,EASTERN EUROPE -OTHER,ARMENIA,2,BIRMINGHAM,YEREVAN,96,0,96,0,0,0,0
17/03/2020 10:48,2019,4,EASTERN EUROPE -OTHER,ARMENIA,2,GLASGOW,YEREVAN,0,0,0,100,0,100,-100
17/03/2020 10:48,2019,4,EASTERN EUROPE -OTHER,AZERBAIJAN,1,GATWICK,BAKU (HEYDER ALIYEV INT'L),241,0,241,234,0,234,2.99145
17/03/2020 10:48,2019,4,EASTERN EUROPE -OTHER,AZERBAIJAN,1,HEATHROW,BAKU (HEYDER ALIYEV INT'L),38709,38709,0,38815,38815,0,-0.27309
17/03/2020 10:48,2019,4,EASTERN EUROPE -OTHER,AZERBAIJAN,1,LUTON,BAKU (HEYDER ALIYEV INT'L),2130,0,2130,1219,0,1219,74.73339
17/03/2020 10:48,2019,4,EASTERN EUROPE -OTHER,AZERBAIJAN,1,STANSTED,BAKU (HEYDER ALIYEV INT'L),1154,0,1154,0,0,0,0
17/03/2020 10:48,2019,4,EASTERN EUROPE -OTHER,AZERBAIJAN,2,BELFAST INTERNATIONAL,BAKU (HEYDER ALIYEV INT'L),68,0,68,0,0,0,0
17/03/2020 10:48,2019,4,EASTERN EUROPE -OTHER,AZERBAIJAN,2,BIGGIN HILL,BAKU (HEYDER ALIYEV INT'L),1,0,1,0,0,0,0
17/03/2020 10:48,2019,4,EASTERN EUROPE -OTHER,AZERBAIJAN,2,CARDIFF WALES,BAKU (HEYDER ALIYEV INT'L),688,0,688,0,0,0,0
17/03/2020 10:48,2019,4,EASTERN EUROPE -OTHER,BELARUS,1,GATWICK,MINSK INT'L ,34255,34255,0,31898,31568,330,7.38918
17/03/2020 10:48,2019,4,EASTERN EUROPE -OTHER,BELARUS,1,LUTON,MINSK INT'L ,77,0,77,0,0,0,0
17/03/2020 10:48,2019,4,EASTERN EUROPE -OTHER,BELARUS,2,BELFAST INTERNATIONAL,MINSK INT'L ,68,0,68,0,0,0,0
17/03/2020 10:48,2019,4,EASTERN EUROPE -OTHER,BELARUS,2,BELFAST INTERNATIONAL,MINSK LOSHITSA,41,0,41,0,0,0,0
17/03/2020 10:48,2019,4,EASTERN EUROPE -OTHER,BELARUS,2,BIGGIN HILL,MINSK INT'L ,73,0,73,0,0,0,0
17/03/2020 10:48,2019,4,EASTERN EUROPE -OTHER,BELARUS,2,CARDIFF WALES,MINSK INT'L ,41,0,41,0,0,0,0
17/03/2020 10:48,2019,4,EASTERN EUROPE -OTHER,BELARUS,2,MANCHESTER,MINSK INT'L ,2972,2972,0,3113,3039,74,-4.52939
17/03/2020 10:48,2019,4,EASTERN EUROPE -OTHER,GEORGIA,1,GATWICK,TBILISI,18938,18938,0,13767,13767,0,37.56083
17/03/2020 10:48,2019,4,EASTERN EUROPE -OTHER,GEORGIA,1,LUTON,KUTAISI,25619,25619,0,27427,27427,0,-6.59204
17/03/2020 10:48,2019,4,EASTERN EUROPE -OTHER,GEORGIA,2,ABERDEEN,TBILISI,94,0,94,0,0,0,0
17/03/2020 10:48,2019,4,EASTERN EUROPE -OTHER,GEORGIA,2,EDINBURGH,TBILISI,0,0,0,95,0,95,-100
17/03/2020 10:48,2019,4,EASTERN EUROPE -OTHER,KAZAKHSTAN,1,HEATHROW,ASTANA,45726,45726,0,45379,45379,0,0.76467
17/03/2020 10:48,2019,4,EASTERN EUROPE -OTHER,KAZAKHSTAN,2,GLASGOW,ASTANA,76,0,76,0,0,0,0
17/03/2020 10:48,2019,4,EASTERN EUROPE -OTHER,KAZAKHSTAN,2,MANCHESTER,ASTANA,290,0,290,0,0,0,0
17/03/2020 10:48,2019,4,EASTERN EUROPE -OTHER,REPUBLIC OF MOLDOVA,1,LUTON,CHISINAU (KISHINEV),166404,166404,0,117156,117156,0,42.03626
17/03/2020 10:48,2019,4,EASTERN EUROPE -OTHER,REPUBLIC OF MOLDOVA,1,STANSTED,CHISINAU (KISHINEV),74542,74542,0,67873,67873,0,9.8257
17/03/2020 10:48,2019,4,EASTERN EUROPE -OTHER,RUSSIA,1,GATWICK,MOSCOW (SHEREMETYEVO),555,555,0,16577,16577,0,-96.65199
17/03/2020 10:48,2019,4,EASTERN EUROPE -OTHER,RUSSIA,1,GATWICK,MOSCOW (VNUKOVO),6,0,6,0,0,0,0
17/03/2020 10:48,2019,4,EASTERN EUROPE -OTHER,RUSSIA,1,GATWICK,ST PETERSBURG,71682,71682,0,47097,47097,0,52.20078
17/03/2020 10:48,2019,4,EASTERN EUROPE -OTHER,RUSSIA,1,HEATHROW,MOSCOW (DOMODEDOVO),176047,176047,0,248977,248977,0,-29.29186
17/03/2020 10:48,2019,4,EASTERN EUROPE -OTHER,RUSSIA,1,HEATHROW,MOSCOW (SHEREMETYEVO),530753,530753,0,475473,475473,0,11.62632
17/03/2020 10:48,2019,4,EASTERN EUROPE -OTHER,RUSSIA,1,HEATHROW,ST PETERSBURG,59136,59136,0,81017,81017,0,-27.00791
17/03/2020 10:48,2019,4,EASTERN EUROPE -OTHER,RUSSIA,1,LUTON,ADLER / SOCHI,626,0,626,400,0,400,56.5
17/03/2020 10:48,2019,4,EASTERN EUROPE -OTHER,RUSSIA,1,LUTON,MOSCOW (SHEREMETYEVO),0,0,0,113,0,113,-100
17/03/2020 10:48,2019,4,EASTERN EUROPE -OTHER,RUSSIA,1,LUTON,MOSCOW (VNUKOVO),35092,35092,0,0,0,0,0
17/03/2020 10:48,2019,4,EASTERN EUROPE -OTHER,RUSSIA,1,LUTON,ST PETERSBURG,29763,29763,0,164,164,0,18048.17073
17/03/2020 10:48,2019,4,EASTERN EUROPE -OTHER,RUSSIA,1,STANSTED,KAZAN,105,0,105,0,0,0,0
17/03/2020 10:48,2019,4,EASTERN EUROPE -OTHER,RUSSIA,1,STANSTED,MOSCOW (DOMODEDOVO),1305,1305,0,0,0,0,0
17/03/2020 10:48,2019,4,EASTERN EUROPE -OTHER,RUSSIA,1,STANSTED,MOSCOW (SHEREMETYEVO),0,0,0,256,0,256,-100
17/03/2020 10:48,2019,4,EASTERN EUROPE -OTHER,RUSSIA,1,STANSTED,ST PETERSBURG,9659,9659,0,13665,13665,0,-29.31577
17/03/2020 10:48,2019,4,EASTERN EUROPE -OTHER,RUSSIA,2,BIGGIN HILL,MOSCOW (SHEREMETYEVO),31,0,31,0,0,0,0
17/03/2020 10:48,2019,4,EASTERN EUROPE -OTHER,RUSSIA,2,BIGGIN HILL,MOSCOW (VNUKOVO),27,0,27,46,0,46,-41.30435
17/03/2020 10:48,2019,4,EASTERN EUROPE -OTHER,RUSSIA,2,BIGGIN HILL,MURMANSK,2,0,2,2,0,2,0
17/03/2020 10:48,2019,4,EASTERN EUROPE -OTHER,RUSSIA,2,BIGGIN HILL,ST PETERSBURG,2,0,2,4,0,4,-50
17/03/2020 10:48,2019,4,EASTERN EUROPE -OTHER,RUSSIA,2,BIRMINGHAM,ST PETERSBURG,0,0,0,62,0,62,-100
17/03/2020 10:48,2019,4,EASTERN EUROPE -OTHER,RUSSIA,2,EAST MIDLANDS INTERNATIONAL,SAMARA/KUYBYSHEV,0,0,0,220,0,220,-100
17/03/2020 10:48,2019,4,EASTERN EUROPE -OTHER,RUSSIA,2,EDINBURGH,MOSCOW (SHEREMETYEVO),0,0,0,98,0,98,-100
17/03/2020 10:48,2019,4,EASTERN EUROPE -OTHER,RUSSIA,2,EDINBURGH,MOSCOW (VNUKOVO),155,0,155,0,0,0,0
17/03/2020 10:48,2019,4,EASTERN EUROPE -OTHER,RUSSIA,2,GLASGOW,KALININGRAD,69,0,69,0,0,0,0
17/03/2020 10:48,2019,4,EASTERN EUROPE -OTHER,RUSSIA,2,GLASGOW,MOSCOW (SHEREMETYEVO),66,0,66,336,0,336,-80.35714
17/03/2020 10:48,2019,4,EASTERN EUROPE -OTHER,RUSSIA,2,GLASGOW,MOSCOW (VNUKOVO),0,0,0,39,0,39,-100
17/03/2020 10:48,2019,4,EASTERN EUROPE -OTHER,RUSSIA,2,GLASGOW,NIZHNIY NOVGOROD,49,0,49,0,0,0,0
17/03/2020 10:48,2019,4,EASTERN EUROPE -OTHER,RUSSIA,2,GLASGOW,ST PETERSBURG,0,0,0,492,0,492,-100
17/03/2020 10:48,2019,4,EASTERN EUROPE -OTHER,RUSSIA,2,GLASGOW,UFA,0,0,0,122,0,122,-100
17/03/2020 10:48,2019,4,EASTERN EUROPE -OTHER,TURKMENISTAN,1,HEATHROW,ASHKHABAD,1163,1163,0,9467,9467,0,-87.71522
17/03/2020 10:48,2019,4,EASTERN EUROPE -OTHER,TURKMENISTAN,2,BIRMINGHAM,ASHKHABAD,13723,13723,0,56344,56344,0,-75.64426
17/03/2020 10:48,2019,4,EASTERN EUROPE -OTHER,TURKMENISTAN,2,BIRMINGHAM,KRASNOVODSK,0,0,0,163,163,0,-100
17/03/2020 10:48,2019,4,EASTERN EUROPE -OTHER,UKRAINE,1,GATWICK,KIEV (BORISPOL),202201,201744,457,192351,192351,0,5.12085
17/03/2020 10:48,2019,4,EASTERN EUROPE -OTHER,UKRAINE,1,HEATHROW,KIEV (BORISPOL),54049,54049,0,82243,81750,493,-34.28134
17/03/2020 10:48,2019,4,EASTERN EUROPE -OTHER,UKRAINE,1,LUTON,KHARKOV OSNOVA INTL,2725,2725,0,3144,3144,0,-13.32697
17/03/2020 10:48,2019,4,EASTERN EUROPE -OTHER,UKRAINE,1,LUTON,KIEV (BORISPOL),1645,1645,0,0,0,0,0
17/03/2020 10:48,2019,4,EASTERN EUROPE -OTHER,UKRAINE,1,LUTON,KIEV (ZHULYANY),53166,53166,0,55289,55289,0,-3.83982
17/03/2020 10:48,2019,4,EASTERN EUROPE -OTHER,UKRAINE,1,LUTON,LVOV,47322,47322,0,32435,32435,0,45.89795
17/03/2020 10:48,2019,4,EASTERN EUROPE -OTHER,UKRAINE,1,STANSTED,KIEV (BORISPOL),80788,80788,0,13444,13444,0,500.92234
17/03/2020 10:48,2019,4,EASTERN EUROPE -OTHER,UKRAINE,1,STANSTED,LVOV,49046,49046,0,7959,7959,0,516.2332
17/03/2020 10:48,2019,4,EASTERN EUROPE -OTHER,UKRAINE,2,BIGGIN HILL,ZAPOROZHYE,4,0,4,0,0,0,0
17/03/2020 10:48,2019,4,EASTERN EUROPE -OTHER,UKRAINE,2,BIRMINGHAM,KIEV (BORISPOL),0,0,0,95,95,0,-100
17/03/2020 10:48,2019,4,EASTERN EUROPE -OTHER,UKRAINE,2,EAST MIDLANDS INTERNATIONAL,KIEV (BORISPOL),0,0,0,375,0,375,-100
17/03/2020 10:48,2019,4,EASTERN EUROPE -OTHER,UKRAINE,2,LIVERPOOL (JOHN LENNON),KIEV (BORISPOL),0,0,0,9361,0,9361,-100
17/03/2020 10:48,2019,4,EASTERN EUROPE -OTHER,UKRAINE,2,LIVERPOOL (JOHN LENNON),KIEV (ZHULYANY),0,0,0,908,0,908,-100
17/03/2020 10:48,2019,4,EASTERN EUROPE -OTHER,UKRAINE,2,MANCHESTER,KHARKOV OSNOVA INTL,243,0,243,646,0,646,-62.3839
17/03/2020 10:48,2019,4,EASTERN EUROPE -OTHER,UKRAINE,2,MANCHESTER,KIEV (BORISPOL),26923,26923,0,1465,0,1465,1737.74744
17/03/2020 10:48,2019,4,EASTERN EUROPE -OTHER,UKRAINE,2,NORWICH,KIEV (ZHULYANY),0,0,0,5,0,5,-100
17/03/2020 10:48,2019,4,EASTERN EUROPE -OTHER,UZBEKISTAN,1,HEATHROW,TASHKENT,29622,29622,0,28710,28710,0,3.17659
17/03/2020 10:48,2019,25,NEAR EAST,ISRAEL,1,GATWICK,TEL AVIV,22329,22011,318,33787,33787,0,-33.91245
17/03/2020 10:48,2019,25,NEAR EAST,ISRAEL,1,HEATHROW,TEL AVIV,678130,678130,0,648088,648088,0,4.63548
17/03/2020 10:48,2019,25,NEAR EAST,ISRAEL,1,LUTON,OVDA,5994,5994,0,5192,4806,386,15.44684
17/03/2020 10:48,2019,25,NEAR EAST,ISRAEL,1,LUTON,RAMON,308,0,308,0,0,0,0
17/03/2020 10:48,2019,25,NEAR EAST,ISRAEL,1,LUTON,TEL AVIV,485140,484854,286,472220,470812,1408,2.73601
17/03/2020 10:48,2019,25,NEAR EAST,ISRAEL,1,STANSTED,TEL AVIV,44500,43870,630,30367,30195,172,46.54065
17/03/2020 10:48,2019,25,NEAR EAST,ISRAEL,2,BELFAST INTERNATIONAL,TEL AVIV,0,0,0,44,0,44,-100
17/03/2020 10:48,2019,25,NEAR EAST,ISRAEL,2,BIGGIN HILL,TEL AVIV,9,0,9,0,0,0,0
17/03/2020 10:48,2019,25,NEAR EAST,ISRAEL,2,DONCASTER SHEFFIELD,TEL AVIV,0,0,0,6,0,6,-100
17/03/2020 10:48,2019,25,NEAR EAST,ISRAEL,2,EDINBURGH,TEL AVIV,0,0,0,3432,0,3432,-100
17/03/2020 10:48,2019,25,NEAR EAST,ISRAEL,2,GLASGOW,TEL AVIV,0,0,0,260,0,260,-100
17/03/2020 10:48,2019,25,NEAR EAST,ISRAEL,2,MANCHESTER,TEL AVIV,60839,60839,0,37292,37292,0,63.14223
17/03/2020 10:48,2019,25,NEAR EAST,JORDAN,1,GATWICK,AQABA,11047,10039,1008,3087,2197,890,257.85552
17/03/2020 10:48,2019,25,NEAR EAST,JORDAN,1,HEATHROW,AMMAN,232636,232636,0,230033,230033,0,1.13158
17/03/2020 10:48,2019,25,NEAR EAST,JORDAN,1,LUTON,AMMAN,218,218,0,0,0,0,0
17/03/2020 10:48,2019,25,NEAR EAST,JORDAN,1,STANSTED,AQABA,0,0,0,554,336,218,-100
17/03/2020 10:48,2019,25,NEAR EAST,JORDAN,2,BELFAST INTERNATIONAL,AMMAN,0,0,0,75,0,75,-100
17/03/2020 10:48,2019,25,NEAR EAST,JORDAN,2,BIRMINGHAM,AMMAN (KING HUSSEIN),281,0,281,113,0,113,148.67257
17/03/2020 10:48,2019,25,NEAR EAST,JORDAN,2,BIRMINGHAM,AQABA,1044,0,1044,596,0,596,75.16779
17/03/2020 10:48,2019,25,NEAR EAST,JORDAN,2,GLASGOW,AMMAN,0,0,0,23,0,23,-100
17/03/2020 10:48,2019,25,NEAR EAST,JORDAN,2,LIVERPOOL (JOHN LENNON),AMMAN,0,0,0,134,0,134,-100
17/03/2020 10:48,2019,25,NEAR EAST,JORDAN,2,LIVERPOOL (JOHN LENNON),AMMAN (KING HUSSEIN),134,0,134,0,0,0,0
17/03/2020 10:48,2019,25,NEAR EAST,JORDAN,2,MANCHESTER,AQABA,1063,0,1063,1036,0,1036,2.60618
17/03/2020 10:48,2019,25,NEAR EAST,LEBANON,1,HEATHROW,BEIRUT,301512,301512,0,300706,300706,0,0.26804
17/03/2020 10:48,2019,25,NEAR EAST,LEBANON,2,BELFAST INTERNATIONAL,BEIRUT,248,0,248,206,0,206,20.38835
17/03/2020 10:48,2019,25,NEAR EAST,LEBANON,2,BIRMINGHAM,BEIRUT,154,0,154,130,0,130,18.46154
17/03/2020 10:48,2019,25,NEAR EAST,LEBANON,2,LIVERPOOL (JOHN LENNON),BEIRUT,0,0,0,122,0,122,-100
17/03/2020 10:48,2019,30,NORTH AFRICA,ALGERIA,1,GATWICK,ALGIERS,64659,64659,0,57169,57169,0,13.10151
17/03/2020 10:48,2019,30,NORTH AFRICA,ALGERIA,1,HEATHROW,ALGIERS,68352,68352,0,74355,74355,0,-8.07343
17/03/2020 10:48,2019,30,NORTH AFRICA,EGYPT,1,GATWICK,HURGHADA,183359,180733,2626,212439,212439,0,-13.68864
17/03/2020 10:48,2019,30,NORTH AFRICA,EGYPT,1,GATWICK,MARSA ALAM,35097,35097,0,28048,28048,0,25.13192
17/03/2020 10:48,2019,30,NORTH AFRICA,EGYPT,1,GATWICK,SHARM EL SHEIKH (OPHIRA),495,0,495,0,0,0,0
17/03/2020 10:48,2019,30,NORTH AFRICA,EGYPT,1,HEATHROW,CAIRO,414952,414952,0,402530,402316,214,3.08598
17/03/2020 10:48,2019,30,NORTH AFRICA,EGYPT,1,HEATHROW,LUXOR,8150,8150,0,8629,8629,0,-5.55105
17/03/2020 10:48,2019,30,NORTH AFRICA,EGYPT,1,LUTON,MARSA ALAM,0,0,0,49,49,0,-100
17/03/2020 10:48,2019,30,NORTH AFRICA,EGYPT,1,STANSTED,HURGHADA,24730,24509,221,5616,5616,0,340.349
17/03/2020 10:48,2019,30,NORTH AFRICA,EGYPT,2,BELFAST INTERNATIONAL,CAIRO,80,0,80,72,0,72,11.11111
17/03/2020 10:48,2019,30,NORTH AFRICA,EGYPT,2,BIRMINGHAM,HURGHADA,94182,91874,2308,99842,99654,188,-5.66896
17/03/2020 10:48,2019,30,NORTH AFRICA,EGYPT,2,BIRMINGHAM,MARSA ALAM,15884,15646,238,21439,21439,0,-25.91072
17/03/2020 10:48,2019,30,NORTH AFRICA,EGYPT,2,BIRMINGHAM,SHARM EL SHEIKH (OPHIRA),308,0,308,0,0,0,0
17/03/2020 10:48,2019,30,NORTH AFRICA,EGYPT,2,BRISTOL,HURGHADA,44845,23420,21425,31066,21891,9175,44.35396
17/03/2020 10:48,2019,30,NORTH AFRICA,EGYPT,2,CARDIFF WALES,HURGHADA,8652,0,8652,0,0,0,0
17/03/2020 10:48,2019,30,NORTH AFRICA,EGYPT,2,DONCASTER SHEFFIELD,HURGHADA,10660,9245,1415,0,0,0,0
17/03/2020 10:48,2019,30,NORTH AFRICA,EGYPT,2,EAST MIDLANDS INTERNATIONAL,HURGHADA,10696,10696,0,7475,7475,0,43.0903
17/03/2020 10:48,2019,30,NORTH AFRICA,EGYPT,2,GLASGOW,CAIRO,0,0,0,89,0,89,-100
17/03/2020 10:48,2019,30,NORTH AFRICA,EGYPT,2,GLASGOW,HURGHADA,4685,4685,0,8031,8031,0,-41.66355
17/03/2020 10:48,2019,30,NORTH AFRICA,EGYPT,2,MANCHESTER,HURGHADA,174029,170406,3623,160244,160244,0,8.60251
17/03/2020 10:48,2019,30,NORTH AFRICA,EGYPT,2,MANCHESTER,MARSA ALAM,2366,2366,0,0,0,0,0
17/03/2020 10:48,2019,30,NORTH AFRICA,EGYPT,2,NEWCASTLE,HURGHADA,14113,14113,0,20234,20234,0,-30.25106
17/03/2020 10:48,2019,30,NORTH AFRICA,MOROCCO,1,GATWICK,AGADIR (AL MASSIRA),95390,95390,0,91010,91010,0,4.81266
17/03/2020 10:48,2019,30,NORTH AFRICA,MOROCCO,1,GATWICK,CASABLANCA MOHAMED V,65239,65233,6,65220,65220,0,0.02913
17/03/2020 10:48,2019,30,NORTH AFRICA,MOROCCO,1,GATWICK,ERRACHIDIA,2,0,2,0,0,0,0
17/03/2020 10:48,2019,30,NORTH AFRICA,MOROCCO,1,GATWICK,FEZ,16667,16667,0,16251,16251,0,2.55984
17/03/2020 10:48,2019,30,NORTH AFRICA,MOROCCO,1,GATWICK,MARRAKESH,386636,386615,21,355350,355350,0,8.80428
17/03/2020 10:48,2019,30,NORTH AFRICA,MOROCCO,1,GATWICK,OUARZAZATE,398,0,398,722,0,722,-44.87535
17/03/2020 10:48,2019,30,NORTH AFRICA,MOROCCO,1,GATWICK,RABAT,298,0,298,228,0,228,30.70175
17/03/2020 10:48,2019,30,NORTH AFRICA,MOROCCO,1,GATWICK,TANGIERS (IBN BATUTA),29802,29802,0,26187,26187,0,13.80456
17/03/2020 10:48,2019,30,NORTH AFRICA,MOROCCO,1,HEATHROW,CASABLANCA MOHAMED V,96222,96222,0,86215,86215,0,11.60703
17/03/2020 10:48,2019,30,NORTH AFRICA,MOROCCO,1,HEATHROW,MARRAKESH,29638,29638,0,8684,8684,0,241.29433
17/03/2020 10:48,2019,30,NORTH AFRICA,MOROCCO,1,HEATHROW,RABAT,12942,12942,0,14147,14147,0,-8.51771
17/03/2020 10:48,2019,30,NORTH AFRICA,MOROCCO,1,LUTON,AGADIR (AL MASSIRA),0,0,0,632,445,187,-100
17/03/2020 10:48,2019,30,NORTH AFRICA,MOROCCO,1,LUTON,CASABLANCA MOHAMED V,0,0,0,38,0,38,-100
17/03/2020 10:48,2019,30,NORTH AFRICA,MOROCCO,1,LUTON,ESSAOUIRA,0,0,0,20038,20038,0,-100
17/03/2020 10:48,2019,30,NORTH AFRICA,MOROCCO,1,LUTON,MARRAKESH,57691,57691,0,59507,59507,0,-3.05174
17/03/2020 10:48,2019,30,NORTH AFRICA,MOROCCO,1,STANSTED,AGADIR (AL MASSIRA),36430,36430,0,37660,37660,0,-3.26606
17/03/2020 10:48,2019,30,NORTH AFRICA,MOROCCO,1,STANSTED,ESSAOUIRA,5565,5565,0,0,0,0,0
17/03/2020 10:48,2019,30,NORTH AFRICA,MOROCCO,1,STANSTED,FEZ,35015,35015,0,35384,35384,0,-1.04284
17/03/2020 10:48,2019,30,NORTH AFRICA,MOROCCO,1,STANSTED,MARRAKESH,133995,131891,2104,130668,128289,2379,2.54615
17/03/2020 10:48,2019,30,NORTH AFRICA,MOROCCO,1,STANSTED,RABAT,55524,55524,0,52556,52556,0,5.64731
17/03/2020 10:48,2019,30,NORTH AFRICA,MOROCCO,2,BELFAST INTERNATIONAL,MARRAKESH,4751,4751,0,0,0,0,0
17/03/2020 10:48,2019,30,NORTH AFRICA,MOROCCO,2,BIGGIN HILL,CASABLANCA MOHAMED V,73,0,73,0,0,0,0
17/03/2020 10:48,2019,30,NORTH AFRICA,MOROCCO,2,BIGGIN HILL,FEZ,0,0,0,8,0,8,-100
17/03/2020 10:48,2019,30,NORTH AFRICA,MOROCCO,2,BIRMINGHAM,AGADIR (AL MASSIRA),12265,12265,0,1616,1616,0,658.97277
17/03/2020 10:48,2019,30,NORTH AFRICA,MOROCCO,2,BIRMINGHAM,CASABLANCA MOHAMED V,186,0,186,0,0,0,0
17/03/2020 10:48,2019,30,NORTH AFRICA,MOROCCO,2,BIRMINGHAM,MARRAKESH,16562,15770,792,18263,18263,0,-9.31391
17/03/2020 10:48,2019,30,NORTH AFRICA,MOROCCO,2,BRISTOL,MARRAKESH,14223,9795,4428,0,0,0,0
17/03/2020 10:48,2019,30,NORTH AFRICA,MOROCCO,2,CARDIFF WALES,MARRAKESH,0,0,0,3,3,0,-100
17/03/2020 10:48,2019,30,NORTH AFRICA,MOROCCO,2,CARDIFF WALES,RABAT,187,0,187,0,0,0,0
17/03/2020 10:48,2019,30,NORTH AFRICA,MOROCCO,2,EAST MIDLANDS INTERNATIONAL,MARRAKESH,189,0,189,180,180,0,5
17/03/2020 10:48,2019,30,NORTH AFRICA,MOROCCO,2,LIVERPOOL (JOHN LENNON),AGADIR (AL MASSIRA),0,0,0,170,170,0,-100
17/03/2020 10:48,2019,30,NORTH AFRICA,MOROCCO,2,LIVERPOOL (JOHN LENNON),MARRAKESH,35447,35447,0,36083,36083,0,-1.7626
17/03/2020 10:48,2019,30,NORTH AFRICA,MOROCCO,2,MANCHESTER,AGADIR (AL MASSIRA),101938,101938,0,93019,93019,0,9.58836
17/03/2020 10:48,2019,30,NORTH AFRICA,MOROCCO,2,MANCHESTER,CASABLANCA MOHAMED V,16496,16496,0,25684,25684,0,-35.77324
17/03/2020 10:48,2019,30,NORTH AFRICA,MOROCCO,2,MANCHESTER,MARRAKESH,139844,138599,1245,89984,88765,1219,55.40985
17/03/2020 10:48,2019,30,NORTH AFRICA,TUNISIA,1,GATWICK,ENFIDHA - HAMMAMET INTL,77293,48852,28441,67630,55691,11939,14.28804
17/03/2020 10:48,2019,30,NORTH AFRICA,TUNISIA,1,GATWICK,MONASTIR,0,0,0,635,635,0,-100
17/03/2020 10:48,2019,30,NORTH AFRICA,TUNISIA,1,GATWICK,TUNIS,27713,27713,0,31450,31077,373,-11.88235
17/03/2020 10:48,2019,30,NORTH AFRICA,TUNISIA,1,HEATHROW,TUNIS,44951,44951,0,46090,46090,0,-2.47125
17/03/2020 10:48,2019,30,NORTH AFRICA,TUNISIA,1,LUTON,ENFIDHA - HAMMAMET INTL,9283,0,9283,0,0,0,0
17/03/2020 10:48,2019,30,NORTH AFRICA,TUNISIA,1,STANSTED,ENFIDHA - HAMMAMET INTL,10869,10869,0,8937,8937,0,21.61799
17/03/2020 10:48,2019,30,NORTH AFRICA,TUNISIA,2,BELFAST INTERNATIONAL,ENFIDHA - HAMMAMET INTL,16922,6096,10826,0,0,0,0
17/03/2020 10:48,2019,30,NORTH AFRICA,TUNISIA,2,BIRMINGHAM,ENFIDHA - HAMMAMET INTL,39313,13044,26269,29108,16930,12178,35.05909
17/03/2020 10:48,2019,30,NORTH AFRICA,TUNISIA,2,BIRMINGHAM,MONASTIR,0,0,0,430,430,0,-100
17/03/2020 10:48,2019,30,NORTH AFRICA,TUNISIA,2,BIRMINGHAM,TUNIS,0,0,0,371,0,371,-100
17/03/2020 10:48,2019,30,NORTH AFRICA,TUNISIA,2,BRISTOL,ENFIDHA - HAMMAMET INTL,27252,21493,5759,9934,0,9934,174.33058
17/03/2020 10:48,2019,30,NORTH AFRICA,TUNISIA,2,BRISTOL,MONASTIR,0,0,0,421,0,421,-100
17/03/2020 10:48,2019,30,NORTH AFRICA,TUNISIA,2,CARDIFF WALES,ENFIDHA - HAMMAMET INTL,18856,0,18856,0,0,0,0
17/03/2020 10:48,2019,30,NORTH AFRICA,TUNISIA,2,DONCASTER SHEFFIELD,ENFIDHA - HAMMAMET INTL,9267,0,9267,0,0,0,0
17/03/2020 10:48,2019,30,NORTH AFRICA,TUNISIA,2,EAST MIDLANDS INTERNATIONAL,ENFIDHA - HAMMAMET INTL,7950,0,7950,0,0,0,0
17/03/2020 10:48,2019,30,NORTH AFRICA,TUNISIA,2,GLASGOW,ENFIDHA - HAMMAMET INTL,39393,30874,8519,13978,13978,0,181.82143
17/03/2020 10:48,2019,30,NORTH AFRICA,TUNISIA,2,GLASGOW,MONASTIR,0,0,0,449,449,0,-100
17/03/2020 10:48,2019,30,NORTH AFRICA,TUNISIA,2,LEEDS BRADFORD,ENFIDHA - HAMMAMET INTL,5766,0,5766,0,0,0,0
17/03/2020 10:48,2019,30,NORTH AFRICA,TUNISIA,2,MANCHESTER,ENFIDHA - HAMMAMET INTL,96695,69106,27589,53699,41660,12039,80.06853
17/03/2020 10:48,2019,30,NORTH AFRICA,TUNISIA,2,MANCHESTER,MONASTIR,0,0,0,797,426,371,-100
17/03/2020 10:48,2019,30,NORTH AFRICA,TUNISIA,2,NEWCASTLE,ENFIDHA - HAMMAMET INTL,25895,25895,0,10738,10738,0,141.15291
17/03/2020 10:48,2019,35,EAST AFRICA,ETHIOPIA,1,HEATHROW,ADDIS ABABA,246383,246383,0,237158,237158,0,3.88981
17/03/2020 10:48,2019,35,EAST AFRICA,ETHIOPIA,2,MANCHESTER,ADDIS ABABA,34978,34978,0,1820,1820,0,1821.86813
17/03/2020 10:48,2019,35,EAST AFRICA,KENYA,1,HEATHROW,NAIROBI,337919,337919,0,360461,360461,0,-6.25366
17/03/2020 10:48,2019,35,EAST AFRICA,KENYA,2,MANCHESTER,NAIROBI,169,0,169,0,0,0,0
17/03/2020 10:48,2019,35,EAST AFRICA,RWANDA,1,GATWICK,KIGALI,28504,28504,0,17684,17684,0,61.18525
17/03/2020 10:48,2019,40,WEST AFRICA,GAMBIA,1,GATWICK,BANJUL,46683,23332,23351,55848,34059,21789,-16.41061
17/03/2020 10:48,2019,40,WEST AFRICA,GAMBIA,1,STANSTED,BANJUL,79,0,79,0,0,0,0
17/03/2020 10:48,2019,40,WEST AFRICA,GAMBIA,2,BIRMINGHAM,BANJUL,10138,9763,375,15801,15801,0,-35.8395
17/03/2020 10:48,2019,40,WEST AFRICA,GAMBIA,2,EAST MIDLANDS INTERNATIONAL,BANJUL,0,0,0,205,0,205,-100
17/03/2020 10:48,2019,40,WEST AFRICA,GAMBIA,2,MANCHESTER,BANJUL,21727,21093,634,30270,30270,0,-28.22266
17/03/2020 10:48,2019,40,WEST AFRICA,GHANA,1,GATWICK,ACCRA,184,0,184,794,0,794,-76.8262
17/03/2020 10:48,2019,40,WEST AFRICA,GHANA,1,HEATHROW,ACCRA,221188,221188,0,208978,208978,0,5.84272
17/03/2020 10:48,2019,40,WEST AFRICA,NIGERIA,1,GATWICK,LAGOS,0,0,0,7273,7273,0,-100
17/03/2020 10:48,2019,40,WEST AFRICA,NIGERIA,1,HEATHROW,ABUJA,136534,136534,0,121274,121274,0,12.58308
17/03/2020 10:48,2019,40,WEST AFRICA,NIGERIA,1,HEATHROW,LAGOS,382375,382375,0,374601,374601,0,2.07527
17/03/2020 10:48,2019,40,WEST AFRICA,NIGERIA,2,DONCASTER SHEFFIELD,LAGOS,0,0,0,137,0,137,-100
17/03/2020 10:48,2019,40,WEST AFRICA,SIERRA LEONE,1,GATWICK,FREETOWN,265,0,265,0,0,0,0
17/03/2020 10:48,2019,45,CENTRAL AFRICA,ANGOLA,1,HEATHROW,LUANDA,0,0,0,3035,3035,0,-100
17/03/2020 10:48,2019,45,CENTRAL AFRICA,CHAD,2,BIGGIN HILL,NDJAMENA,0,0,0,2,0,2,-100
17/03/2020 10:48,2019,50,SOUTHERN AFRICA,REPUBLIC OF SOUTH AFRICA,1,GATWICK,CAPE TOWN,48642,48642,0,50708,49260,1448,-4.07431
17/03/2020 10:48,2019,50,SOUTHERN AFRICA,REPUBLIC OF SOUTH AFRICA,1,HEATHROW,CAPE TOWN,329296,329045,251,331787,331787,0,-0.75078
17/03/2020 10:48,2019,50,SOUTHERN AFRICA,REPUBLIC OF SOUTH AFRICA,1,HEATHROW,DURBAN,56657,56657,0,9650,9650,0,487.11917
17/03/2020 10:48,2019,50,SOUTHERN AFRICA,REPUBLIC OF SOUTH AFRICA,1,HEATHROW,JOHANNESBURG,1004190,1004190,0,933357,933357,0,7.58906
17/03/2020 10:48,2019,50,SOUTHERN AFRICA,REPUBLIC OF SOUTH AFRICA,2,MANCHESTER,CAPE TOWN,0,0,0,1086,0,1086,-100
17/03/2020 10:48,2019,55,MIDDLE EAST,BAHRAIN,1,HEATHROW,BAHRAIN,426683,426683,0,382507,382507,0,11.54907
17/03/2020 10:48,2019,55,MIDDLE EAST,IRAN,1,HEATHROW,TEHRAN IMAM KHOMEINI,55008,55008,0,122937,122937,0,-55.25513
17/03/2020 10:48,2019,55,MIDDLE EAST,IRAQ,1,GATWICK,BAGHDAD (GECA),6469,6432,37,9686,9686,0,-33.21288
17/03/2020 10:48,2019,55,MIDDLE EAST,IRAQ,1,GATWICK,ERBIL INTERNATIONAL,0,0,0,176,176,0,-100
17/03/2020 10:48,2019,55,MIDDLE EAST,IRAQ,1,GATWICK,SULAYMANIYAH INT,6574,6574,0,6929,6929,0,-5.12339
17/03/2020 10:48,2019,55,MIDDLE EAST,IRAQ,2,MANCHESTER,BAGHDAD (GECA),7241,7241,0,8839,8839,0,-18.07897
17/03/2020 10:48,2019,55,MIDDLE EAST,KUWAIT,1,GATWICK,KUWAIT,7264,7264,0,0,0,0,0
17/03/2020 10:48,2019,55,MIDDLE EAST,KUWAIT,1,HEATHROW,KUWAIT,436088,436088,0,379240,379240,0,14.98998
17/03/2020 10:48,2019,55,MIDDLE EAST,OMAN,1,GATWICK,MUSCAT,1033,0,1033,573,0,573,80.27923
17/03/2020 10:48,2019,55,MIDDLE EAST,OMAN,1,HEATHROW,MUSCAT,359470,359470,0,384466,384466,0,-6.50149
17/03/2020 10:48,2019,55,MIDDLE EAST,OMAN,2,BIRMINGHAM,MUSCAT,864,0,864,581,0,581,48.70912
17/03/2020 10:48,2019,55,MIDDLE EAST,OMAN,2,EAST MIDLANDS INTERNATIONAL,MUSCAT,167,0,167,0,0,0,0
17/03/2020 10:48,2019,55,MIDDLE EAST,OMAN,2,MANCHESTER,MUSCAT,146178,145143,1035,133065,132476,589,9.85458
17/03/2020 10:48,2019,55,MIDDLE EAST,QATAR,1,GATWICK,DOHA HAMAD,372378,372378,0,170314,170296,18,118.64204
17/03/2020 10:48,2019,55,MIDDLE EAST,QATAR,1,HEATHROW,DOHA HAMAD,1264687,1264687,0,1181541,1181541,0,7.03708
17/03/2020 10:48,2019,55,MIDDLE EAST,QATAR,2,BIRMINGHAM,DOHA HAMAD,132159,132159,0,121002,121002,0,9.22051
17/03/2020 10:48,2019,55,MIDDLE EAST,QATAR,2,CARDIFF WALES,DOHA HAMAD,90679,90679,0,55568,55568,0,63.18565
17/03/2020 10:48,2019,55,MIDDLE EAST,QATAR,2,EDINBURGH,DOHA HAMAD,167974,167974,0,140727,140727,0,19.3616
17/03/2020 10:48,2019,55,MIDDLE EAST,QATAR,2,LIVERPOOL (JOHN LENNON),DOHA INTERNATIONAL,165,0,165,0,0,0,0
17/03/2020 10:48,2019,55,MIDDLE EAST,QATAR,2,MANCHESTER,DOHA HAMAD,417991,417991,0,327951,327951,0,27.45532
17/03/2020 10:48,2019,55,MIDDLE EAST,QATAR,2,MANCHESTER,DOHA INTERNATIONAL,5891,5891,0,0,0,0,0
17/03/2020 10:48,2019,55,MIDDLE EAST,SAUDI ARABIA,1,HEATHROW,DAMMAM,1564,1564,0,0,0,0,0
17/03/2020 10:48,2019,55,MIDDLE EAST,SAUDI ARABIA,1,HEATHROW,JEDDAH,248762,248762,0,249869,249869,0,-0.44303
17/03/2020 10:48,2019,55,MIDDLE EAST,SAUDI ARABIA,1,HEATHROW,MEDINA,4944,4944,0,3300,3300,0,49.81818
17/03/2020 10:48,2019,55,MIDDLE EAST,SAUDI ARABIA,1,HEATHROW,RIYADH,288758,288758,0,276302,276302,0,4.50811
17/03/2020 10:48,2019,55,MIDDLE EAST,SAUDI ARABIA,1,LUTON,NEOM BAY,804,0,804,0,0,0,0
17/03/2020 10:48,2019,55,MIDDLE EAST,SAUDI ARABIA,1,LUTON,RIYADH,106,0,106,0,0,0,0
17/03/2020 10:48,2019,55,MIDDLE EAST,SAUDI ARABIA,1,STANSTED,RIYADH,0,0,0,64,0,64,-100
17/03/2020 10:48,2019,55,MIDDLE EAST,SAUDI ARABIA,2,BIGGIN HILL,RIYADH,5,0,5,0,0,0,0
17/03/2020 10:48,2019,55,MIDDLE EAST,SAUDI ARABIA,2,CARDIFF WALES,JEDDAH,80,80,0,0,0,0,0
17/03/2020 10:48,2019,55,MIDDLE EAST,SAUDI ARABIA,2,MANCHESTER,JEDDAH,94769,94769,0,97621,97621,0,-2.9215
17/03/2020 10:48,2019,55,MIDDLE EAST,SAUDI ARABIA,2,MANCHESTER,MEDINA,1986,1986,0,0,0,0,0
17/03/2020 10:48,2019,55,MIDDLE EAST,SAUDI ARABIA,2,MANCHESTER,RIYADH,427,427,0,0,0,0,0
17/03/2020 10:48,2019,55,MIDDLE EAST,UNITED ARAB EMIRATES,1,GATWICK,ABU DHABI INTERNATIONAL,0,0,0,195,0,195,-100
17/03/2020 10:48,2019,55,MIDDLE EAST,UNITED ARAB EMIRATES,1,GATWICK,DUBAI,979723,979723,0,1029841,1029841,0,-4.86658
17/03/2020 10:48,2019,55,MIDDLE EAST,UNITED ARAB EMIRATES,1,GATWICK,DUBAI (WORLD CENTRAL),1025,0,1025,567,0,567,80.77601
17/03/2020 10:48,2019,55,MIDDLE EAST,UNITED ARAB EMIRATES,1,HEATHROW,ABU DHABI INTERNATIONAL,1119673,1119673,0,1010388,1010160,228,10.81614
17/03/2020 10:48,2019,55,MIDDLE EAST,UNITED ARAB EMIRATES,1,HEATHROW,DUBAI,2333127,2333108,19,2610784,2610784,0,-10.635
17/03/2020 10:48,2019,55,MIDDLE EAST,UNITED ARAB EMIRATES,1,STANSTED,ABU DHABI INTERNATIONAL,0,0,0,234,0,234,-100
17/03/2020 10:48,2019,55,MIDDLE EAST,UNITED ARAB EMIRATES,1,STANSTED,DUBAI,317846,317846,0,122643,122643,0,159.16359
17/03/2020 10:48,2019,55,MIDDLE EAST,UNITED ARAB EMIRATES,2,BIRMINGHAM,ABU DHABI INTERNATIONAL,185,185,0,0,0,0,0
17/03/2020 10:48,2019,55,MIDDLE EAST,UNITED ARAB EMIRATES,2,BIRMINGHAM,DUBAI,702283,702283,0,710517,710517,0,-1.15887
17/03/2020 10:48,2019,55,MIDDLE EAST,UNITED ARAB EMIRATES,2,BIRMINGHAM,DUBAI (WORLD CENTRAL),990,282,708,581,0,581,70.39587
17/03/2020 10:48,2019,55,MIDDLE EAST,UNITED ARAB EMIRATES,2,CARDIFF WALES,DUBAI (WORLD CENTRAL),0,0,0,44,0,44,-100
17/03/2020 10:48,2019,55,MIDDLE EAST,UNITED ARAB EMIRATES,2,EDINBURGH,ABU DHABI INTERNATIONAL,0,0,0,84346,84346,0,-100
17/03/2020 10:48,2019,55,MIDDLE EAST,UNITED ARAB EMIRATES,2,EDINBURGH,DUBAI,183969,183969,0,40565,40565,0,353.51658
17/03/2020 10:48,2019,55,MIDDLE EAST,UNITED ARAB EMIRATES,2,GLASGOW,DUBAI,437748,437748,0,455037,455037,0,-3.79947
17/03/2020 10:48,2019,55,MIDDLE EAST,UNITED ARAB EMIRATES,2,LIVERPOOL (JOHN LENNON),DUBAI (WORLD CENTRAL),32,0,32,160,0,160,-80
17/03/2020 10:48,2019,55,MIDDLE EAST,UNITED ARAB EMIRATES,2,MANCHESTER,ABU DHABI INTERNATIONAL,395739,395739,0,426468,425877,591,-7.20546
17/03/2020 10:48,2019,55,MIDDLE EAST,UNITED ARAB EMIRATES,2,MANCHESTER,DUBAI,1002656,998209,4447,1000214,1000214,0,0.24415
17/03/2020 10:48,2019,55,MIDDLE EAST,UNITED ARAB EMIRATES,2,MANCHESTER,DUBAI (WORLD CENTRAL),1226,0,1226,685,0,685,78.9781
17/03/2020 10:48,2019,55,MIDDLE EAST,UNITED ARAB EMIRATES,2,NEWCASTLE,DUBAI,227629,227629,0,242302,241964,338,-6.05567
17/03/2020 10:48,2019,55,MIDDLE EAST,UNITED ARAB EMIRATES,2,PRESTWICK,DUBAI,0,0,0,630,0,630,-100
17/03/2020 10:48,2019,60,INDIAN SUB-CONTINENT,BANGLADESH,1,HEATHROW,DHAKHA,87419,87419,0,80436,80436,0,8.68144
17/03/2020 10:48,2019,60,INDIAN SUB-CONTINENT,BANGLADESH,1,HEATHROW,SYLHET,54413,54413,0,52345,52345,0,3.95071
17/03/2020 10:48,2019,60,INDIAN SUB-CONTINENT,INDIA,1,GATWICK,COCHIN,990,0,990,577,0,577,71.57712
17/03/2020 10:48,2019,60,INDIAN SUB-CONTINENT,INDIA,1,GATWICK,GOA,41495,23273,18222,43279,29584,13695,-4.12209
17/03/2020 10:48,2019,60,INDIAN SUB-CONTINENT,INDIA,1,HEATHROW,AHMEDABAD,94291,94291,0,65910,65910,0,43.06023
17/03/2020 10:48,2019,60,INDIAN SUB-CONTINENT,INDIA,1,HEATHROW,AMRITSAR,294,294,0,4689,4689,0,-93.73001
17/03/2020 10:48,2019,60,INDIAN SUB-CONTINENT,INDIA,1,HEATHROW,BANGALORE (BENGALURU),231123,231123,0,179321,179321,0,28.88786
17/03/2020 10:48,2019,60,INDIAN SUB-CONTINENT,INDIA,1,HEATHROW,CHENNAI,136841,136841,0,136869,136869,0,-0.02046
17/03/2020 10:48,2019,60,INDIAN SUB-CONTINENT,INDIA,1,HEATHROW,DELHI,871188,871188,0,1021351,1021351,0,-14.70239
17/03/2020 10:48,2019,60,INDIAN SUB-CONTINENT,INDIA,1,HEATHROW,HYDERABAD ( RAJIV GHANDI ),141438,141438,0,140459,140459,0,0.697
17/03/2020 10:48,2019,60,INDIAN SUB-CONTINENT,INDIA,1,HEATHROW,MUMBAI,724449,724449,0,1121997,1121997,0,-35.43218
17/03/2020 10:48,2019,60,INDIAN SUB-CONTINENT,INDIA,1,STANSTED,AMRITSAR,9377,9377,0,0,0,0,0
17/03/2020 10:48,2019,60,INDIAN SUB-CONTINENT,INDIA,2,BIRMINGHAM,AMRITSAR,52313,52313,0,76088,76088,0,-31.24671
17/03/2020 10:48,2019,60,INDIAN SUB-CONTINENT,INDIA,2,BIRMINGHAM,COCHIN,997,0,997,575,0,575,73.3913
17/03/2020 10:48,2019,60,INDIAN SUB-CONTINENT,INDIA,2,BIRMINGHAM,DELHI,55838,55838,0,70715,70715,0,-21.03797
17/03/2020 10:48,2019,60,INDIAN SUB-CONTINENT,INDIA,2,BIRMINGHAM,GOA,9167,0,9167,7788,0,7788,17.70673
17/03/2020 10:48,2019,60,INDIAN SUB-CONTINENT,INDIA,2,BIRMINGHAM,MUMBAI,218,218,0,0,0,0,0
17/03/2020 10:48,2019,60,INDIAN SUB-CONTINENT,INDIA,2,MANCHESTER,COCHIN,1090,0,1090,586,0,586,86.00683
17/03/2020 10:48,2019,60,INDIAN SUB-CONTINENT,INDIA,2,MANCHESTER,GOA,50673,33129,17544,64009,46846,17163,-20.83457
17/03/2020 10:48,2019,60,INDIAN SUB-CONTINENT,INDIA,2,MANCHESTER,MUMBAI,24463,24463,0,15299,15299,0,59.89934
17/03/2020 10:48,2019,60,INDIAN SUB-CONTINENT,PAKISTAN,1,GATWICK,BENAZIR BHUTTO INTERNATIONAL AIRPORT,120,51,69,724,0,724,-83.42541
17/03/2020 10:48,2019,60,INDIAN SUB-CONTINENT,PAKISTAN,1,HEATHROW,BENAZIR BHUTTO INTERNATIONAL AIRPORT,12840,12840,0,97948,97948,0,-86.891
17/03/2020 10:48,2019,60,INDIAN SUB-CONTINENT,PAKISTAN,1,HEATHROW,ISLAMABAD INTERNATIONAL AIRPORT,165252,165252,0,51618,51618,0,220.14414
17/03/2020 10:48,2019,60,INDIAN SUB-CONTINENT,PAKISTAN,1,HEATHROW,KARACHI,42998,42998,0,49278,49278,0,-12.74402
17/03/2020 10:48,2019,60,INDIAN SUB-CONTINENT,PAKISTAN,1,HEATHROW,LAHORE,89978,89978,0,92561,92561,0,-2.79059
17/03/2020 10:48,2019,60,INDIAN SUB-CONTINENT,PAKISTAN,1,HEATHROW,SIALKOT,6451,6451,0,0,0,0,0
17/03/2020 10:48,2019,60,INDIAN SUB-CONTINENT,PAKISTAN,2,BIRMINGHAM,BENAZIR BHUTTO INTERNATIONAL AIRPORT,7720,7720,0,81726,81726,0,-90.5538
17/03/2020 10:48,2019,60,INDIAN SUB-CONTINENT,PAKISTAN,2,BIRMINGHAM,ISLAMABAD INTERNATIONAL AIRPORT,82846,82846,0,0,0,0,0
17/03/2020 10:48,2019,60,INDIAN SUB-CONTINENT,PAKISTAN,2,DONCASTER SHEFFIELD,BENAZIR BHUTTO INTERNATIONAL AIRPORT,0,0,0,139,0,139,-100
17/03/2020 10:48,2019,60,INDIAN SUB-CONTINENT,PAKISTAN,2,DONCASTER SHEFFIELD,ISLAMABAD INTERNATIONAL AIRPORT,176,0,176,0,0,0,0
17/03/2020 10:48,2019,60,INDIAN SUB-CONTINENT,PAKISTAN,2,MANCHESTER,BENAZIR BHUTTO INTERNATIONAL AIRPORT,17553,17553,0,153159,153159,0,-88.53936
17/03/2020 10:48,2019,60,INDIAN SUB-CONTINENT,PAKISTAN,2,MANCHESTER,ISLAMABAD INTERNATIONAL AIRPORT,176514,176514,0,33116,33116,0,433.01727
17/03/2020 10:48,2019,60,INDIAN SUB-CONTINENT,PAKISTAN,2,MANCHESTER,KARACHI,0,0,0,23,23,0,-100
17/03/2020 10:48,2019,60,INDIAN SUB-CONTINENT,PAKISTAN,2,MANCHESTER,LAHORE,54930,54930,0,51716,51716,0,6.21471
17/03/2020 10:48,2019,60,INDIAN SUB-CONTINENT,SRI LANKA,1,GATWICK,COLOMBO,10303,0,10303,8482,0,8482,21.46899
17/03/2020 10:48,2019,60,INDIAN SUB-CONTINENT,SRI LANKA,1,HEATHROW,COLOMBO,219395,219395,0,225211,225211,0,-2.58247
17/03/2020 10:48,2019,60,INDIAN SUB-CONTINENT,SRI LANKA,2,MANCHESTER,COLOMBO,334,0,334,362,0,362,-7.73481
17/03/2020 10:48,2019,65,FAR EAST,BRUNEI,1,HEATHROW,BANDAR SERI BEGAWAN,127023,127023,0,79062,79062,0,60.66252
17/03/2020 10:48,2019,65,FAR EAST,CHINA,1,GATWICK,BEIJING,0,0,0,224,224,0,-100
17/03/2020 10:48,2019,65,FAR EAST,CHINA,1,GATWICK,CHENGDU,11205,11205,0,27214,27214,0,-58.82634
17/03/2020 10:48,2019,65,FAR EAST,CHINA,1,GATWICK,CHONGQING JIANGBEI INTERNATIONAL,0,0,0,11034,11034,0,-100
17/03/2020 10:48,2019,65,FAR EAST,CHINA,1,GATWICK,SHANGHAI (PU DONG),79040,79040,0,4526,4526,0,1646.3544
17/03/2020 10:48,2019,65,FAR EAST,CHINA,1,GATWICK,TIANJIN,0,0,0,13821,13821,0,-100
17/03/2020 10:48,2019,65,FAR EAST,CHINA,1,HEATHROW,BEIJING,585832,585832,0,530314,530314,0,10.46889
17/03/2020 10:48,2019,65,FAR EAST,CHINA,1,HEATHROW,BEIJING DAXING INTERNATIONAL AIRPORT,21928,21928,0,0,0,0,0
17/03/2020 10:48,2019,65,FAR EAST,CHINA,1,HEATHROW,CHANGSHA HUANGHUA INTERNATIONAL AIRPORT,43833,43833,0,34452,34452,0,27.22919
17/03/2020 10:48,2019,65,FAR EAST,CHINA,1,HEATHROW,CHENGDU,41051,41051,0,0,0,0,0
17/03/2020 10:48,2019,65,FAR EAST,CHINA,1,HEATHROW,CHONGQING JIANGBEI INTERNATIONAL,28816,28816,0,12886,12886,0,123.62254
17/03/2020 10:48,2019,65,FAR EAST,CHINA,1,HEATHROW,GUANGZHOU BAIYUN INTERNATIONAL,165630,165630,0,157231,157231,0,5.34182
17/03/2020 10:48,2019,65,FAR EAST,CHINA,1,HEATHROW,QINGDAO,34369,34369,0,28699,26695,2004,19.75679
17/03/2020 10:48,2019,65,FAR EAST,CHINA,1,HEATHROW,SANYA PHOENIX INTERNATIONAL,16204,16204,0,9383,9383,0,72.6953
17/03/2020 10:48,2019,65,FAR EAST,CHINA,1,HEATHROW,SHANGHAI (PU DONG),510675,510675,0,511003,511003,0,-0.06419
17/03/2020 10:48,2019,65,FAR EAST,CHINA,1,HEATHROW,SHENZHEN (HUANGTIAN),65841,65841,0,9264,9264,0,610.71891
17/03/2020 10:48,2019,65,FAR EAST,CHINA,1,HEATHROW,TIANJIN,10031,10031,0,4851,4851,0,106.78211
17/03/2020 10:48,2019,65,FAR EAST,CHINA,1,HEATHROW,WUHAN TIANHE INTERNATIONAL,54772,54772,0,30425,30425,0,80.02301
17/03/2020 10:48,2019,65,FAR EAST,CHINA,1,HEATHROW,XIAN XIANYANG,45516,45516,0,25331,25331,0,79.68497
17/03/2020 10:48,2019,65,FAR EAST,CHINA,1,HEATHROW,ZHENGZHOU XINZHENG,17938,17938,0,0,0,0,0
17/03/2020 10:48,2019,65,FAR EAST,CHINA,2,EDINBURGH,BEIJING,29214,29214,0,19329,19329,0,51.14077
17/03/2020 10:48,2019,65,FAR EAST,CHINA,2,MANCHESTER,BEIJING,75274,75274,0,75536,75536,0,-0.34685
17/03/2020 10:48,2019,65,FAR EAST,CHINA,2,MANCHESTER,SHANGHAI (PU DONG),128,0,128,0,0,0,0
17/03/2020 10:48,2019,65,FAR EAST,HONG KONG,1,GATWICK,HONG KONG (CHEK LAP KOK),168823,168823,0,166758,166758,0,1.23832
17/03/2020 10:48,2019,65,FAR EAST,HONG KONG,1,HEATHROW,HONG KONG (CHEK LAP KOK),1612530,1612530,0,1572021,1572021,0,2.57687
17/03/2020 10:48,2019,65,FAR EAST,HONG KONG,2,MANCHESTER,HONG KONG (CHEK LAP KOK),195444,195444,0,183553,183553,0,6.47824
17/03/2020 10:48,2019,65,FAR EAST,INDONESIA,1,HEATHROW,BALI INTERNATIONAL,13102,13102,0,0,0,0,0
17/03/2020 10:48,2019,65,FAR EAST,INDONESIA,1,HEATHROW,JAKARTA (SOEKARNO-HATTA INTNL),9161,9161,0,55264,55264,0,-83.4232
17/03/2020 10:48,2019,65,FAR EAST,INDONESIA,1,HEATHROW,KUALANAMU INTERNATIONAL AIRPORT,8608,8608,0,0,0,0,0
17/03/2020 10:48,2019,65,FAR EAST,JAPAN,1,HEATHROW,OSAKA (KANSAI),51706,51706,0,0,0,0,0
17/03/2020 10:48,2019,65,FAR EAST,JAPAN,1,HEATHROW,TOKYO (HANEDA),586226,586226,0,587932,587932,0,-0.29017
17/03/2020 10:48,2019,65,FAR EAST,JAPAN,1,HEATHROW,TOKYO (NARITA),137180,137180,0,130054,130054,0,5.47926
17/03/2020 10:48,2019,65,FAR EAST,JAPAN,2,MANCHESTER,TOKYO (HANEDA),92,0,92,0,0,0,0
17/03/2020 10:48,2019,65,FAR EAST,MALAYSIA,1,GATWICK,LANGKAWI,5218,0,5218,585,0,585,791.96581
17/03/2020 10:48,2019,65,FAR EAST,MALAYSIA,1,HEATHROW,KUALA LUMPUR (SEPANG),478219,478219,0,521674,521674,0,-8.32991
17/03/2020 10:48,2019,65,FAR EAST,MALAYSIA,2,BIRMINGHAM,LANGKAWI,5268,0,5268,582,0,582,805.15464
17/03/2020 10:48,2019,65,FAR EAST,MALAYSIA,2,MANCHESTER,LANGKAWI,5251,0,5251,582,0,582,802.23368
17/03/2020 10:48,2019,65,FAR EAST,MONGOLIA,1,GATWICK,ULAN BATOR,0,0,0,80,0,80,-100
17/03/2020 10:48,2019,65,FAR EAST,PHILIPPINES,1,HEATHROW,MANILA,111217,111217,0,161339,161339,0,-31.06626
17/03/2020 10:48,2019,65,FAR EAST,REPUBLIC OF KOREA,1,GATWICK,SEOUL (INCHEON),0,0,0,186,0,186,-100
17/03/2020 10:48,2019,65,FAR EAST,REPUBLIC OF KOREA,1,HEATHROW,SEOUL (INCHEON),528363,528363,0,526584,526584,0,0.33784
17/03/2020 10:48,2019,65,FAR EAST,REPUBLIC OF KOREA,2,GLASGOW,SEOUL (INCHEON),0,0,0,320,0,320,-100
17/03/2020 10:48,2019,65,FAR EAST,SINGAPORE,1,GATWICK,SINGAPORE,4228,4228,0,119140,119140,0,-96.45123
17/03/2020 10:48,2019,65,FAR EAST,SINGAPORE,1,HEATHROW,SINGAPORE,1526634,1526634,0,1421105,1421105,0,7.42584
17/03/2020 10:48,2019,65,FAR EAST,SINGAPORE,2,MANCHESTER,SINGAPORE,92381,92381,0,83766,83766,0,10.2846
17/03/2020 10:48,2019,65,FAR EAST,TAIWAN,1,GATWICK,TAIPEI,112445,112445,0,114895,114895,0,-2.13238
17/03/2020 10:48,2019,65,FAR EAST,TAIWAN,1,HEATHROW,TAIPEI,30465,30465,0,31225,31225,0,-2.43395
17/03/2020 10:48,2019,65,FAR EAST,THAILAND,1,GATWICK,KRABI,0,0,0,4915,0,4915,-100
17/03/2020 10:48,2019,65,FAR EAST,THAILAND,1,GATWICK,PHUKET,14195,0,14195,13970,0,13970,1.61059
17/03/2020 10:48,2019,65,FAR EAST,THAILAND,1,GATWICK,U-TAPAO,4488,0,4488,585,0,585,667.17949
17/03/2020 10:48,2019,65,FAR EAST,THAILAND,1,HEATHROW,BANGKOK SUVARNABHUMI ,863175,863175,0,828432,828432,0,4.19383
17/03/2020 10:48,2019,65,FAR EAST,THAILAND,2,BIRMINGHAM,PHUKET,0,0,0,4988,0,4988,-100
17/03/2020 10:48,2019,65,FAR EAST,THAILAND,2,BIRMINGHAM,U-TAPAO,4661,0,4661,588,0,588,692.68707
17/03/2020 10:48,2019,65,FAR EAST,THAILAND,2,MANCHESTER,PHUKET,13205,0,13205,7900,0,7900,67.1519
17/03/2020 10:48,2019,65,FAR EAST,THAILAND,2,MANCHESTER,U-TAPAO,4627,0,4627,0,0,0,0
17/03/2020 10:48,2019,65,FAR EAST,VIETNAM,1,GATWICK,PHU QUOC INTERNATIONAL,8331,0,8331,10074,0,10074,-17.30197
17/03/2020 10:48,2019,65,FAR EAST,VIETNAM,1,HEATHROW,HANOI,89598,89598,0,86576,86576,0,3.49057
17/03/2020 10:48,2019,65,FAR EAST,VIETNAM,1,HEATHROW,HO CHI MINH CITY,65413,65413,0,65749,65749,0,-0.51103
17/03/2020 10:48,2019,70,AUSTRALASIA,AUSTRALIA,1,HEATHROW,MELBOURNE,16769,16769,0,51499,51499,0,-67.4382
17/03/2020 10:48,2019,70,AUSTRALASIA,AUSTRALIA,1,HEATHROW,PERTH (AUSTRALIA),141724,141724,0,108737,108737,0,30.3365
17/03/2020 10:48,2019,70,AUSTRALASIA,AUSTRALIA,1,HEATHROW,SYDNEY,179503,179465,38,192603,192603,0,-6.80156
17/03/2020 10:48,2019,70,AUSTRALASIA,NEW ZEALAND,1,HEATHROW,AUCKLAND INTERNATIONAL,17895,17895,0,17419,17419,0,2.73265
17/03/2020 10:48,2019,75,CANADA,CANADA,1,GATWICK,CALGARY,179185,179185,0,134547,134547,0,33.17651
17/03/2020 10:48,2019,75,CANADA,CANADA,1,GATWICK,EDMONTON,5430,5430,0,11070,11070,0,-50.94851
17/03/2020 10:48,2019,75,CANADA,CANADA,1,GATWICK,GANDER,0,0,0,342,342,0,-100
17/03/2020 10:48,2019,75,CANADA,CANADA,1,GATWICK,HALIFAX INT,36559,36559,0,49572,49572,0,-26.25071
17/03/2020 10:48,2019,75,CANADA,CANADA,1,GATWICK,MONTREAL (DORVAL),28158,28158,0,25226,25226,0,11.62293
17/03/2020 10:48,2019,75,CANADA,CANADA,1,GATWICK,OTTAWA INTERNATIONAL,0,0,0,774,774,0,-100
17/03/2020 10:48,2019,75,CANADA,CANADA,1,GATWICK,ST JOHNS,0,0,0,500,500,0,-100
17/03/2020 10:48,2019,75,CANADA,CANADA,1,GATWICK,TORONTO,436800,436800,0,431505,431505,0,1.2271
17/03/2020 10:48,2019,75,CANADA,CANADA,1,GATWICK,VANCOUVER,154191,154191,0,163669,163669,0,-5.79096
17/03/2020 10:48,2019,75,CANADA,CANADA,1,GATWICK,WINNIPEG,5248,5248,0,5553,5553,0,-5.49253
17/03/2020 10:48,2019,75,CANADA,CANADA,1,HEATHROW,CALGARY,259720,259720,0,291248,291248,0,-10.82514
17/03/2020 10:48,2019,75,CANADA,CANADA,1,HEATHROW,HALIFAX INT,9884,9884,0,71799,71799,0,-86.23379
17/03/2020 10:48,2019,75,CANADA,CANADA,1,HEATHROW,MONTREAL (DORVAL),320213,320213,0,321085,321085,0,-0.27158
17/03/2020 10:48,2019,75,CANADA,CANADA,1,HEATHROW,OTTAWA INTERNATIONAL,117614,117614,0,114365,114365,0,2.8409
17/03/2020 10:48,2019,75,CANADA,CANADA,1,HEATHROW,ST JOHNS,3318,3318,0,39606,39606,0,-91.62248
17/03/2020 10:48,2019,75,CANADA,CANADA,1,HEATHROW,TORONTO,1151792,1151792,0,1091315,1091315,0,5.54166
17/03/2020 10:48,2019,75,CANADA,CANADA,1,HEATHROW,VANCOUVER,542568,542568,0,546666,546666,0,-0.74964
17/03/2020 10:48,2019,75,CANADA,CANADA,1,STANSTED,HALIFAX INT,48,0,48,0,0,0,0
17/03/2020 10:48,2019,75,CANADA,CANADA,1,STANSTED,TORONTO,0,0,0,20211,20211,0,-100
17/03/2020 10:48,2019,75,CANADA,CANADA,2,ABERDEEN,TORONTO,57,0,57,0,0,0,0
17/03/2020 10:48,2019,75,CANADA,CANADA,2,BELFAST INTERNATIONAL,MONTREAL (DORVAL),10,0,10,0,0,0,0
17/03/2020 10:48,2019,75,CANADA,CANADA,2,BIRMINGHAM,MONTREAL (DORVAL),0,0,0,48,0,48,-100
17/03/2020 10:48,2019,75,CANADA,CANADA,2,BIRMINGHAM,TORONTO,0,0,0,467,467,0,-100
17/03/2020 10:48,2019,75,CANADA,CANADA,2,EDINBURGH,TORONTO,32396,32396,0,30316,30316,0,6.86106
17/03/2020 10:48,2019,75,CANADA,CANADA,2,GLASGOW,CALGARY,0,0,0,248,248,0,-100
17/03/2020 10:48,2019,75,CANADA,CANADA,2,GLASGOW,HALIFAX INT,30357,30357,0,614,614,0,4844.13681
17/03/2020 10:48,2019,75,CANADA,CANADA,2,GLASGOW,TORONTO,103956,103956,0,137736,137736,0,-24.52518
17/03/2020 10:48,2019,75,CANADA,CANADA,2,GLASGOW,VANCOUVER,0,0,0,13126,13126,0,-100
17/03/2020 10:48,2019,75,CANADA,CANADA,2,HUMBERSIDE,HALIFAX INT,32,0,32,0,0,0,0
17/03/2020 10:48,2019,75,CANADA,CANADA,2,LEEDS BRADFORD,TORONTO,0,0,0,57,11,46,-100
17/03/2020 10:48,2019,75,CANADA,CANADA,2,MANCHESTER,IQALUIT,0,0,0,1,1,0,-100
17/03/2020 10:48,2019,75,CANADA,CANADA,2,MANCHESTER,MONTREAL (DORVAL),74,0,74,0,0,0,0
17/03/2020 10:48,2019,75,CANADA,CANADA,2,MANCHESTER,TORONTO,149933,149933,0,134653,134653,0,11.34769
17/03/2020 10:48,2019,75,CANADA,CANADA,2,MANCHESTER,VANCOUVER,35557,35557,0,34925,34925,0,1.80959
17/03/2020 10:48,2019,80,UNITED STATES OF AMERICA,USA,1,GATWICK,ATLANTA,175,175,0,0,0,0,0
17/03/2020 10:48,2019,80,UNITED STATES OF AMERICA,USA,1,GATWICK,AUSTIN (BERGSTROM),62740,62740,0,54214,54214,0,15.72657
17/03/2020 10:48,2019,80,UNITED STATES OF AMERICA,USA,1,GATWICK,BOSTON,221024,221024,0,209106,209106,0,5.6995
17/03/2020 10:48,2019,80,UNITED STATES OF AMERICA,USA,1,GATWICK,CHICAGO (O'HARE),98447,98447,0,145697,145697,0,-32.43032
17/03/2020 10:48,2019,80,UNITED STATES OF AMERICA,USA,1,GATWICK,CINCINNATI,154,0,154,0,0,0,0
17/03/2020 10:48,2019,80,UNITED STATES OF AMERICA,USA,1,GATWICK,DENVER INTERNATIONAL,71140,71140,0,84217,84217,0,-15.52774
17/03/2020 10:48,2019,80,UNITED STATES OF AMERICA,USA,1,GATWICK,FORT LAUDERDALE,97296,97296,0,179438,179438,0,-45.77737
17/03/2020 10:48,2019,80,UNITED STATES OF AMERICA,USA,1,GATWICK,LAS VEGAS,175567,175567,0,306923,306923,0,-42.7977
17/03/2020 10:48,2019,80,UNITED STATES OF AMERICA,USA,1,GATWICK,LOS ANGELES INTERNATIONAL,233689,233689,0,283710,283710,0,-17.63103
17/03/2020 10:48,2019,80,UNITED STATES OF AMERICA,USA,1,GATWICK,MIAMI INTERNATIONAL,143524,143524,0,0,0,0,0
17/03/2020 10:48,2019,80,UNITED STATES OF AMERICA,USA,1,GATWICK,NEW YORK (JF KENNEDY),699766,699688,78,593620,593300,320,17.88114
17/03/2020 10:48,2019,80,UNITED STATES OF AMERICA,USA,1,GATWICK,NEW YORK (NEWARK),540,540,0,0,0,0,0
17/03/2020 10:48,2019,80,UNITED STATES OF AMERICA,USA,1,GATWICK,NEWBURGH/USA,0,0,0,344,344,0,-100
17/03/2020 10:48,2019,80,UNITED STATES OF AMERICA,USA,1,GATWICK,OAKLAND,22609,22609,0,193615,193448,167,-88.3227
17/03/2020 10:48,2019,80,UNITED STATES OF AMERICA,USA,1,GATWICK,ORLANDO,973978,973204,774,876408,876102,306,11.13294
17/03/2020 10:48,2019,80,UNITED STATES OF AMERICA,USA,1,GATWICK,PHILADELPHIA INTERNATIONAL,32,32,0,0,0,0,0
17/03/2020 10:48,2019,80,UNITED STATES OF AMERICA,USA,1,GATWICK,SAN FRANCISCO,116728,116551,177,0,0,0,0
17/03/2020 10:48,2019,80,UNITED STATES OF AMERICA,USA,1,GATWICK,SANFORD,36311,346,35965,40391,0,40391,-10.10126
17/03/2020 10:48,2019,80,UNITED STATES OF AMERICA,USA,1,GATWICK,SEATTLE (TACOMA),72600,72600,0,95714,95549,165,-24.14903
17/03/2020 10:48,2019,80,UNITED STATES OF AMERICA,USA,1,GATWICK,TAMPA,234071,233636,435,156527,156527,0,49.54033
17/03/2020 10:48,2019,80,UNITED STATES OF AMERICA,USA,1,GATWICK,TETERBORO,1,0,1,0,0,0,0
17/03/2020 10:48,2019,80,UNITED STATES OF AMERICA,USA,1,HEATHROW,ATLANTA,621852,621694,158,617007,617007,0,0.78524
17/03/2020 10:48,2019,80,UNITED STATES OF AMERICA,USA,1,HEATHROW,AUSTIN (BERGSTROM),188349,188349,0,171798,171798,0,9.63399
17/03/2020 10:48,2019,80,UNITED STATES OF AMERICA,USA,1,HEATHROW,BALTIMORE,136538,136538,0,128387,128387,0,6.34877
17/03/2020 10:48,2019,80,UNITED STATES OF AMERICA,USA,1,HEATHROW,BOSTON,970239,970239,0,849443,849443,0,14.22061
17/03/2020 10:48,2019,80,UNITED STATES OF AMERICA,USA,1,HEATHROW,CHARLESTON,19503,19503,0,0,0,0,0
17/03/2020 10:48,2019,80,UNITED STATES OF AMERICA,USA,1,HEATHROW,CHARLOTTE,319493,319342,151,302048,302048,0,5.77557
17/03/2020 10:48,2019,80,UNITED STATES OF AMERICA,USA,1,HEATHROW,CHICAGO (O'HARE),1250426,1250019,407,1158537,1158537,0,7.93147
17/03/2020 10:48,2019,80,UNITED STATES OF AMERICA,USA,1,HEATHROW,CINCINNATI,154,0,154,0,0,0,0
17/03/2020 10:48,2019,80,UNITED STATES OF AMERICA,USA,1,HEATHROW,CLEVELAND,0,0,0,147,0,147,-100
17/03/2020 10:48,2019,80,UNITED STATES OF AMERICA,USA,1,HEATHROW,DALLAS/FORT WORTH,778797,778797,0,710461,710461,0,9.61854
17/03/2020 10:48,2019,80,UNITED STATES OF AMERICA,USA,1,HEATHROW,DENVER INTERNATIONAL,306275,306275,0,282201,282201,0,8.5308
17/03/2020 10:48,2019,80,UNITED STATES OF AMERICA,USA,1,HEATHROW,DETROIT,236225,236225,0,190484,190484,0,24.01304
17/03/2020 10:48,2019,80,UNITED STATES OF AMERICA,USA,1,HEATHROW,HOUSTON,517011,516678,333,500856,500856,0,3.22548
17/03/2020 10:48,2019,80,UNITED STATES OF AMERICA,USA,1,HEATHROW,INDIANAPOLIS,165,0,165,0,0,0,0
17/03/2020 10:48,2019,80,UNITED STATES OF AMERICA,USA,1,HEATHROW,JACKSONVILLE,412,0,412,415,0,415,-0.72289
17/03/2020 10:48,2019,80,UNITED STATES OF AMERICA,USA,1,HEATHROW,LAS VEGAS,352828,352828,0,297490,297490,0,18.60163
17/03/2020 10:48,2019,80,UNITED STATES OF AMERICA,USA,1,HEATHROW,LOS ANGELES INTERNATIONAL,1602892,1602725,167,1657737,1657580,157,-3.30843
17/03/2020 10:48,2019,80,UNITED STATES OF AMERICA,USA,1,HEATHROW,MIAMI INTERNATIONAL,1069986,1069986,0,1029366,1029176,190,3.94612
17/03/2020 10:48,2019,80,UNITED STATES OF AMERICA,USA,1,HEATHROW,MINNEAPOLIS-ST PAUL,136000,136000,0,131244,131244,0,3.62378
17/03/2020 10:48,2019,80,UNITED STATES OF AMERICA,USA,1,HEATHROW,NASHVILLE METROPOLITAN,100918,100918,0,58512,58183,329,72.47402
17/03/2020 10:48,2019,80,UNITED STATES OF AMERICA,USA,1,HEATHROW,NEW ORLEANS,86390,86390,0,85932,85932,0,0.53298
17/03/2020 10:48,2019,80,UNITED STATES OF AMERICA,USA,1,HEATHROW,NEW YORK (JF KENNEDY),3192195,3191631,564,3034155,3034155,0,5.2087
17/03/2020 10:48,2019,80,UNITED STATES OF AMERICA,USA,1,HEATHROW,NEW YORK (NEWARK),977730,977730,0,1084275,1084275,0,-9.82638
17/03/2020 10:48,2019,80,UNITED STATES OF AMERICA,USA,1,HEATHROW,OAKLAND,0,0,0,164,0,164,-100
17/03/2020 10:48,2019,80,UNITED STATES OF AMERICA,USA,1,HEATHROW,ORLANDO,1107,775,332,2268,1611,657,-51.19048
17/03/2020 10:48,2019,80,UNITED STATES OF AMERICA,USA,1,HEATHROW,PHILADELPHIA INTERNATIONAL,480513,480513,0,466399,465749,650,3.02616
17/03/2020 10:48,2019,80,UNITED STATES OF AMERICA,USA,1,HEATHROW,PHOENIX,312469,312469,0,248620,248620,0,25.68136
17/03/2020 10:48,2019,80,UNITED STATES OF AMERICA,USA,1,HEATHROW,PITTSBURGH,51602,51602,0,0,0,0,0
17/03/2020 10:48,2019,80,UNITED STATES OF AMERICA,USA,1,HEATHROW,PORTLAND (OREGON),57481,57481,0,32248,32248,0,78.24671
17/03/2020 10:48,2019,80,UNITED STATES OF AMERICA,USA,1,HEATHROW,RALEIGH,143348,143348,0,132254,132254,0,8.3884
17/03/2020 10:48,2019,80,UNITED STATES OF AMERICA,USA,1,HEATHROW,SALT LAKE CITY,80607,80607,0,71790,71790,0,12.28165
17/03/2020 10:48,2019,80,UNITED STATES OF AMERICA,USA,1,HEATHROW,SAN DIEGO,173448,173448,0,173771,173771,0,-0.18588
17/03/2020 10:48,2019,80,UNITED STATES OF AMERICA,USA,1,HEATHROW,SAN FRANCISCO,1075554,1075554,0,1055976,1055976,0,1.85402
17/03/2020 10:48,2019,80,UNITED STATES OF AMERICA,USA,1,HEATHROW,SAN JOSE,117896,117896,0,110016,110016,0,7.16259
17/03/2020 10:48,2019,80,UNITED STATES OF AMERICA,USA,1,HEATHROW,SEATTLE (TACOMA),426192,426192,0,397356,397356,0,7.25697
17/03/2020 10:48,2019,80,UNITED STATES OF AMERICA,USA,1,HEATHROW,WASHINGTON (DULLES),842269,841889,380,838389,838389,0,0.46279
17/03/2020 10:48,2019,80,UNITED STATES OF AMERICA,USA,1,LONDON CITY,NEW YORK (JF KENNEDY),10461,10461,0,10558,10514,44,-0.91873
17/03/2020 10:48,2019,80,UNITED STATES OF AMERICA,USA,1,LUTON,WASHINGTON (DULLES),15,0,15,0,0,0,0
17/03/2020 10:48,2019,80,UNITED STATES OF AMERICA,USA,1,STANSTED,BOSTON,24,0,24,22494,22494,0,-99.8933
17/03/2020 10:48,2019,80,UNITED STATES OF AMERICA,USA,1,STANSTED,CHARLOTTE,79,0,79,0,0,0,0
17/03/2020 10:48,2019,80,UNITED STATES OF AMERICA,USA,1,STANSTED,COLUMBUS,756,0,756,0,0,0,0
17/03/2020 10:48,2019,80,UNITED STATES OF AMERICA,USA,1,STANSTED,COLUMBUS RICKENBACKER AFB,252,0,252,0,0,0,0
17/03/2020 10:48,2019,80,UNITED STATES OF AMERICA,USA,1,STANSTED,LAS VEGAS,0,0,0,3347,3347,0,-100
17/03/2020 10:48,2019,80,UNITED STATES OF AMERICA,USA,1,STANSTED,NEW YORK (NEWARK),329,329,0,48216,48216,0,-99.31765
17/03/2020 10:48,2019,80,UNITED STATES OF AMERICA,USA,1,STANSTED,ORLANDO,0,0,0,12242,12242,0,-100
17/03/2020 10:48,2019,80,UNITED STATES OF AMERICA,USA,1,STANSTED,TAMPA,179,0,179,0,0,0,0
17/03/2020 10:48,2019,80,UNITED STATES OF AMERICA,USA,1,STANSTED,WASHINGTON (DULLES),0,0,0,6033,6033,0,-100
17/03/2020 10:48,2019,80,UNITED STATES OF AMERICA,USA,2,BELFAST INTERNATIONAL,BANGOR,0,0,0,4,0,4,-100
17/03/2020 10:48,2019,80,UNITED STATES OF AMERICA,USA,2,BELFAST INTERNATIONAL,LAS VEGAS,0,0,0,597,0,597,-100
17/03/2020 10:48,2019,80,UNITED STATES OF AMERICA,USA,2,BELFAST INTERNATIONAL,MEMPHIS,98,0,98,0,0,0,0
17/03/2020 10:48,2019,80,UNITED STATES OF AMERICA,USA,2,BELFAST INTERNATIONAL,MOLINE (QUAD CITY),51,0,51,0,0,0,0
17/03/2020 10:48,2019,80,UNITED STATES OF AMERICA,USA,2,BELFAST INTERNATIONAL,NEW YORK (NEWARK),0,0,0,322,322,0,-100
17/03/2020 10:48,2019,80,UNITED STATES OF AMERICA,USA,2,BELFAST INTERNATIONAL,NEWBURGH/USA,0,0,0,24261,24261,0,-100
17/03/2020 10:48,2019,80,UNITED STATES OF AMERICA,USA,2,BELFAST INTERNATIONAL,ORLANDO,17214,16051,1163,18565,17288,1277,-7.27713
17/03/2020 10:48,2019,80,UNITED STATES OF AMERICA,USA,2,BELFAST INTERNATIONAL,PROVIDENCE,0,0,0,13378,13378,0,-100
17/03/2020 10:48,2019,80,UNITED STATES OF AMERICA,USA,2,BIGGIN HILL,TETERBORO,0,0,0,2,0,2,-100
17/03/2020 10:48,2019,80,UNITED STATES OF AMERICA,USA,2,BIRMINGHAM,NEW YORK (NEWARK),0,0,0,7059,7059,0,-100
17/03/2020 10:48,2019,80,UNITED STATES OF AMERICA,USA,2,BIRMINGHAM,SANFORD,17803,0,17803,18066,0,18066,-1.45577
17/03/2020 10:48,2019,80,UNITED STATES OF AMERICA,USA,2,BIRMINGHAM,WASHINGTON (DULLES),319,319,0,0,0,0,0
17/03/2020 10:48,2019,80,UNITED STATES OF AMERICA,USA,2,BRISTOL,SANFORD,16497,0,16497,12816,0,12816,28.72191
17/03/2020 10:48,2019,80,UNITED STATES OF AMERICA,USA,2,CARDIFF WALES,BOSTON,2,2,0,0,0,0,0
17/03/2020 10:48,2019,80,UNITED STATES OF AMERICA,USA,2,CARDIFF WALES,ORLANDO,0,0,0,325,325,0,-100
17/03/2020 10:48,2019,80,UNITED STATES OF AMERICA,USA,2,CARDIFF WALES,TAMPA,0,0,0,276,276,0,-100
17/03/2020 10:48,2019,80,UNITED STATES OF AMERICA,USA,2,DONCASTER SHEFFIELD,NEW YORK (JF KENNEDY),0,0,0,332,332,0,-100
17/03/2020 10:48,2019,80,UNITED STATES OF AMERICA,USA,2,DONCASTER SHEFFIELD,SANFORD,10971,0,10971,0,0,0,0
17/03/2020 10:48,2019,80,UNITED STATES OF AMERICA,USA,2,EAST MIDLANDS INTERNATIONAL,NEW YORK (NEWARK),650,650,0,410,410,0,58.53659
17/03/2020 10:48,2019,80,UNITED STATES OF AMERICA,USA,2,EAST MIDLANDS INTERNATIONAL,SANFORD,11099,0,11099,10839,0,10839,2.39875
17/03/2020 10:48,2019,80,UNITED STATES OF AMERICA,USA,2,EDINBURGH,BOSTON,29296,29296,0,0,0,0,0
17/03/2020 10:48,2019,80,UNITED STATES OF AMERICA,USA,2,EDINBURGH,CHICAGO (O'HARE),47594,47594,0,52383,52383,0,-9.14228
17/03/2020 10:48,2019,80,UNITED STATES OF AMERICA,USA,2,EDINBURGH,COLUMBUS,261,0,261,0,0,0,0
17/03/2020 10:48,2019,80,UNITED STATES OF AMERICA,USA,2,EDINBURGH,COLUMBUS RICKENBACKER AFB,263,0,263,0,0,0,0
17/03/2020 10:48,2019,80,UNITED STATES OF AMERICA,USA,2,EDINBURGH,HOUSTON,0,0,0,266,266,0,-100
17/03/2020 10:48,2019,80,UNITED STATES OF AMERICA,USA,2,EDINBURGH,NEW YORK (JF KENNEDY),84532,84532,0,135142,135142,0,-37.4495
17/03/2020 10:48,2019,80,UNITED STATES OF AMERICA,USA,2,EDINBURGH,NEW YORK (NEWARK),113144,113144,0,108537,108537,0,4.24464
17/03/2020 10:48,2019,80,UNITED STATES OF AMERICA,USA,2,EDINBURGH,NEWBURGH/USA,10585,10585,0,64687,64687,0,-83.63659
17/03/2020 10:48,2019,80,UNITED STATES OF AMERICA,USA,2,EDINBURGH,PHILADELPHIA INTERNATIONAL,63347,63347,0,0,0,0,0
17/03/2020 10:48,2019,80,UNITED STATES OF AMERICA,USA,2,EDINBURGH,PORTLAND (MAINE),155,155,0,0,0,0,0
17/03/2020 10:48,2019,80,UNITED STATES OF AMERICA,USA,2,EDINBURGH,PROVIDENCE,0,0,0,31898,31898,0,-100
17/03/2020 10:48,2019,80,UNITED STATES OF AMERICA,USA,2,EDINBURGH,SANFORD,2329,0,2329,2157,0,2157,7.97404
17/03/2020 10:48,2019,80,UNITED STATES OF AMERICA,USA,2,EDINBURGH,WASHINGTON (DULLES),38289,38289,0,37150,37150,0,3.06595
17/03/2020 10:48,2019,80,UNITED STATES OF AMERICA,USA,2,EDINBURGH,WINDSOR LOCKS BRADLEY INTL,0,0,0,3656,3656,0,-100
17/03/2020 10:48,2019,80,UNITED STATES OF AMERICA,USA,2,GLASGOW,LAS VEGAS,639,639,0,11725,11725,0,-94.55011
17/03/2020 10:48,2019,80,UNITED STATES OF AMERICA,USA,2,GLASGOW,NEW YORK (JF KENNEDY),38104,38104,0,34154,34154,0,11.56526
17/03/2020 10:48,2019,80,UNITED STATES OF AMERICA,USA,2,GLASGOW,NEW YORK (NEWARK),49228,49228,0,46448,46005,443,5.98519
17/03/2020 10:48,2019,80,UNITED STATES OF AMERICA,USA,2,GLASGOW,ORLANDO,74419,73987,432,88106,88106,0,-15.5347
17/03/2020 10:48,2019,80,UNITED STATES OF AMERICA,USA,2,GLASGOW,PHILADELPHIA INTERNATIONAL,0,0,0,42167,42167,0,-100
17/03/2020 10:48,2019,80,UNITED STATES OF AMERICA,USA,2,GLASGOW,SANFORD,17298,8,17290,23072,0,23072,-25.02601
17/03/2020 10:48,2019,80,UNITED STATES OF AMERICA,USA,2,LEEDS BRADFORD,NEW YORK (NEWARK),1776,1776,0,3090,3090,0,-42.52427
17/03/2020 10:48,2019,80,UNITED STATES OF AMERICA,USA,2,LIVERPOOL (JOHN LENNON),LOS ANGELES INTERNATIONAL,3,0,3,0,0,0,0
17/03/2020 10:48,2019,80,UNITED STATES OF AMERICA,USA,2,LIVERPOOL (JOHN LENNON),NEW YORK (JF KENNEDY),0,0,0,326,326,0,-100
17/03/2020 10:48,2019,80,UNITED STATES OF AMERICA,USA,2,MANCHESTER,ATLANTA,174853,174853,0,118245,118245,0,47.87348
17/03/2020 10:48,2019,80,UNITED STATES OF AMERICA,USA,2,MANCHESTER,BOSTON,23172,23172,0,44489,44489,0,-47.91521
17/03/2020 10:48,2019,80,UNITED STATES OF AMERICA,USA,2,MANCHESTER,CHARLOTTE,0,0,0,106,0,106,-100
17/03/2020 10:48,2019,80,UNITED STATES OF AMERICA,USA,2,MANCHESTER,CHICAGO (O'HARE),0,0,0,34426,34339,87,-100
17/03/2020 10:48,2019,80,UNITED STATES OF AMERICA,USA,2,MANCHESTER,DALLAS/FORT WORTH,0,0,0,131,131,0,-100
17/03/2020 10:48,2019,80,UNITED STATES OF AMERICA,USA,2,MANCHESTER,DETROIT,0,0,0,118,0,118,-100
17/03/2020 10:48,2019,80,UNITED STATES OF AMERICA,USA,2,MANCHESTER,HOUSTON,67967,67967,0,62580,62580,0,8.60818
17/03/2020 10:48,2019,80,UNITED STATES OF AMERICA,USA,2,MANCHESTER,LAS VEGAS,130542,130542,0,142334,142334,0,-8.28474
17/03/2020 10:48,2019,80,UNITED STATES OF AMERICA,USA,2,MANCHESTER,LOS ANGELES INTERNATIONAL,47163,47163,0,42921,42819,102,9.88327
17/03/2020 10:48,2019,80,UNITED STATES OF AMERICA,USA,2,MANCHESTER,MIAMI INTERNATIONAL,0,0,0,197,0,197,-100
17/03/2020 10:48,2019,80,UNITED STATES OF AMERICA,USA,2,MANCHESTER,NEW YORK (JF KENNEDY),341820,341820,0,347873,347873,0,-1.74
17/03/2020 10:48,2019,80,UNITED STATES OF AMERICA,USA,2,MANCHESTER,NEW YORK (NEWARK),143746,143594,152,113097,113097,0,27.09975
17/03/2020 10:48,2019,80,UNITED STATES OF AMERICA,USA,2,MANCHESTER,ORLANDO,485690,484698,992,484811,484811,0,0.18131
17/03/2020 10:48,2019,80,UNITED STATES OF AMERICA,USA,2,MANCHESTER,PHILADELPHIA INTERNATIONAL,119813,119813,0,129394,129394,0,-7.40452
17/03/2020 10:48,2019,80,UNITED STATES OF AMERICA,USA,2,MANCHESTER,SAN FRANCISCO,32060,32060,0,62331,62331,0,-48.56492
17/03/2020 10:48,2019,80,UNITED STATES OF AMERICA,USA,2,MANCHESTER,SANFORD,39709,0,39709,39320,0,39320,0.98932
17/03/2020 10:48,2019,80,UNITED STATES OF AMERICA,USA,2,MANCHESTER,SEATTLE (TACOMA),13160,13160,0,18867,18867,0,-30.24858
17/03/2020 10:48,2019,80,UNITED STATES OF AMERICA,USA,2,MANCHESTER,SOUTH BEND (MICHIANA),147,0,147,0,0,0,0
17/03/2020 10:48,2019,80,UNITED STATES OF AMERICA,USA,2,MANCHESTER,WASHINGTON (DULLES),0,0,0,547,547,0,-100
17/03/2020 10:48,2019,80,UNITED STATES OF AMERICA,USA,2,NEWCASTLE,NEW YORK (NEWARK),2795,2795,0,3147,3147,0,-11.18526
17/03/2020 10:48,2019,80,UNITED STATES OF AMERICA,USA,2,NEWCASTLE,SANFORD,14607,14607,0,22579,22579,0,-35.30714
17/03/2020 10:48,2019,80,UNITED STATES OF AMERICA,USA,2,PRESTWICK,NEW YORK (JF KENNEDY),127,0,127,0,0,0,0
17/03/2020 10:48,2019,85,CENTRAL AMERICA,COSTA RICA,1,GATWICK,LIBERIA,30665,0,30665,30409,0,30409,0.84186
17/03/2020 10:48,2019,85,CENTRAL AMERICA,COSTA RICA,1,GATWICK,SAN JOSE COST RICA,57189,57189,0,54659,54659,0,4.6287
17/03/2020 10:48,2019,85,CENTRAL AMERICA,CUBA,1,GATWICK,CUNAGUA (CAYO COCO),14044,14003,41,17163,17163,0,-18.17281
17/03/2020 10:48,2019,85,CENTRAL AMERICA,CUBA,1,GATWICK,HAVANA,49643,49643,0,77462,77381,81,-35.91309
17/03/2020 10:48,2019,85,CENTRAL AMERICA,CUBA,1,GATWICK,HOLGUIN (FRANK PAIS),23371,23120,251,31796,31796,0,-26.49704
17/03/2020 10:48,2019,85,CENTRAL AMERICA,CUBA,1,GATWICK,VARADERO,0,0,0,25512,0,25512,-100
17/03/2020 10:48,2019,85,CENTRAL AMERICA,CUBA,1,HEATHROW,HAVANA,0,0,0,385,385,0,-100
17/03/2020 10:48,2019,85,CENTRAL AMERICA,CUBA,2,GLASGOW,CUNAGUA (CAYO COCO),648,648,0,640,640,0,1.25
17/03/2020 10:48,2019,85,CENTRAL AMERICA,CUBA,2,MANCHESTER,CUNAGUA (CAYO COCO),22431,22431,0,31124,31124,0,-27.93021
17/03/2020 10:48,2019,85,CENTRAL AMERICA,CUBA,2,MANCHESTER,HOLGUIN (FRANK PAIS),27961,27961,0,51886,51886,0,-46.1107
17/03/2020 10:48,2019,85,CENTRAL AMERICA,CUBA,2,MANCHESTER,SANTA CLARA,0,0,0,14492,14492,0,-100
17/03/2020 10:48,2019,85,CENTRAL AMERICA,CUBA,2,MANCHESTER,VARADERO,23661,23661,0,31626,31626,0,-25.18497
17/03/2020 10:48,2019,85,CENTRAL AMERICA,DOMINICAN REPUBLIC,1,GATWICK,LA ROMANA,0,0,0,6502,0,6502,-100
17/03/2020 10:48,2019,85,CENTRAL AMERICA,DOMINICAN REPUBLIC,1,GATWICK,PUERTO PLATA,0,0,0,9897,0,9897,-100
17/03/2020 10:48,2019,85,CENTRAL AMERICA,DOMINICAN REPUBLIC,1,GATWICK,PUNTA CANA,182397,98825,83572,168288,84743,83545,8.38384
17/03/2020 10:48,2019,85,CENTRAL AMERICA,DOMINICAN REPUBLIC,2,BIRMINGHAM,LA ROMANA,0,0,0,6102,0,6102,-100
17/03/2020 10:48,2019,85,CENTRAL AMERICA,DOMINICAN REPUBLIC,2,BIRMINGHAM,PUNTA CANA,37319,0,37319,34761,291,34470,7.35882
17/03/2020 10:48,2019,85,CENTRAL AMERICA,DOMINICAN REPUBLIC,2,BRISTOL,PUNTA CANA,0,0,0,14881,0,14881,-100
17/03/2020 10:48,2019,85,CENTRAL AMERICA,DOMINICAN REPUBLIC,2,GLASGOW,LA ROMANA,0,0,0,214,0,214,-100
17/03/2020 10:48,2019,85,CENTRAL AMERICA,DOMINICAN REPUBLIC,2,MANCHESTER,LA ROMANA,0,0,0,5856,0,5856,-100
17/03/2020 10:48,2019,85,CENTRAL AMERICA,DOMINICAN REPUBLIC,2,MANCHESTER,PUERTO PLATA,0,0,0,24452,0,24452,-100
17/03/2020 10:48,2019,85,CENTRAL AMERICA,DOMINICAN REPUBLIC,2,MANCHESTER,PUNTA CANA,96757,27862,68895,114169,50553,63616,-15.25108
17/03/2020 10:48,2019,85,CENTRAL AMERICA,MEXICO,1,GATWICK,CANCUN,337866,336248,1618,397071,397071,0,-14.91043
17/03/2020 10:48,2019,85,CENTRAL AMERICA,MEXICO,1,GATWICK,LOS CABOS,4009,0,4009,0,0,0,0
17/03/2020 10:48,2019,85,CENTRAL AMERICA,MEXICO,1,GATWICK,MERIDA,0,0,0,325,325,0,-100
17/03/2020 10:48,2019,85,CENTRAL AMERICA,MEXICO,1,GATWICK,PUERTO VALLARTA,25440,0,25440,30800,0,30800,-17.4026
17/03/2020 10:48,2019,85,CENTRAL AMERICA,MEXICO,1,HEATHROW,MEXICO CITY,261877,261877,0,253958,253958,0,3.11823
17/03/2020 10:48,2019,85,CENTRAL AMERICA,MEXICO,1,HEATHROW,PUERTO VALLARTA,287,0,287,0,0,0,0
17/03/2020 10:48,2019,85,CENTRAL AMERICA,MEXICO,1,STANSTED,CANCUN,0,0,0,7089,7089,0,-100
17/03/2020 10:48,2019,85,CENTRAL AMERICA,MEXICO,1,STANSTED,PUERTO VALLARTA,0,0,0,301,0,301,-100
17/03/2020 10:48,2019,85,CENTRAL AMERICA,MEXICO,2,BELFAST INTERNATIONAL,CANCUN,1260,0,1260,1288,0,1288,-2.17391
17/03/2020 10:48,2019,85,CENTRAL AMERICA,MEXICO,2,BIRMINGHAM,CANCUN,65236,65236,0,56410,56410,0,15.64616
17/03/2020 10:48,2019,85,CENTRAL AMERICA,MEXICO,2,BRISTOL,CANCUN,32191,26452,5739,13923,13637,286,131.20735
17/03/2020 10:48,2019,85,CENTRAL AMERICA,MEXICO,2,CARDIFF WALES,CANCUN,0,0,0,291,291,0,-100
17/03/2020 10:48,2019,85,CENTRAL AMERICA,MEXICO,2,EAST MIDLANDS INTERNATIONAL,CANCUN,10102,10102,0,11750,11750,0,-14.02553
17/03/2020 10:48,2019,85,CENTRAL AMERICA,MEXICO,2,EDINBURGH,CANCUN,2366,2366,0,2356,2356,0,0.42445
17/03/2020 10:48,2019,85,CENTRAL AMERICA,MEXICO,2,GLASGOW,CANCUN,42914,33392,9522,45948,22945,23003,-6.60312
17/03/2020 10:48,2019,85,CENTRAL AMERICA,MEXICO,2,MANCHESTER,CANCUN,283126,278648,4478,287877,287877,0,-1.65036
17/03/2020 10:48,2019,85,CENTRAL AMERICA,MEXICO,2,MANCHESTER,PUERTO VALLARTA,37980,0,37980,30578,0,30578,24.20695
17/03/2020 10:48,2019,85,CENTRAL AMERICA,MEXICO,2,NEWCASTLE,CANCUN,28067,28067,0,22868,22868,0,22.73483
17/03/2020 10:48,2019,90,SOUTH AMERICA,ARGENTINA,1,GATWICK,BUENOS AIRES,187531,187531,0,105918,105918,0,77.053
17/03/2020 10:48,2019,90,SOUTH AMERICA,ARGENTINA,1,HEATHROW,BUENOS AIRES,173728,173728,0,173064,173064,0,0.38367
17/03/2020 10:48,2019,90,SOUTH AMERICA,BRAZIL,1,GATWICK,MANAUS-EDUARDO GOMES,610,0,610,0,0,0,0
17/03/2020 10:48,2019,90,SOUTH AMERICA,BRAZIL,1,GATWICK,RIO DE JANEIRO (GALEAO),85554,85554,0,0,0,0,0
17/03/2020 10:48,2019,90,SOUTH AMERICA,BRAZIL,1,HEATHROW,RIO DE JANEIRO (GALEAO),137822,137822,0,122280,122280,0,12.71017
17/03/2020 10:48,2019,90,SOUTH AMERICA,BRAZIL,1,HEATHROW,SAO PAULO (GUARULHOS),450794,450794,0,451517,451517,0,-0.16013
17/03/2020 10:48,2019,90,SOUTH AMERICA,BRAZIL,2,MANCHESTER,MANAUS-EDUARDO GOMES,615,307,308,0,0,0,0
17/03/2020 10:48,2019,90,SOUTH AMERICA,CHILE,1,HEATHROW,SANTIAGO DE CHILE,93407,93407,0,78256,78256,0,19.36082
17/03/2020 10:48,2019,90,SOUTH AMERICA,COLOMBIA,1,HEATHROW,BOGOTA,161232,161232,0,162566,162566,0,-0.82059
17/03/2020 10:48,2019,90,SOUTH AMERICA,PERU,1,GATWICK,JORGE CHAVEZ INTERNATIONAL,43281,43281,0,45815,45815,0,-5.53094
17/03/2020 10:48,2019,95,CARIBBEAN AREA,ANTIGUA AND BARBUDA,1,GATWICK,ANTIGUA,193095,193095,0,161620,161620,0,19.47469
17/03/2020 10:48,2019,95,CARIBBEAN AREA,ANTIGUA AND BARBUDA,1,HEATHROW,ANTIGUA,0,0,0,268,268,0,-100
17/03/2020 10:48,2019,95,CARIBBEAN AREA,ANTIGUA AND BARBUDA,2,MANCHESTER,ANTIGUA,3910,3910,0,1220,1220,0,220.4918
17/03/2020 10:48,2019,95,CARIBBEAN AREA,BAHAMAS,1,HEATHROW,NASSAU,57335,57335,0,60556,60556,0,-5.31904
17/03/2020 10:48,2019,95,CARIBBEAN AREA,BARBADOS,1,GATWICK,BRIDGETOWN,506291,411954,94337,463991,388696,75295,9.11656
17/03/2020 10:48,2019,95,CARIBBEAN AREA,BARBADOS,1,HEATHROW,BRIDGETOWN,7448,7143,305,11840,9548,2292,-37.09459
17/03/2020 10:48,2019,95,CARIBBEAN AREA,BARBADOS,1,LUTON,BRIDGETOWN,0,0,0,300,300,0,-100
17/03/2020 10:48,2019,95,CARIBBEAN AREA,BARBADOS,1,STANSTED,BRIDGETOWN,546,0,546,581,0,581,-6.0241
17/03/2020 10:48,2019,95,CARIBBEAN AREA,BARBADOS,2,BELFAST INTERNATIONAL,BRIDGETOWN,578,0,578,590,0,590,-2.0339
17/03/2020 10:48,2019,95,CARIBBEAN AREA,BARBADOS,2,BIRMINGHAM,BRIDGETOWN,52370,0,52370,37959,0,37959,37.96465
17/03/2020 10:48,2019,95,CARIBBEAN AREA,BARBADOS,2,BOURNEMOUTH,BRIDGETOWN,1457,0,1457,1137,0,1137,28.14424
17/03/2020 10:48,2019,95,CARIBBEAN AREA,BARBADOS,2,BRISTOL,BRIDGETOWN,581,0,581,596,0,596,-2.51678
17/03/2020 10:48,2019,95,CARIBBEAN AREA,BARBADOS,2,CARDIFF WALES,BRIDGETOWN,4290,0,4290,3969,276,3693,8.08768
17/03/2020 10:48,2019,95,CARIBBEAN AREA,BARBADOS,2,DONCASTER SHEFFIELD,BRIDGETOWN,622,0,622,597,0,597,4.1876
17/03/2020 10:48,2019,95,CARIBBEAN AREA,BARBADOS,2,EAST MIDLANDS INTERNATIONAL,BRIDGETOWN,464,0,464,1173,0,1173,-60.44331
17/03/2020 10:48,2019,95,CARIBBEAN AREA,BARBADOS,2,GLASGOW,BRIDGETOWN,6705,0,6705,8100,0,8100,-17.22222
17/03/2020 10:48,2019,95,CARIBBEAN AREA,BARBADOS,2,MANCHESTER,BRIDGETOWN,145660,74575,71085,140161,79368,60793,3.92335
17/03/2020 10:48,2019,95,CARIBBEAN AREA,BARBADOS,2,NEWCASTLE,BRIDGETOWN,4785,4785,0,4054,4054,0,18.03157
17/03/2020 10:48,2019,95,CARIBBEAN AREA,BERMUDA,1,GATWICK,BERMUDA,98469,98469,0,94895,94595,300,3.76627
17/03/2020 10:48,2019,95,CARIBBEAN AREA,BERMUDA,2,HUMBERSIDE,BERMUDA,32,0,32,0,0,0,0
17/03/2020 10:48,2019,95,CARIBBEAN AREA,CAYMAN ISLANDS,1,HEATHROW,GRAND CAYMAN,38326,38326,0,35911,35911,0,6.72496
17/03/2020 10:48,2019,95,CARIBBEAN AREA,GRENADA,1,GATWICK,GRENADA,35992,35992,0,30763,30763,0,16.99769
17/03/2020 10:48,2019,95,CARIBBEAN AREA,GUADELOUPE,1,GATWICK,POINTE A PITRE GUADELOUPE,0,0,0,944,0,944,-100
17/03/2020 10:48,2019,95,CARIBBEAN AREA,ISLE OF CURACAO NETH.ANTILLES,1,GATWICK,ARUBA,13762,0,13762,13534,0,13534,1.68465
17/03/2020 10:48,2019,95,CARIBBEAN AREA,ISLE OF CURACAO NETH.ANTILLES,1,STANSTED,ARUBA,294,0,294,0,0,0,0
17/03/2020 10:48,2019,95,CARIBBEAN AREA,JAMAICA,1,GATWICK,KINGSTON,99935,99813,122,91204,91204,0,9.57305
17/03/2020 10:48,2019,95,CARIBBEAN AREA,JAMAICA,1,GATWICK,MONTEGO BAY,209524,101409,108115,213295,99241,114054,-1.76797
17/03/2020 10:48,2019,95,CARIBBEAN AREA,JAMAICA,1,HEATHROW,MONTEGO BAY,250,0,250,0,0,0,0
17/03/2020 10:48,2019,95,CARIBBEAN AREA,JAMAICA,1,STANSTED,KINGSTON,316,0,316,0,0,0,0
17/03/2020 10:48,2019,95,CARIBBEAN AREA,JAMAICA,1,STANSTED,MONTEGO BAY,1117,0,1117,612,0,612,82.51634
17/03/2020 10:48,2019,95,CARIBBEAN AREA,JAMAICA,2,BIRMINGHAM,MONTEGO BAY,47416,0,47416,47617,0,47617,-0.42212
17/03/2020 10:48,2019,95,CARIBBEAN AREA,JAMAICA,2,BRISTOL,MONTEGO BAY,600,0,600,0,0,0,0
17/03/2020 10:48,2019,95,CARIBBEAN AREA,JAMAICA,2,CARDIFF WALES,KINGSTON,0,0,0,183,183,0,-100
17/03/2020 10:48,2019,95,CARIBBEAN AREA,JAMAICA,2,CARDIFF WALES,MONTEGO BAY,1185,0,1185,2086,0,2086,-43.19271
17/03/2020 10:48,2019,95,CARIBBEAN AREA,JAMAICA,2,DONCASTER SHEFFIELD,MONTEGO BAY,609,0,609,0,0,0,0
17/03/2020 10:48,2019,95,CARIBBEAN AREA,JAMAICA,2,EAST MIDLANDS INTERNATIONAL,MONTEGO BAY,593,0,593,589,0,589,0.67912
17/03/2020 10:48,2019,95,CARIBBEAN AREA,JAMAICA,2,GLASGOW,MONTEGO BAY,4109,0,4109,4615,0,4615,-10.96425
17/03/2020 10:48,2019,95,CARIBBEAN AREA,JAMAICA,2,MANCHESTER,MONTEGO BAY,99610,12179,87431,82441,0,82441,20.8258
17/03/2020 10:48,2019,95,CARIBBEAN AREA,JAMAICA,2,NEWCASTLE,MONTEGO BAY,1199,1199,0,2258,2258,0,-46.89991
17/03/2020 10:48,2019,95,CARIBBEAN AREA,SAINT KITTS AND NEVIS,1,GATWICK,ST KITTS,18191,18191,0,16928,16928,0,7.46101
17/03/2020 10:48,2019,95,CARIBBEAN AREA,ST LUCIA,1,GATWICK,ST LUCIA (HEWANORRA),199288,167606,31682,200141,168763,31378,-0.4262
17/03/2020 10:48,2019,95,CARIBBEAN AREA,ST LUCIA,2,MANCHESTER,ST LUCIA (HEWANORRA),3389,3389,0,8999,8999,0,-62.34026
17/03/2020 10:48,2019,95,CARIBBEAN AREA,TRINIDAD AND TOBAGO,1,GATWICK,PORT OF SPAIN,66712,66712,0,60122,60122,0,10.96105
17/03/2020 10:48,2019,95,CARIBBEAN AREA,TRINIDAD AND TOBAGO,1,GATWICK,TOBAGO,28918,28918,0,33240,33240,0,-13.00241
17/03/2020 10:48,2019,95,CARIBBEAN AREA,TRINIDAD AND TOBAGO,2,MANCHESTER,TOBAGO,3462,3462,0,5804,5804,0,-40.35148
17/03/2020 10:48,2019,95,CARIBBEAN AREA,TURKS AND CAICOS ISLANDS,1,GATWICK,PROVIDENCIALES,12165,12165,0,16251,16251,0,-25.14307
17/03/2020 10:48,2019,100,INDIAN OCEAN ISLANDS,MALDIVE ISLANDS,1,GATWICK,MALE INTERNATIONAL,31893,31893,0,28678,28678,0,11.21068
17/03/2020 10:48,2019,100,INDIAN OCEAN ISLANDS,MALDIVE ISLANDS,1,HEATHROW,MALE INTERNATIONAL,0,0,0,242,242,0,-100
17/03/2020 10:48,2019,100,INDIAN OCEAN ISLANDS,MAURITIUS,1,GATWICK,MAURITIUS,132011,132011,0,131786,129722,2064,0.17073
17/03/2020 10:48,2019,100,INDIAN OCEAN ISLANDS,MAURITIUS,1,HEATHROW,MAURITIUS,86332,86332,0,88545,88545,0,-2.49929
17/03/2020 10:48,2019,100,INDIAN OCEAN ISLANDS,MAURITIUS,2,MANCHESTER,MAURITIUS,0,0,0,1471,0,1471,-100
17/03/2020 10:48,2019,100,INDIAN OCEAN ISLANDS,SEYCHELLES,1,HEATHROW,SEYCHELLES,38525,38525,0,28368,28368,0,35.80443
17/03/2020 10:48,2019,105,ATLANTIC OCEAN ISLANDS,CAPE VERDE ISLANDS,1,GATWICK,BOA VISTA (RABIL),88603,88603,0,68377,68377,0,29.58012
17/03/2020 10:48,2019,105,ATLANTIC OCEAN ISLANDS,CAPE VERDE ISLANDS,1,GATWICK,ILHA DO SAL C.VERDE,75882,75882,0,82010,81631,379,-7.47226
17/03/2020 10:48,2019,105,ATLANTIC OCEAN ISLANDS,CAPE VERDE ISLANDS,1,LUTON,BOA VISTA (RABIL),0,0,0,217,0,217,-100
17/03/2020 10:48,2019,105,ATLANTIC OCEAN ISLANDS,CAPE VERDE ISLANDS,1,LUTON,ILHA DO SAL C.VERDE,0,0,0,196,0,196,-100
17/03/2020 10:48,2019,105,ATLANTIC OCEAN ISLANDS,CAPE VERDE ISLANDS,1,STANSTED,ILHA DO SAL C.VERDE,0,0,0,228,228,0,-100
17/03/2020 10:48,2019,105,ATLANTIC OCEAN ISLANDS,CAPE VERDE ISLANDS,2,BIRMINGHAM,BOA VISTA (RABIL),43813,43813,0,24476,24476,0,79.00392
17/03/2020 10:48,2019,105,ATLANTIC OCEAN ISLANDS,CAPE VERDE ISLANDS,2,BIRMINGHAM,ILHA DO SAL C.VERDE,28881,28881,0,36812,35801,1011,-21.54461
17/03/2020 10:48,2019,105,ATLANTIC OCEAN ISLANDS,CAPE VERDE ISLANDS,2,BRISTOL,ILHA DO SAL C.VERDE,18084,10252,7832,24510,17996,6514,-26.21787
17/03/2020 10:48,2019,105,ATLANTIC OCEAN ISLANDS,CAPE VERDE ISLANDS,2,GLASGOW,ILHA DO SAL C.VERDE,0,0,0,16030,0,16030,-100
17/03/2020 10:48,2019,105,ATLANTIC OCEAN ISLANDS,CAPE VERDE ISLANDS,2,MANCHESTER,BOA VISTA (RABIL),65309,65309,0,64642,64424,218,1.03184
17/03/2020 10:48,2019,105,ATLANTIC OCEAN ISLANDS,CAPE VERDE ISLANDS,2,MANCHESTER,ILHA DO SAL C.VERDE,65631,65631,0,55256,54928,328,18.77624
17/03/2020 10:48,2019,115,OIL RIGS,OIL RIGS,2,ABERDEEN,OIL RIGS,425152,0,425152,381492,0,381492,11.44454
17/03/2020 10:48,2019,115,OIL RIGS,OIL RIGS,2,BLACKPOOL,OIL RIGS,15213,0,15213,19321,0,19321,-21.26184
17/03/2020 10:48,2019,115,OIL RIGS,OIL RIGS,2,HUMBERSIDE,OIL RIGS,20530,0,20530,21158,0,21158,-2.96814
17/03/2020 10:48,2019,115,OIL RIGS,OIL RIGS,2,INVERNESS,OIL RIGS,23,0,23,0,0,0,0
17/03/2020 10:48,2019,115,OIL RIGS,OIL RIGS,2,KIRKWALL,OIL RIGS,34,0,34,19,0,19,78.94737
17/03/2020 10:48,2019,115,OIL RIGS,OIL RIGS,2,NORWICH,OIL RIGS,88707,0,88707,93847,972,92875,-5.477
17/03/2020 10:48,2019,115,OIL RIGS,OIL RIGS,2,SCATSTA,OIL RIGS,50454,0,50454,81575,0,81575,-38.15017
17/03/2020 10:48,2019,115,OIL RIGS,OIL RIGS,2,SUMBURGH,OIL RIGS,62419,0,62419,24110,0,24110,158.89258

