rundate,this_period,last_period,grp_cd,grp_name,apt1_apt_name,apt2_apt_name,total_pax_tp,total_pax_shd_tp,total_pax_cht_tp,total_pax_lp,total_pax_shd_lp,total_pax_cht_lp,total_pax_pc
29/01/2018 17:02,2016,2015,A,London Area Airports,GATWICK,ABERDEEN,143651,143651,0,163184,163184,0,-11.96992
29/01/2018 17:02,2016,2015,A,London Area Airports,GATWICK,BELFAST CITY (GEORGE BEST),39662,39662,0,212897,212897,0,-81.37033
29/01/2018 17:02,2016,2015,A,London Area Airports,GATWICK,BELFAST INTERNATIONAL,858757,858744,13,470344,470344,0,82.58062
29/01/2018 17:02,2016,2015,A,London Area Airports,GATWICK,BIRMINGHAM,62,60,2,36,0,36,72.22222
29/01/2018 17:02,2016,2015,A,London Area Airports,GATWICK,BRISTOL,2,0,2,1,0,1,100
29/01/2018 17:02,2016,2015,A,London Area Airports,GATWICK,CARDIFF WALES,112,0,112,38,0,38,194.73684
29/01/2018 17:02,2016,2015,A,London Area Airports,GATWICK,DONCASTER SHEFFIELD,246,0,246,37,0,37,564.86486
29/01/2018 17:02,2016,2015,A,London Area Airports,GATWICK,DURHAM TEES VALLEY,124,0,124,74,0,74,67.56757
29/01/2018 17:02,2016,2015,A,London Area Airports,GATWICK,EAST MIDLANDS INTERNATIONAL,104,0,104,176,0,176,-40.90909
29/01/2018 17:02,2016,2015,A,London Area Airports,GATWICK,EDINBURGH,700064,699899,165,672948,672948,0,4.02943
29/01/2018 17:02,2016,2015,A,London Area Airports,GATWICK,EXETER,2,1,1,0,0,0,0
29/01/2018 17:02,2016,2015,A,London Area Airports,GATWICK,GLASGOW,608550,608381,169,612497,612329,168,-0.64441
29/01/2018 17:02,2016,2015,A,London Area Airports,GATWICK,GUERNSEY,311468,311468,0,317723,317723,0,-1.9687
29/01/2018 17:02,2016,2015,A,London Area Airports,GATWICK,HEATHROW,457,452,5,0,0,0,0
29/01/2018 17:02,2016,2015,A,London Area Airports,GATWICK,HUMBERSIDE,334,0,334,209,0,209,59.80861
29/01/2018 17:02,2016,2015,A,London Area Airports,GATWICK,INVERNESS,237927,237926,1,207074,207074,0,14.8995
29/01/2018 17:02,2016,2015,A,London Area Airports,GATWICK,ISLE OF MAN,155840,155840,0,144654,144654,0,7.73294
29/01/2018 17:02,2016,2015,A,London Area Airports,GATWICK,JERSEY,658968,658694,274,649377,649377,0,1.47695
29/01/2018 17:02,2016,2015,A,London Area Airports,GATWICK,LEEDS BRADFORD,213,138,75,141,0,141,51.06383
29/01/2018 17:02,2016,2015,A,London Area Airports,GATWICK,LIVERPOOL (JOHN LENNON),138,0,138,225,0,225,-38.66667
29/01/2018 17:02,2016,2015,A,London Area Airports,GATWICK,LONDON CITY,17,17,0,0,0,0,0
29/01/2018 17:02,2016,2015,A,London Area Airports,GATWICK,LUTON,2,0,2,0,0,0,0
29/01/2018 17:02,2016,2015,A,London Area Airports,GATWICK,MANCHESTER,478,249,229,650,0,650,-26.46154
29/01/2018 17:02,2016,2015,A,London Area Airports,GATWICK,NEWCASTLE,349,154,195,27699,27451,248,-98.74003
29/01/2018 17:02,2016,2015,A,London Area Airports,GATWICK,NEWQUAY,150137,150137,0,115899,115899,0,29.54124
29/01/2018 17:02,2016,2015,A,London Area Airports,GATWICK,NORWICH,38,0,38,0,0,0,0
29/01/2018 17:02,2016,2015,A,London Area Airports,GATWICK,SOUTHEND,1,0,1,0,0,0,0
29/01/2018 17:02,2016,2015,A,London Area Airports,GATWICK,STANSTED,2,0,2,0,0,0,0
29/01/2018 17:02,2016,2015,A,London Area Airports,GATWICK,WARTON,33,0,33,0,0,0,0
29/01/2018 17:02,2016,2015,A,London Area Airports,HEATHROW,ABERDEEN,592701,592701,0,726745,726745,0,-18.44443
29/01/2018 17:02,2016,2015,A,London Area Airports,HEATHROW,BELFAST CITY (GEORGE BEST),693937,693937,0,684255,684145,110,1.41497
29/01/2018 17:02,2016,2015,A,London Area Airports,HEATHROW,DURHAM TEES VALLEY,0,0,0,48,0,48,-100
29/01/2018 17:02,2016,2015,A,London Area Airports,HEATHROW,EDINBURGH,1053382,1053382,0,1383915,1383915,0,-23.88391
29/01/2018 17:02,2016,2015,A,London Area Airports,HEATHROW,GLASGOW,893846,893846,0,907873,907873,0,-1.54504
29/01/2018 17:02,2016,2015,A,London Area Airports,HEATHROW,HUMBERSIDE,0,0,0,24,0,24,-100
29/01/2018 17:02,2016,2015,A,London Area Airports,HEATHROW,INVERNESS,57879,57879,0,0,0,0,0
29/01/2018 17:02,2016,2015,A,London Area Airports,HEATHROW,LEEDS BRADFORD,160703,160703,0,148796,148796,0,8.00223
29/01/2018 17:02,2016,2015,A,London Area Airports,HEATHROW,LIVERPOOL (JOHN LENNON),0,0,0,155,0,155,-100
29/01/2018 17:02,2016,2015,A,London Area Airports,HEATHROW,MANCHESTER,692960,692923,37,776369,776334,35,-10.74347
29/01/2018 17:02,2016,2015,A,London Area Airports,HEATHROW,NEWCASTLE,499479,499479,0,513496,513321,175,-2.72972
29/01/2018 17:02,2016,2015,A,London Area Airports,LONDON CITY,ABERDEEN,64452,64452,0,63433,63433,0,1.60642
29/01/2018 17:02,2016,2015,A,London Area Airports,LONDON CITY,BELFAST CITY (GEORGE BEST),111944,111944,0,114940,114940,0,-2.60658
29/01/2018 17:02,2016,2015,A,London Area Airports,LONDON CITY,CARDIFF WALES,12425,12380,45,0,0,0,0
29/01/2018 17:02,2016,2015,A,London Area Airports,LONDON CITY,EDINBURGH,528029,527934,95,532857,532857,0,-0.90606
29/01/2018 17:02,2016,2015,A,London Area Airports,LONDON CITY,EXETER,38151,38151,0,49933,49933,0,-23.59562
29/01/2018 17:02,2016,2015,A,London Area Airports,LONDON CITY,GLASGOW,235075,235075,0,238413,238413,0,-1.40009
29/01/2018 17:02,2016,2015,A,London Area Airports,LONDON CITY,GUERNSEY,26442,26442,0,22338,22338,0,18.37228
29/01/2018 17:02,2016,2015,A,London Area Airports,LONDON CITY,INVERNESS,0,0,0,4866,4866,0,-100
29/01/2018 17:02,2016,2015,A,London Area Airports,LONDON CITY,ISLE OF MAN,74001,74001,0,58709,58709,0,26.04711
29/01/2018 17:02,2016,2015,A,London Area Airports,LONDON CITY,JERSEY,36987,36987,0,43344,43344,0,-14.66639
29/01/2018 17:02,2016,2015,A,London Area Airports,LONDON CITY,LIVERPOOL (JOHN LENNON),43,0,43,0,0,0,0
29/01/2018 17:02,2016,2015,A,London Area Airports,LONDON CITY,MANCHESTER,84,84,0,0,0,0,0
29/01/2018 17:02,2016,2015,A,London Area Airports,LONDON CITY,SOUTHEND,0,0,0,50,50,0,-100
29/01/2018 17:02,2016,2015,A,London Area Airports,LUTON,ABERDEEN,72149,72141,8,71242,71108,134,1.27313
29/01/2018 17:02,2016,2015,A,London Area Airports,LUTON,BELFAST CITY (GEORGE BEST),37,0,37,0,0,0,0
29/01/2018 17:02,2016,2015,A,London Area Airports,LUTON,BELFAST INTERNATIONAL,310431,310315,116,295292,294894,398,5.12679
29/01/2018 17:02,2016,2015,A,London Area Airports,LUTON,BIRMINGHAM,0,0,0,104,0,104,-100
29/01/2018 17:02,2016,2015,A,London Area Airports,LUTON,BOURNEMOUTH,64,0,64,0,0,0,0
29/01/2018 17:02,2016,2015,A,London Area Airports,LUTON,BRISTOL,0,0,0,4,0,4,-100
29/01/2018 17:02,2016,2015,A,London Area Airports,LUTON,CARDIFF WALES,74,0,74,68,0,68,8.82353
29/01/2018 17:02,2016,2015,A,London Area Airports,LUTON,CITY OF DERRY (EGLINTON),0,0,0,31,0,31,-100
29/01/2018 17:02,2016,2015,A,London Area Airports,LUTON,DONCASTER SHEFFIELD,0,0,0,56,0,56,-100
29/01/2018 17:02,2016,2015,A,London Area Airports,LUTON,DUNDEE,56,29,27,73,0,73,-23.28767
29/01/2018 17:02,2016,2015,A,London Area Airports,LUTON,DURHAM TEES VALLEY,103,0,103,407,0,407,-74.69287
29/01/2018 17:02,2016,2015,A,London Area Airports,LUTON,EAST MIDLANDS INTERNATIONAL,148,148,0,0,0,0,0
29/01/2018 17:02,2016,2015,A,London Area Airports,LUTON,EDINBURGH,272503,272446,57,266562,266460,102,2.22875
29/01/2018 17:02,2016,2015,A,London Area Airports,LUTON,GLASGOW,214693,214631,62,215052,215010,42,-0.16694
29/01/2018 17:02,2016,2015,A,London Area Airports,LUTON,HUMBERSIDE,177,0,177,63,0,63,180.95238
29/01/2018 17:02,2016,2015,A,London Area Airports,LUTON,INVERNESS,133945,133876,69,93517,93361,156,43.23064
29/01/2018 17:02,2016,2015,A,London Area Airports,LUTON,ISLE OF MAN,13,0,13,0,0,0,0
29/01/2018 17:02,2016,2015,A,London Area Airports,LUTON,JERSEY,36398,36398,0,80,0,80,45397.5
29/01/2018 17:02,2016,2015,A,London Area Airports,LUTON,LEEDS BRADFORD,21,0,21,156,0,156,-86.53846
29/01/2018 17:02,2016,2015,A,London Area Airports,LUTON,LIVERPOOL (JOHN LENNON),400,0,400,438,0,438,-8.6758
29/01/2018 17:02,2016,2015,A,London Area Airports,LUTON,MANCHESTER,588,0,588,696,0,696,-15.51724
29/01/2018 17:02,2016,2015,A,London Area Airports,LUTON,NEWCASTLE,379,0,379,674,0,674,-43.76855
29/01/2018 17:02,2016,2015,A,London Area Airports,LUTON,NEWQUAY,0,0,0,31,0,31,-100
29/01/2018 17:02,2016,2015,A,London Area Airports,LUTON,NORTHOLT,5,0,5,0,0,0,0
29/01/2018 17:02,2016,2015,A,London Area Airports,LUTON,NORWICH,6,0,6,61,0,61,-90.16393
29/01/2018 17:02,2016,2015,A,London Area Airports,LUTON,PRESTWICK,0,0,0,10,0,10,-100
29/01/2018 17:02,2016,2015,A,London Area Airports,LUTON,STANSTED,213,213,0,0,0,0,0
29/01/2018 17:02,2016,2015,A,London Area Airports,LUTON,WICK JOHN O GROATS,100,0,100,0,0,0,0
29/01/2018 17:02,2016,2015,A,London Area Airports,SOUTHEND,ABERDEEN,245,245,0,55,55,0,345.45455
29/01/2018 17:02,2016,2015,A,London Area Airports,SOUTHEND,BELFAST CITY (GEORGE BEST),315,315,0,0,0,0,0
29/01/2018 17:02,2016,2015,A,London Area Airports,SOUTHEND,BELFAST INTERNATIONAL,154,154,0,0,0,0,0
29/01/2018 17:02,2016,2015,A,London Area Airports,SOUTHEND,CARDIFF WALES,42,42,0,0,0,0,0
29/01/2018 17:02,2016,2015,A,London Area Airports,SOUTHEND,DUNDEE,22,22,0,0,0,0,0
29/01/2018 17:02,2016,2015,A,London Area Airports,SOUTHEND,EDINBURGH,424,424,0,0,0,0,0
29/01/2018 17:02,2016,2015,A,London Area Airports,SOUTHEND,EXETER,213,213,0,0,0,0,0
29/01/2018 17:02,2016,2015,A,London Area Airports,SOUTHEND,GLASGOW,100,100,0,0,0,0,0
29/01/2018 17:02,2016,2015,A,London Area Airports,SOUTHEND,GUERNSEY,193,193,0,0,0,0,0
29/01/2018 17:02,2016,2015,A,London Area Airports,SOUTHEND,ISLE OF MAN,133,133,0,0,0,0,0
29/01/2018 17:02,2016,2015,A,London Area Airports,SOUTHEND,JERSEY,23761,23761,0,21669,21669,0,9.65434
29/01/2018 17:02,2016,2015,A,London Area Airports,SOUTHEND,KIRKWALL,118,0,118,0,0,0,0
29/01/2018 17:02,2016,2015,A,London Area Airports,SOUTHEND,MANCHESTER,0,0,0,287,0,287,-100
29/01/2018 17:02,2016,2015,A,London Area Airports,SOUTHEND,NEWCASTLE,85,85,0,0,0,0,0
29/01/2018 17:02,2016,2015,A,London Area Airports,STANSTED,ABERDEEN,27,27,0,0,0,0,0
29/01/2018 17:02,2016,2015,A,London Area Airports,STANSTED,BELFAST INTERNATIONAL,363943,363943,0,323659,323659,0,12.44643
29/01/2018 17:02,2016,2015,A,London Area Airports,STANSTED,BIRMINGHAM,0,0,0,36,0,36,-100
29/01/2018 17:02,2016,2015,A,London Area Airports,STANSTED,BOURNEMOUTH,0,0,0,177,0,177,-100
29/01/2018 17:02,2016,2015,A,London Area Airports,STANSTED,CARDIFF WALES,0,0,0,115,0,115,-100
29/01/2018 17:02,2016,2015,A,London Area Airports,STANSTED,CITY OF DERRY (EGLINTON),116748,116748,0,126306,126306,0,-7.56734
29/01/2018 17:02,2016,2015,A,London Area Airports,STANSTED,DUNDEE,20852,20852,0,20377,20377,0,2.33106
29/01/2018 17:02,2016,2015,A,London Area Airports,STANSTED,EDINBURGH,836860,836696,164,622172,621689,483,34.50621
29/01/2018 17:02,2016,2015,A,London Area Airports,STANSTED,GLASGOW,652434,652434,0,533327,533327,0,22.33283
29/01/2018 17:02,2016,2015,A,London Area Airports,STANSTED,GUERNSEY,26778,26778,0,26901,26901,0,-0.45723
29/01/2018 17:02,2016,2015,A,London Area Airports,STANSTED,INVERNESS,56,0,56,0,0,0,0
29/01/2018 17:02,2016,2015,A,London Area Airports,STANSTED,ISLE OF MAN,8968,8968,0,45973,45973,0,-80.4929
29/01/2018 17:02,2016,2015,A,London Area Airports,STANSTED,LEEDS BRADFORD,0,0,0,41,0,41,-100
29/01/2018 17:02,2016,2015,A,London Area Airports,STANSTED,LIVERPOOL (JOHN LENNON),182,182,0,38,0,38,378.94737
29/01/2018 17:02,2016,2015,A,London Area Airports,STANSTED,LONDON CITY,65,65,0,0,0,0,0
29/01/2018 17:02,2016,2015,A,London Area Airports,STANSTED,MANCHESTER,18,0,18,0,0,0,0
29/01/2018 17:02,2016,2015,A,London Area Airports,STANSTED,NEWCASTLE,1790,1790,0,31392,30872,520,-94.29791
29/01/2018 17:02,2016,2015,A,London Area Airports,STANSTED,NEWQUAY,21364,21364,0,14438,14438,0,47.97063
29/01/2018 17:02,2016,2015,B,Other Reporting Airports,ABERDEEN,BELFAST CITY (GEORGE BEST),43082,43082,0,40026,40026,0,7.63504
29/01/2018 17:02,2016,2015,B,Other Reporting Airports,ABERDEEN,BELFAST INTERNATIONAL,207,0,207,0,0,0,0
29/01/2018 17:02,2016,2015,B,Other Reporting Airports,ABERDEEN,BIRMINGHAM,129606,129535,71,115812,115812,0,11.91068
29/01/2018 17:02,2016,2015,B,Other Reporting Airports,ABERDEEN,BOURNEMOUTH,92,0,92,0,0,0,0
29/01/2018 17:02,2016,2015,B,Other Reporting Airports,ABERDEEN,BRISTOL,21589,21589,0,26447,26447,0,-18.36881
29/01/2018 17:02,2016,2015,B,Other Reporting Airports,ABERDEEN,CARDIFF WALES,5601,5601,0,10578,10578,0,-47.05048
29/01/2018 17:02,2016,2015,B,Other Reporting Airports,ABERDEEN,CONINGSBY,20,20,0,0,0,0,0
29/01/2018 17:02,2016,2015,B,Other Reporting Airports,ABERDEEN,DONCASTER SHEFFIELD,0,0,0,98,0,98,-100
29/01/2018 17:02,2016,2015,B,Other Reporting Airports,ABERDEEN,DUNDEE,17,0,17,0,0,0,0
29/01/2018 17:02,2016,2015,B,Other Reporting Airports,ABERDEEN,DURHAM TEES VALLEY,13225,13159,66,28224,28224,0,-53.14272
29/01/2018 17:02,2016,2015,B,Other Reporting Airports,ABERDEEN,EAST MIDLANDS INTERNATIONAL,5370,5370,0,15480,15480,0,-65.31008
29/01/2018 17:02,2016,2015,B,Other Reporting Airports,ABERDEEN,EDINBURGH,30,30,0,146,0,146,-79.45205
29/01/2018 17:02,2016,2015,B,Other Reporting Airports,ABERDEEN,FARNBOROUGH,0,0,0,3,0,3,-100
29/01/2018 17:02,2016,2015,B,Other Reporting Airports,ABERDEEN,GLASGOW,67,67,0,0,0,0,0
29/01/2018 17:02,2016,2015,B,Other Reporting Airports,ABERDEEN,HUMBERSIDE,18197,17963,234,30097,30097,0,-39.53882
29/01/2018 17:02,2016,2015,B,Other Reporting Airports,ABERDEEN,INVERNESS,0,0,0,13,0,13,-100
29/01/2018 17:02,2016,2015,B,Other Reporting Airports,ABERDEEN,JERSEY,2433,2433,0,17896,17896,0,-86.40478
29/01/2018 17:02,2016,2015,B,Other Reporting Airports,ABERDEEN,KIRKWALL,35746,35437,309,48233,48189,44,-25.88891
29/01/2018 17:02,2016,2015,B,Other Reporting Airports,ABERDEEN,LEEDS BRADFORD,3627,3627,0,9226,9226,0,-60.68719
29/01/2018 17:02,2016,2015,B,Other Reporting Airports,ABERDEEN,LIVERPOOL (JOHN LENNON),24,0,24,0,0,0,0
29/01/2018 17:02,2016,2015,B,Other Reporting Airports,ABERDEEN,MANCHESTER,202391,201704,687,202623,201205,1418,-0.1145
29/01/2018 17:02,2016,2015,B,Other Reporting Airports,ABERDEEN,NEWCASTLE,8925,8925,0,20788,20726,62,-57.06658
29/01/2018 17:02,2016,2015,B,Other Reporting Airports,ABERDEEN,NEWQUAY,1552,1552,0,0,0,0,0
29/01/2018 17:02,2016,2015,B,Other Reporting Airports,ABERDEEN,NORWICH,42389,40672,1717,50584,50584,0,-16.20077
29/01/2018 17:02,2016,2015,B,Other Reporting Airports,ABERDEEN,PRESTWICK,49,0,49,0,0,0,0
29/01/2018 17:02,2016,2015,B,Other Reporting Airports,ABERDEEN,SCATSTA,75080,1385,73695,142655,6668,135987,-47.36953
29/01/2018 17:02,2016,2015,B,Other Reporting Airports,ABERDEEN,SOUTHAMPTON,6709,6590,119,13884,13884,0,-51.67819
29/01/2018 17:02,2016,2015,B,Other Reporting Airports,ABERDEEN,STORNOWAY,3593,3561,32,5467,5467,0,-34.2784
29/01/2018 17:02,2016,2015,B,Other Reporting Airports,ABERDEEN,SUMBURGH,107401,95486,11915,143693,76360,67333,-25.25662
29/01/2018 17:02,2016,2015,B,Other Reporting Airports,ABERDEEN,WICK JOHN O GROATS,5703,5543,160,12774,11462,1312,-55.35463
29/01/2018 17:02,2016,2015,B,Other Reporting Airports,ALDERNEY,EXETER,11,11,0,0,0,0,0
29/01/2018 17:02,2016,2015,B,Other Reporting Airports,ALDERNEY,GUERNSEY,34355,34355,0,35778,35778,0,-3.9773
29/01/2018 17:02,2016,2015,B,Other Reporting Airports,ALDERNEY,JERSEY,0,0,0,21,21,0,-100
29/01/2018 17:02,2016,2015,B,Other Reporting Airports,ALDERNEY,SOUTHAMPTON,23240,23240,0,24000,24000,0,-3.16667
29/01/2018 17:02,2016,2015,B,Other Reporting Airports,ANGLESEY (VALLEY),CARDIFF WALES,9187,9187,0,10860,10860,0,-15.40516
29/01/2018 17:02,2016,2015,B,Other Reporting Airports,ANGLESEY (VALLEY),GLOUCESTERSHIRE,25,25,0,0,0,0,0
29/01/2018 17:02,2016,2015,B,Other Reporting Airports,BARRA,BENBECULA,12,12,0,0,0,0,0
29/01/2018 17:02,2016,2015,B,Other Reporting Airports,BARRA,GLASGOW,12793,12793,0,10683,10683,0,19.75101
29/01/2018 17:02,2016,2015,B,Other Reporting Airports,BARRA,TIREE,3,3,0,0,0,0,0
29/01/2018 17:02,2016,2015,B,Other Reporting Airports,BELFAST CITY (GEORGE BEST),BELFAST INTERNATIONAL,72,11,61,0,0,0,0
29/01/2018 17:02,2016,2015,B,Other Reporting Airports,BELFAST CITY (GEORGE BEST),BIRMINGHAM,256598,256598,0,256023,255751,272,0.22459
29/01/2018 17:02,2016,2015,B,Other Reporting Airports,BELFAST CITY (GEORGE BEST),BLACKPOOL,0,0,0,5398,5398,0,-100
29/01/2018 17:02,2016,2015,B,Other Reporting Airports,BELFAST CITY (GEORGE BEST),BOURNEMOUTH,32,32,0,0,0,0,0
29/01/2018 17:02,2016,2015,B,Other Reporting Airports,BELFAST CITY (GEORGE BEST),CARDIFF WALES,43676,43676,0,41862,41862,0,4.33329
29/01/2018 17:02,2016,2015,B,Other Reporting Airports,BELFAST CITY (GEORGE BEST),DONCASTER SHEFFIELD,0,0,0,81,81,0,-100
29/01/2018 17:02,2016,2015,B,Other Reporting Airports,BELFAST CITY (GEORGE BEST),EAST MIDLANDS INTERNATIONAL,144312,144312,0,148170,148170,0,-2.60377
29/01/2018 17:02,2016,2015,B,Other Reporting Airports,BELFAST CITY (GEORGE BEST),EDINBURGH,165550,165550,0,137972,137938,34,19.98811
29/01/2018 17:02,2016,2015,B,Other Reporting Airports,BELFAST CITY (GEORGE BEST),EXETER,32531,32531,0,34671,34671,0,-6.17231
29/01/2018 17:02,2016,2015,B,Other Reporting Airports,BELFAST CITY (GEORGE BEST),GLASGOW,169839,169793,46,155157,155132,25,9.46267
29/01/2018 17:02,2016,2015,B,Other Reporting Airports,BELFAST CITY (GEORGE BEST),GLOUCESTERSHIRE,8,8,0,0,0,0,0
29/01/2018 17:02,2016,2015,B,Other Reporting Airports,BELFAST CITY (GEORGE BEST),INVERNESS,30286,30286,0,29193,29193,0,3.74405
29/01/2018 17:02,2016,2015,B,Other Reporting Airports,BELFAST CITY (GEORGE BEST),ISLE OF MAN,23424,23424,0,20029,20029,0,16.95042
29/01/2018 17:02,2016,2015,B,Other Reporting Airports,BELFAST CITY (GEORGE BEST),LEEDS BRADFORD,159107,159107,0,150842,150842,0,5.47924
29/01/2018 17:02,2016,2015,B,Other Reporting Airports,BELFAST CITY (GEORGE BEST),LIVERPOOL (JOHN LENNON),97866,97866,0,86051,86051,0,13.73023
29/01/2018 17:02,2016,2015,B,Other Reporting Airports,BELFAST CITY (GEORGE BEST),MANCHESTER,266431,266316,115,276512,276512,0,-3.64577
29/01/2018 17:02,2016,2015,B,Other Reporting Airports,BELFAST CITY (GEORGE BEST),NEWCASTLE,9911,9911,0,24335,24335,0,-59.27265
29/01/2018 17:02,2016,2015,B,Other Reporting Airports,BELFAST CITY (GEORGE BEST),NEWQUAY,1679,1679,0,1605,1605,0,4.61059
29/01/2018 17:02,2016,2015,B,Other Reporting Airports,BELFAST CITY (GEORGE BEST),SOUTHAMPTON,117277,117277,0,108528,108528,0,8.06151
29/01/2018 17:02,2016,2015,B,Other Reporting Airports,BELFAST INTERNATIONAL,BIRMINGHAM,227526,227526,0,196202,196084,118,15.96518
29/01/2018 17:02,2016,2015,B,Other Reporting Airports,BELFAST INTERNATIONAL,BOURNEMOUTH,0,0,0,352,0,352,-100
29/01/2018 17:02,2016,2015,B,Other Reporting Airports,BELFAST INTERNATIONAL,BRISTOL,249481,249481,0,246504,246406,98,1.20769
29/01/2018 17:02,2016,2015,B,Other Reporting Airports,BELFAST INTERNATIONAL,CARDIFF WALES,171,0,171,317,90,227,-46.05678
29/01/2018 17:02,2016,2015,B,Other Reporting Airports,BELFAST INTERNATIONAL,EAST MIDLANDS INTERNATIONAL,0,0,0,47,0,47,-100
29/01/2018 17:02,2016,2015,B,Other Reporting Airports,BELFAST INTERNATIONAL,EDINBURGH,274292,274292,0,262773,262684,89,4.38363
29/01/2018 17:02,2016,2015,B,Other Reporting Airports,BELFAST INTERNATIONAL,EXETER,0,0,0,192,0,192,-100
29/01/2018 17:02,2016,2015,B,Other Reporting Airports,BELFAST INTERNATIONAL,FARNBOROUGH,0,0,0,97,0,97,-100
29/01/2018 17:02,2016,2015,B,Other Reporting Airports,BELFAST INTERNATIONAL,GLASGOW,282375,282291,84,266275,265368,907,6.04638
29/01/2018 17:02,2016,2015,B,Other Reporting Airports,BELFAST INTERNATIONAL,JERSEY,19930,19930,0,10355,10355,0,92.46741
29/01/2018 17:02,2016,2015,B,Other Reporting Airports,BELFAST INTERNATIONAL,LEEDS BRADFORD,0,0,0,140,140,0,-100
29/01/2018 17:02,2016,2015,B,Other Reporting Airports,BELFAST INTERNATIONAL,LIVERPOOL (JOHN LENNON),465543,465543,0,426106,426106,0,9.25521
29/01/2018 17:02,2016,2015,B,Other Reporting Airports,BELFAST INTERNATIONAL,MANCHESTER,253217,253171,46,224497,224356,141,12.79304
29/01/2018 17:02,2016,2015,B,Other Reporting Airports,BELFAST INTERNATIONAL,NEWCASTLE,250418,250418,0,219499,219499,0,14.08617
29/01/2018 17:02,2016,2015,B,Other Reporting Airports,BELFAST INTERNATIONAL,PERTH (UK),3,0,3,0,0,0,0
29/01/2018 17:02,2016,2015,B,Other Reporting Airports,BELFAST INTERNATIONAL,PRESTWICK,48,0,48,0,0,0,0
29/01/2018 17:02,2016,2015,B,Other Reporting Airports,BELFAST INTERNATIONAL,SOUTHAMPTON,0,0,0,190,0,190,-100
29/01/2018 17:02,2016,2015,B,Other Reporting Airports,BENBECULA,EDINBURGH,22,22,0,0,0,0,0
29/01/2018 17:02,2016,2015,B,Other Reporting Airports,BENBECULA,GLASGOW,24199,24199,0,23548,23548,0,2.76457
29/01/2018 17:02,2016,2015,B,Other Reporting Airports,BENBECULA,INVERNESS,3,3,0,2051,2051,0,-99.85373
29/01/2018 17:02,2016,2015,B,Other Reporting Airports,BENBECULA,STORNOWAY,8203,8203,0,6488,6488,0,26.43342
29/01/2018 17:02,2016,2015,B,Other Reporting Airports,BIGGIN HILL,BIRMINGHAM,0,0,0,73,0,73,-100
29/01/2018 17:02,2016,2015,B,Other Reporting Airports,BIGGIN HILL,CITY OF DERRY (EGLINTON),0,0,0,35,0,35,-100
29/01/2018 17:02,2016,2015,B,Other Reporting Airports,BIGGIN HILL,DURHAM TEES VALLEY,35,0,35,0,0,0,0
29/01/2018 17:02,2016,2015,B,Other Reporting Airports,BIGGIN HILL,EAST MIDLANDS INTERNATIONAL,35,0,35,0,0,0,0
29/01/2018 17:02,2016,2015,B,Other Reporting Airports,BIGGIN HILL,EDINBURGH,0,0,0,31,0,31,-100
29/01/2018 17:02,2016,2015,B,Other Reporting Airports,BIGGIN HILL,EXETER,0,0,0,116,0,116,-100
29/01/2018 17:02,2016,2015,B,Other Reporting Airports,BIGGIN HILL,HUMBERSIDE,36,0,36,0,0,0,0
29/01/2018 17:02,2016,2015,B,Other Reporting Airports,BIGGIN HILL,INVERNESS,0,0,0,27,0,27,-100
29/01/2018 17:02,2016,2015,B,Other Reporting Airports,BIGGIN HILL,LEEDS BRADFORD,0,0,0,11,0,11,-100
29/01/2018 17:02,2016,2015,B,Other Reporting Airports,BIGGIN HILL,LIVERPOOL (JOHN LENNON),0,0,0,80,0,80,-100
29/01/2018 17:02,2016,2015,B,Other Reporting Airports,BIGGIN HILL,MANCHESTER,85,0,85,122,0,122,-30.32787
29/01/2018 17:02,2016,2015,B,Other Reporting Airports,BIGGIN HILL,NEWCASTLE,40,0,40,91,0,91,-56.04396
29/01/2018 17:02,2016,2015,B,Other Reporting Airports,BIRMINGHAM,BOURNEMOUTH,65,0,65,0,0,0,0
29/01/2018 17:02,2016,2015,B,Other Reporting Airports,BIRMINGHAM,DONCASTER SHEFFIELD,48,48,0,0,0,0,0
29/01/2018 17:02,2016,2015,B,Other Reporting Airports,BIRMINGHAM,DURHAM TEES VALLEY,41,41,0,0,0,0,0
29/01/2018 17:02,2016,2015,B,Other Reporting Airports,BIRMINGHAM,EDINBURGH,267279,267198,81,277911,277644,267,-3.82569
29/01/2018 17:02,2016,2015,B,Other Reporting Airports,BIRMINGHAM,EXETER,45,45,0,14,0,14,221.42857
29/01/2018 17:02,2016,2015,B,Other Reporting Airports,BIRMINGHAM,GLASGOW,226731,226469,262,226704,226119,585,0.01191
29/01/2018 17:02,2016,2015,B,Other Reporting Airports,BIRMINGHAM,GUERNSEY,32746,32746,0,33746,33592,154,-2.96331
29/01/2018 17:02,2016,2015,B,Other Reporting Airports,BIRMINGHAM,INVERNESS,42480,42386,94,41359,41359,0,2.71041
29/01/2018 17:02,2016,2015,B,Other Reporting Airports,BIRMINGHAM,ISLE OF MAN,38454,38357,97,42606,42521,85,-9.74511
29/01/2018 17:02,2016,2015,B,Other Reporting Airports,BIRMINGHAM,JERSEY,59832,59832,0,58735,58735,0,1.86771
29/01/2018 17:02,2016,2015,B,Other Reporting Airports,BIRMINGHAM,LEEDS BRADFORD,39,39,0,27,0,27,44.44444
29/01/2018 17:02,2016,2015,B,Other Reporting Airports,BIRMINGHAM,LIVERPOOL (JOHN LENNON),71,71,0,0,0,0,0
29/01/2018 17:02,2016,2015,B,Other Reporting Airports,BIRMINGHAM,MANCHESTER,762,762,0,0,0,0,0
29/01/2018 17:02,2016,2015,B,Other Reporting Airports,BIRMINGHAM,NEWCASTLE,3612,3495,117,8490,8356,134,-57.45583
29/01/2018 17:02,2016,2015,B,Other Reporting Airports,BIRMINGHAM,NEWQUAY,23955,23920,35,23659,23659,0,1.25111
29/01/2018 17:02,2016,2015,B,Other Reporting Airports,BIRMINGHAM,SOUTHAMPTON,186,141,45,0,0,0,0
29/01/2018 17:02,2016,2015,B,Other Reporting Airports,BLACKPOOL,CARDIFF WALES,3,3,0,0,0,0,0
29/01/2018 17:02,2016,2015,B,Other Reporting Airports,BLACKPOOL,GLOUCESTERSHIRE,13,13,0,0,0,0,0
29/01/2018 17:02,2016,2015,B,Other Reporting Airports,BLACKPOOL,ISLE OF MAN,15750,15750,0,10339,10339,0,52.33582
29/01/2018 17:02,2016,2015,B,Other Reporting Airports,BOURNEMOUTH,CARDIFF WALES,68,0,68,60,0,60,13.33333
29/01/2018 17:02,2016,2015,B,Other Reporting Airports,BOURNEMOUTH,DURHAM TEES VALLEY,80,0,80,76,0,76,5.26316
29/01/2018 17:02,2016,2015,B,Other Reporting Airports,BOURNEMOUTH,EAST MIDLANDS INTERNATIONAL,0,0,0,34,0,34,-100
29/01/2018 17:02,2016,2015,B,Other Reporting Airports,BOURNEMOUTH,EDINBURGH,143,143,0,340,0,340,-57.94118
29/01/2018 17:02,2016,2015,B,Other Reporting Airports,BOURNEMOUTH,GLASGOW,387,387,0,33399,33399,0,-98.84128
29/01/2018 17:02,2016,2015,B,Other Reporting Airports,BOURNEMOUTH,GUERNSEY,204,204,0,137,52,85,48.90511
29/01/2018 17:02,2016,2015,B,Other Reporting Airports,BOURNEMOUTH,HUMBERSIDE,69,0,69,0,0,0,0
29/01/2018 17:02,2016,2015,B,Other Reporting Airports,BOURNEMOUTH,JERSEY,409,375,34,18012,18012,0,-97.72929
29/01/2018 17:02,2016,2015,B,Other Reporting Airports,BOURNEMOUTH,LIVERPOOL (JOHN LENNON),364,0,364,272,0,272,33.82353
29/01/2018 17:02,2016,2015,B,Other Reporting Airports,BOURNEMOUTH,MANCHESTER,4135,3254,881,29766,29360,406,-86.10831
29/01/2018 17:02,2016,2015,B,Other Reporting Airports,BOURNEMOUTH,NEWCASTLE,327,71,256,168,0,168,94.64286
29/01/2018 17:02,2016,2015,B,Other Reporting Airports,BOURNEMOUTH,NORWICH,70,0,70,128,0,128,-45.3125
29/01/2018 17:02,2016,2015,B,Other Reporting Airports,BRISTOL,CARDIFF WALES,1188,1188,0,0,0,0,0
29/01/2018 17:02,2016,2015,B,Other Reporting Airports,BRISTOL,EAST MIDLANDS INTERNATIONAL,8,2,6,0,0,0,0
29/01/2018 17:02,2016,2015,B,Other Reporting Airports,BRISTOL,EDINBURGH,381945,381945,0,351954,351747,207,8.52128
29/01/2018 17:02,2016,2015,B,Other Reporting Airports,BRISTOL,GLASGOW,297295,297295,0,267162,267162,0,11.27892
29/01/2018 17:02,2016,2015,B,Other Reporting Airports,BRISTOL,GUERNSEY,26677,26677,0,24248,24248,0,10.01732
29/01/2018 17:02,2016,2015,B,Other Reporting Airports,BRISTOL,HAWARDEN,2340,14,2326,4735,0,4735,-50.58078
29/01/2018 17:02,2016,2015,B,Other Reporting Airports,BRISTOL,HUMBERSIDE,0,0,0,62,0,62,-100
29/01/2018 17:02,2016,2015,B,Other Reporting Airports,BRISTOL,INVERNESS,87714,87714,0,82446,82446,0,6.38964
29/01/2018 17:02,2016,2015,B,Other Reporting Airports,BRISTOL,ISLE OF MAN,24663,24663,0,23512,23512,0,4.89537
29/01/2018 17:02,2016,2015,B,Other Reporting Airports,BRISTOL,JERSEY,30380,30380,0,33369,33369,0,-8.95742
29/01/2018 17:02,2016,2015,B,Other Reporting Airports,BRISTOL,LIVERPOOL (JOHN LENNON),305,305,0,6,0,6,4983.33333
29/01/2018 17:02,2016,2015,B,Other Reporting Airports,BRISTOL,MANCHESTER,346,340,6,0,0,0,0
29/01/2018 17:02,2016,2015,B,Other Reporting Airports,BRISTOL,NEWCASTLE,164595,164515,80,169231,169145,86,-2.73945
29/01/2018 17:02,2016,2015,B,Other Reporting Airports,BRISTOL,NORWICH,218,190,28,0,0,0,0
29/01/2018 17:02,2016,2015,B,Other Reporting Airports,BRISTOL,SOUTHAMPTON,29,0,29,0,0,0,0
29/01/2018 17:02,2016,2015,B,Other Reporting Airports,CAMBRIDGE,JERSEY,0,0,0,1741,0,1741,-100
29/01/2018 17:02,2016,2015,B,Other Reporting Airports,CAMBRIDGE,MANCHESTER,33,0,33,0,0,0,0
29/01/2018 17:02,2016,2015,B,Other Reporting Airports,CAMBRIDGE,NEWCASTLE,0,0,0,44,0,44,-100
29/01/2018 17:02,2016,2015,B,Other Reporting Airports,CAMBRIDGE,SOUTHAMPTON,0,0,0,32,0,32,-100
29/01/2018 17:02,2016,2015,B,Other Reporting Airports,CAMPBELTOWN,GLASGOW,8406,8406,0,8234,8234,0,2.0889
29/01/2018 17:02,2016,2015,B,Other Reporting Airports,CAMPBELTOWN,ISLAY,37,37,0,18,18,0,105.55556
29/01/2018 17:02,2016,2015,B,Other Reporting Airports,CAMPBELTOWN,TIREE,29,29,0,0,0,0,0
29/01/2018 17:02,2016,2015,B,Other Reporting Airports,CARDIFF WALES,DONCASTER SHEFFIELD,137,19,118,0,0,0,0
29/01/2018 17:02,2016,2015,B,Other Reporting Airports,CARDIFF WALES,DURHAM TEES VALLEY,38,0,38,122,0,122,-68.85246
29/01/2018 17:02,2016,2015,B,Other Reporting Airports,CARDIFF WALES,EAST MIDLANDS INTERNATIONAL,166,0,166,95,0,95,74.73684
29/01/2018 17:02,2016,2015,B,Other Reporting Airports,CARDIFF WALES,EDINBURGH,94288,94232,56,69229,68528,701,36.19726
29/01/2018 17:02,2016,2015,B,Other Reporting Airports,CARDIFF WALES,FARNBOROUGH,63,0,63,3,0,3,2000
29/01/2018 17:02,2016,2015,B,Other Reporting Airports,CARDIFF WALES,GLASGOW,37714,37682,32,18136,18011,125,107.95104
29/01/2018 17:02,2016,2015,B,Other Reporting Airports,CARDIFF WALES,GLOUCESTERSHIRE,12,12,0,0,0,0,0
29/01/2018 17:02,2016,2015,B,Other Reporting Airports,CARDIFF WALES,HAWARDEN,22,22,0,0,0,0,0
29/01/2018 17:02,2016,2015,B,Other Reporting Airports,CARDIFF WALES,HUMBERSIDE,78,0,78,231,0,231,-66.23377
29/01/2018 17:02,2016,2015,B,Other Reporting Airports,CARDIFF WALES,INVERNESS,174,120,54,0,0,0,0
29/01/2018 17:02,2016,2015,B,Other Reporting Airports,CARDIFF WALES,ISLE OF MAN,7,7,0,0,0,0,0
29/01/2018 17:02,2016,2015,B,Other Reporting Airports,CARDIFF WALES,JERSEY,16630,16630,0,9434,9434,0,76.27729
29/01/2018 17:02,2016,2015,B,Other Reporting Airports,CARDIFF WALES,LEEDS BRADFORD,66,0,66,77,0,77,-14.28571
29/01/2018 17:02,2016,2015,B,Other Reporting Airports,CARDIFF WALES,LIVERPOOL (JOHN LENNON),319,0,319,340,0,340,-6.17647
29/01/2018 17:02,2016,2015,B,Other Reporting Airports,CARDIFF WALES,MANCHESTER,480,30,450,622,0,622,-22.82958
29/01/2018 17:02,2016,2015,B,Other Reporting Airports,CARDIFF WALES,NEWCASTLE,13664,13463,201,12412,12044,368,10.08701
29/01/2018 17:02,2016,2015,B,Other Reporting Airports,CARDIFF WALES,NORWICH,138,0,138,581,417,164,-76.24785
29/01/2018 17:02,2016,2015,B,Other Reporting Airports,CARDIFF WALES,SOUTHAMPTON,71,0,71,59,0,59,20.33898
29/01/2018 17:02,2016,2015,B,Other Reporting Airports,CITY OF DERRY (EGLINTON),GLASGOW,80671,80671,0,75986,75986,0,6.16561
29/01/2018 17:02,2016,2015,B,Other Reporting Airports,CITY OF DERRY (EGLINTON),LEEDS BRADFORD,0,0,0,185,185,0,-100
29/01/2018 17:02,2016,2015,B,Other Reporting Airports,CITY OF DERRY (EGLINTON),LIVERPOOL (JOHN LENNON),81412,81412,0,77099,77099,0,5.59411
29/01/2018 17:02,2016,2015,B,Other Reporting Airports,CITY OF DERRY (EGLINTON),SOUTHAMPTON,0,0,0,170,0,170,-100
29/01/2018 17:02,2016,2015,B,Other Reporting Airports,DONCASTER SHEFFIELD,EXETER,35,6,29,0,0,0,0
29/01/2018 17:02,2016,2015,B,Other Reporting Airports,DONCASTER SHEFFIELD,GLASGOW,94,45,49,0,0,0,0
29/01/2018 17:02,2016,2015,B,Other Reporting Airports,DONCASTER SHEFFIELD,ISLE OF MAN,0,0,0,231,231,0,-100
29/01/2018 17:02,2016,2015,B,Other Reporting Airports,DONCASTER SHEFFIELD,JERSEY,33085,32825,260,2807,2807,0,1078.66049
29/01/2018 17:02,2016,2015,B,Other Reporting Airports,DONCASTER SHEFFIELD,LEEDS BRADFORD,74,74,0,0,0,0,0
29/01/2018 17:02,2016,2015,B,Other Reporting Airports,DONCASTER SHEFFIELD,MANCHESTER,2,2,0,0,0,0,0
29/01/2018 17:02,2016,2015,B,Other Reporting Airports,DONCASTER SHEFFIELD,NEWQUAY,11255,11255,0,0,0,0,0
29/01/2018 17:02,2016,2015,B,Other Reporting Airports,DONCASTER SHEFFIELD,SOUTHAMPTON,5,5,0,0,0,0,0
29/01/2018 17:02,2016,2015,B,Other Reporting Airports,DUNDEE,DURHAM TEES VALLEY,18,0,18,0,0,0,0
29/01/2018 17:02,2016,2015,B,Other Reporting Airports,DUNDEE,FARNBOROUGH,0,0,0,9,0,9,-100
29/01/2018 17:02,2016,2015,B,Other Reporting Airports,DUNDEE,JERSEY,0,0,0,1291,0,1291,-100
29/01/2018 17:02,2016,2015,B,Other Reporting Airports,DUNDEE,KIRKWALL,29,29,0,0,0,0,0
29/01/2018 17:02,2016,2015,B,Other Reporting Airports,DUNDEE,LIVERPOOL (JOHN LENNON),0,0,0,80,0,80,-100
29/01/2018 17:02,2016,2015,B,Other Reporting Airports,DURHAM TEES VALLEY,FARNBOROUGH,0,0,0,73,0,73,-100
29/01/2018 17:02,2016,2015,B,Other Reporting Airports,DURHAM TEES VALLEY,GLASGOW,0,0,0,12,0,12,-100
29/01/2018 17:02,2016,2015,B,Other Reporting Airports,DURHAM TEES VALLEY,HUMBERSIDE,108,108,0,0,0,0,0
29/01/2018 17:02,2016,2015,B,Other Reporting Airports,DURHAM TEES VALLEY,JERSEY,2111,2111,0,2408,2408,0,-12.33389
29/01/2018 17:02,2016,2015,B,Other Reporting Airports,DURHAM TEES VALLEY,LEEDS BRADFORD,78,78,0,0,0,0,0
29/01/2018 17:02,2016,2015,B,Other Reporting Airports,DURHAM TEES VALLEY,LIVERPOOL (JOHN LENNON),131,33,98,0,0,0,0
29/01/2018 17:02,2016,2015,B,Other Reporting Airports,DURHAM TEES VALLEY,MANCHESTER,73,35,38,0,0,0,0
29/01/2018 17:02,2016,2015,B,Other Reporting Airports,DURHAM TEES VALLEY,NEWCASTLE,85,85,0,5,5,0,1600
29/01/2018 17:02,2016,2015,B,Other Reporting Airports,DURHAM TEES VALLEY,NORWICH,14,14,0,15,15,0,-6.66667
29/01/2018 17:02,2016,2015,B,Other Reporting Airports,DURHAM TEES VALLEY,SOUTHAMPTON,66,66,0,0,0,0,0
29/01/2018 17:02,2016,2015,B,Other Reporting Airports,EAST MIDLANDS INTERNATIONAL,EDINBURGH,93710,93710,0,95307,95307,0,-1.67564
29/01/2018 17:02,2016,2015,B,Other Reporting Airports,EAST MIDLANDS INTERNATIONAL,FARNBOROUGH,34,0,34,76,0,76,-55.26316
29/01/2018 17:02,2016,2015,B,Other Reporting Airports,EAST MIDLANDS INTERNATIONAL,GLASGOW,109538,109538,0,94954,94954,0,15.35902
29/01/2018 17:02,2016,2015,B,Other Reporting Airports,EAST MIDLANDS INTERNATIONAL,GUERNSEY,26709,26709,0,30893,30893,0,-13.54352
29/01/2018 17:02,2016,2015,B,Other Reporting Airports,EAST MIDLANDS INTERNATIONAL,HUMBERSIDE,94,69,25,50,50,0,88
29/01/2018 17:02,2016,2015,B,Other Reporting Airports,EAST MIDLANDS INTERNATIONAL,JERSEY,26523,26523,0,30538,30538,0,-13.14755
29/01/2018 17:02,2016,2015,B,Other Reporting Airports,EAST MIDLANDS INTERNATIONAL,LEEDS BRADFORD,2,2,0,0,0,0,0
29/01/2018 17:02,2016,2015,B,Other Reporting Airports,EAST MIDLANDS INTERNATIONAL,LIVERPOOL (JOHN LENNON),74,0,74,0,0,0,0
29/01/2018 17:02,2016,2015,B,Other Reporting Airports,EAST MIDLANDS INTERNATIONAL,MANCHESTER,341,0,341,0,0,0,0
29/01/2018 17:02,2016,2015,B,Other Reporting Airports,EAST MIDLANDS INTERNATIONAL,NEWCASTLE,549,122,427,288,0,288,90.625
29/01/2018 17:02,2016,2015,B,Other Reporting Airports,EAST MIDLANDS INTERNATIONAL,NORWICH,44,21,23,39,39,0,12.82051
29/01/2018 17:02,2016,2015,B,Other Reporting Airports,EAST MIDLANDS INTERNATIONAL,PRESTWICK,54,0,54,0,0,0,0
29/01/2018 17:02,2016,2015,B,Other Reporting Airports,EAST MIDLANDS INTERNATIONAL,SOUTHAMPTON,0,0,0,68,0,68,-100
29/01/2018 17:02,2016,2015,B,Other Reporting Airports,EAST MIDLANDS INTERNATIONAL,STORNOWAY,173,0,173,248,0,248,-30.24194
29/01/2018 17:02,2016,2015,B,Other Reporting Airports,EAST MIDLANDS INTERNATIONAL,WICK JOHN O GROATS,76,76,0,0,0,0,0
29/01/2018 17:02,2016,2015,B,Other Reporting Airports,EDAY,KIRKWALL,673,673,0,684,684,0,-1.60819
29/01/2018 17:02,2016,2015,B,Other Reporting Airports,EDAY,NEWQUAY,746,746,0,0,0,0,0
29/01/2018 17:02,2016,2015,B,Other Reporting Airports,EDINBURGH,EXETER,45213,45213,0,45115,45115,0,0.21722
29/01/2018 17:02,2016,2015,B,Other Reporting Airports,EDINBURGH,FARNBOROUGH,45,0,45,37,0,37,21.62162
29/01/2018 17:02,2016,2015,B,Other Reporting Airports,EDINBURGH,HUMBERSIDE,0,0,0,33,0,33,-100
29/01/2018 17:02,2016,2015,B,Other Reporting Airports,EDINBURGH,INVERNESS,110,110,0,0,0,0,0
29/01/2018 17:02,2016,2015,B,Other Reporting Airports,EDINBURGH,JERSEY,7011,7011,0,6412,6412,0,9.34186
29/01/2018 17:02,2016,2015,B,Other Reporting Airports,EDINBURGH,KIRKWALL,45846,45818,28,44530,44530,0,2.95531
29/01/2018 17:02,2016,2015,B,Other Reporting Airports,EDINBURGH,LIVERPOOL (JOHN LENNON),15869,15869,0,2776,2776,0,471.64986
29/01/2018 17:02,2016,2015,B,Other Reporting Airports,EDINBURGH,MANCHESTER,102259,102259,0,114095,114095,0,-10.37381
29/01/2018 17:02,2016,2015,B,Other Reporting Airports,EDINBURGH,NEWCASTLE,129,129,0,0,0,0,0
29/01/2018 17:02,2016,2015,B,Other Reporting Airports,EDINBURGH,NEWQUAY,2693,2693,0,2358,2358,0,14.20696
29/01/2018 17:02,2016,2015,B,Other Reporting Airports,EDINBURGH,NORWICH,25838,25838,0,29260,29260,0,-11.69515
29/01/2018 17:02,2016,2015,B,Other Reporting Airports,EDINBURGH,SOUTHAMPTON,198501,198501,0,194058,194058,0,2.28952
29/01/2018 17:02,2016,2015,B,Other Reporting Airports,EDINBURGH,STORNOWAY,20595,20595,0,20607,20607,0,-0.05823
29/01/2018 17:02,2016,2015,B,Other Reporting Airports,EDINBURGH,SUMBURGH,43530,43530,0,44786,44786,0,-2.80445
29/01/2018 17:02,2016,2015,B,Other Reporting Airports,EDINBURGH,WICK JOHN O GROATS,11607,11607,0,11067,11067,0,4.87937
29/01/2018 17:02,2016,2015,B,Other Reporting Airports,ELSTREE,GUERNSEY,33,33,0,0,0,0,0
29/01/2018 17:02,2016,2015,B,Other Reporting Airports,EXETER,GLASGOW,32794,32746,48,3059,3059,0,972.04969
29/01/2018 17:02,2016,2015,B,Other Reporting Airports,EXETER,GUERNSEY,29645,29645,0,25106,25106,0,18.07934
29/01/2018 17:02,2016,2015,B,Other Reporting Airports,EXETER,HAWARDEN,0,0,0,7,0,7,-100
29/01/2018 17:02,2016,2015,B,Other Reporting Airports,EXETER,HUMBERSIDE,61,0,61,0,0,0,0
29/01/2018 17:02,2016,2015,B,Other Reporting Airports,EXETER,ISLES OF SCILLY (ST.MARYS),15063,15063,0,14002,14002,0,7.57749
29/01/2018 17:02,2016,2015,B,Other Reporting Airports,EXETER,JERSEY,41421,41421,0,37560,37560,0,10.27955
29/01/2018 17:02,2016,2015,B,Other Reporting Airports,EXETER,LEEDS BRADFORD,0,0,0,25,0,25,-100
29/01/2018 17:02,2016,2015,B,Other Reporting Airports,EXETER,LIVERPOOL (JOHN LENNON),325,0,325,0,0,0,0
29/01/2018 17:02,2016,2015,B,Other Reporting Airports,EXETER,MANCHESTER,113291,113242,49,127644,127566,78,-11.24456
29/01/2018 17:02,2016,2015,B,Other Reporting Airports,EXETER,NEWCASTLE,39713,39631,82,35883,35795,88,10.67358
29/01/2018 17:02,2016,2015,B,Other Reporting Airports,EXETER,NEWQUAY,94,94,0,47,45,2,100
29/01/2018 17:02,2016,2015,B,Other Reporting Airports,EXETER,NORWICH,22359,22359,0,55,0,55,40552.72727
29/01/2018 17:02,2016,2015,B,Other Reporting Airports,EXETER,SOUTHAMPTON,9,9,0,0,0,0,0
29/01/2018 17:02,2016,2015,B,Other Reporting Airports,FAIR ISLE,LERWICK (TINGWALL),3150,3150,0,2305,2305,0,36.65944
29/01/2018 17:02,2016,2015,B,Other Reporting Airports,FAIR ISLE,SUMBURGH,126,126,0,112,112,0,12.5
29/01/2018 17:02,2016,2015,B,Other Reporting Airports,FARNBOROUGH,GLASGOW,0,0,0,6,0,6,-100
29/01/2018 17:02,2016,2015,B,Other Reporting Airports,FARNBOROUGH,LEEDS BRADFORD,0,0,0,9,0,9,-100
29/01/2018 17:02,2016,2015,B,Other Reporting Airports,FARNBOROUGH,LIVERPOOL (JOHN LENNON),97,0,97,196,0,196,-50.5102
29/01/2018 17:02,2016,2015,B,Other Reporting Airports,FARNBOROUGH,MANCHESTER,33,0,33,160,0,160,-79.375
29/01/2018 17:02,2016,2015,B,Other Reporting Airports,FARNBOROUGH,NEWCASTLE,92,0,92,39,0,39,135.89744
29/01/2018 17:02,2016,2015,B,Other Reporting Airports,FARNBOROUGH,WICK JOHN O GROATS,12,0,12,12,0,12,0
29/01/2018 17:02,2016,2015,B,Other Reporting Airports,FOULA,LERWICK (TINGWALL),1235,1235,0,1063,1063,0,16.18062
29/01/2018 17:02,2016,2015,B,Other Reporting Airports,GLASGOW,INVERNESS,524,443,81,0,0,0,0
29/01/2018 17:02,2016,2015,B,Other Reporting Airports,GLASGOW,ISLAY,25349,25349,0,28687,28687,0,-11.63593
29/01/2018 17:02,2016,2015,B,Other Reporting Airports,GLASGOW,ISLE OF MAN,8797,8797,0,9901,9901,0,-11.15039
29/01/2018 17:02,2016,2015,B,Other Reporting Airports,GLASGOW,JERSEY,40671,40644,27,34665,34665,0,17.32583
29/01/2018 17:02,2016,2015,B,Other Reporting Airports,GLASGOW,KIRKWALL,17402,17216,186,17372,17372,0,0.17269
29/01/2018 17:02,2016,2015,B,Other Reporting Airports,GLASGOW,LEEDS BRADFORD,7636,7636,0,8332,8332,0,-8.35334
29/01/2018 17:02,2016,2015,B,Other Reporting Airports,GLASGOW,LIVERPOOL (JOHN LENNON),0,0,0,16,0,16,-100
29/01/2018 17:02,2016,2015,B,Other Reporting Airports,GLASGOW,MANCHESTER,43466,42984,482,45389,45248,141,-4.23671
29/01/2018 17:02,2016,2015,B,Other Reporting Airports,GLASGOW,NEWCASTLE,0,0,0,12,0,12,-100
29/01/2018 17:02,2016,2015,B,Other Reporting Airports,GLASGOW,NEWQUAY,2307,2307,0,0,0,0,0
29/01/2018 17:02,2016,2015,B,Other Reporting Airports,GLASGOW,PRESTWICK,0,0,0,304,304,0,-100
29/01/2018 17:02,2016,2015,B,Other Reporting Airports,GLASGOW,SOUTHAMPTON,179436,179436,0,158310,158310,0,13.3447
29/01/2018 17:02,2016,2015,B,Other Reporting Airports,GLASGOW,STORNOWAY,59983,59983,0,62413,62413,0,-3.89342
29/01/2018 17:02,2016,2015,B,Other Reporting Airports,GLASGOW,SUMBURGH,26768,26768,0,28599,28599,0,-6.40232
29/01/2018 17:02,2016,2015,B,Other Reporting Airports,GLASGOW,TIREE,9326,9326,0,8675,8675,0,7.50432
29/01/2018 17:02,2016,2015,B,Other Reporting Airports,GLOUCESTERSHIRE,ISLE OF MAN,11824,11824,0,11718,11718,0,0.90459
29/01/2018 17:02,2016,2015,B,Other Reporting Airports,GLOUCESTERSHIRE,JERSEY,472,472,0,534,534,0,-11.61049
29/01/2018 17:02,2016,2015,B,Other Reporting Airports,GUERNSEY,HAVERFORD WEST,0,0,0,26,0,26,-100
29/01/2018 17:02,2016,2015,B,Other Reporting Airports,GUERNSEY,JERSEY,113904,113368,536,127014,126838,176,-10.3217
29/01/2018 17:02,2016,2015,B,Other Reporting Airports,GUERNSEY,LEEDS BRADFORD,7854,7854,0,0,0,0,0
29/01/2018 17:02,2016,2015,B,Other Reporting Airports,GUERNSEY,LIVERPOOL (JOHN LENNON),0,0,0,128,128,0,-100
29/01/2018 17:02,2016,2015,B,Other Reporting Airports,GUERNSEY,MANCHESTER,65285,65285,0,67733,67733,0,-3.61419
29/01/2018 17:02,2016,2015,B,Other Reporting Airports,GUERNSEY,NEWQUAY,0,0,0,37,0,37,-100
29/01/2018 17:02,2016,2015,B,Other Reporting Airports,GUERNSEY,NORWICH,1362,1362,0,651,649,2,109.21659
29/01/2018 17:02,2016,2015,B,Other Reporting Airports,GUERNSEY,SOUTHAMPTON,135792,135791,1,140425,140425,0,-3.29927
29/01/2018 17:02,2016,2015,B,Other Reporting Airports,HUMBERSIDE,JERSEY,2158,0,2158,2385,2385,0,-9.51782
29/01/2018 17:02,2016,2015,B,Other Reporting Airports,HUMBERSIDE,LEEDS BRADFORD,75,40,35,0,0,0,0
29/01/2018 17:02,2016,2015,B,Other Reporting Airports,HUMBERSIDE,LIVERPOOL (JOHN LENNON),0,0,0,168,0,168,-100
29/01/2018 17:02,2016,2015,B,Other Reporting Airports,HUMBERSIDE,LOSSIEMOUTH,2,2,0,0,0,0,0
29/01/2018 17:02,2016,2015,B,Other Reporting Airports,HUMBERSIDE,MARHAM(KINGS LYNN),99,99,0,0,0,0,0
29/01/2018 17:02,2016,2015,B,Other Reporting Airports,HUMBERSIDE,NEWCASTLE,103,35,68,0,0,0,0
29/01/2018 17:02,2016,2015,B,Other Reporting Airports,HUMBERSIDE,NORWICH,56,56,0,48,0,48,16.66667
29/01/2018 17:02,2016,2015,B,Other Reporting Airports,HUMBERSIDE,SOUTHAMPTON,105,2,103,33,0,33,218.18182
29/01/2018 17:02,2016,2015,B,Other Reporting Airports,HUMBERSIDE,WADDINGTON,32,32,0,0,0,0,0
29/01/2018 17:02,2016,2015,B,Other Reporting Airports,HUMBERSIDE,WARTON,98,98,0,0,0,0,0
29/01/2018 17:02,2016,2015,B,Other Reporting Airports,INVERNESS,JERSEY,1925,1925,0,2080,2025,55,-7.45192
29/01/2018 17:02,2016,2015,B,Other Reporting Airports,INVERNESS,KIRKWALL,19216,19216,0,19919,19919,0,-3.52929
29/01/2018 17:02,2016,2015,B,Other Reporting Airports,INVERNESS,LEEDS BRADFORD,0,0,0,39,39,0,-100
29/01/2018 17:02,2016,2015,B,Other Reporting Airports,INVERNESS,MANCHESTER,68244,68244,0,84436,84436,0,-19.17665
29/01/2018 17:02,2016,2015,B,Other Reporting Airports,INVERNESS,NEWCASTLE,0,0,0,24,0,24,-100
29/01/2018 17:02,2016,2015,B,Other Reporting Airports,INVERNESS,STORNOWAY,31198,31198,0,27133,26923,210,14.98176
29/01/2018 17:02,2016,2015,B,Other Reporting Airports,INVERNESS,SUMBURGH,3546,3546,0,3733,3733,0,-5.00938
29/01/2018 17:02,2016,2015,B,Other Reporting Airports,ISLAY,TIREE,29,29,0,0,0,0,0
29/01/2018 17:02,2016,2015,B,Other Reporting Airports,ISLE OF MAN,JERSEY,0,0,0,384,0,384,-100
29/01/2018 17:02,2016,2015,B,Other Reporting Airports,ISLE OF MAN,LEEDS BRADFORD,0,0,0,146,0,146,-100
29/01/2018 17:02,2016,2015,B,Other Reporting Airports,ISLE OF MAN,LIVERPOOL (JOHN LENNON),213190,213190,0,200784,200784,0,6.17878
29/01/2018 17:02,2016,2015,B,Other Reporting Airports,ISLE OF MAN,MANCHESTER,159194,159194,0,158896,158871,25,0.18754
29/01/2018 17:02,2016,2015,B,Other Reporting Airports,ISLE OF MAN,NEWCASTLE,4191,4191,0,4409,4409,0,-4.94443
29/01/2018 17:02,2016,2015,B,Other Reporting Airports,ISLES OF SCILLY (ST.MARYS),NEWQUAY,19253,19253,0,19982,19982,0,-3.64828
29/01/2018 17:02,2016,2015,B,Other Reporting Airports,JERSEY,LEEDS BRADFORD,12200,12200,0,50035,50035,0,-75.61707
29/01/2018 17:02,2016,2015,B,Other Reporting Airports,JERSEY,LIVERPOOL (JOHN LENNON),115485,115342,143,107637,107637,0,7.29117
29/01/2018 17:02,2016,2015,B,Other Reporting Airports,JERSEY,MANCHESTER,51024,51024,0,50652,50652,0,0.73442
29/01/2018 17:02,2016,2015,B,Other Reporting Airports,JERSEY,NEWCASTLE,23674,23674,0,17853,17853,0,32.60516
29/01/2018 17:02,2016,2015,B,Other Reporting Airports,JERSEY,NEWQUAY,61,61,0,0,0,0,0
29/01/2018 17:02,2016,2015,B,Other Reporting Airports,JERSEY,NORWICH,3920,3920,0,2773,2773,0,41.36314
29/01/2018 17:02,2016,2015,B,Other Reporting Airports,JERSEY,SOUTHAMPTON,161927,161927,0,118862,118862,0,36.23109
29/01/2018 17:02,2016,2015,B,Other Reporting Airports,JERSEY,STORNOWAY,0,0,0,197,0,197,-100
29/01/2018 17:02,2016,2015,B,Other Reporting Airports,KIRKWALL,NORTH RONALDSAY,6423,6423,0,5624,5624,0,14.20697
29/01/2018 17:02,2016,2015,B,Other Reporting Airports,KIRKWALL,PAPA WESTRAY,4915,4915,0,4802,4802,0,2.35319
29/01/2018 17:02,2016,2015,B,Other Reporting Airports,KIRKWALL,SANDAY,3060,3060,0,3126,3126,0,-2.11132
29/01/2018 17:02,2016,2015,B,Other Reporting Airports,KIRKWALL,STRONSAY,3246,3246,0,3282,3282,0,-1.09689
29/01/2018 17:02,2016,2015,B,Other Reporting Airports,KIRKWALL,SUMBURGH,8953,8953,0,8429,8429,0,6.21663
29/01/2018 17:02,2016,2015,B,Other Reporting Airports,KIRKWALL,WESTRAY,3560,3560,0,3630,3630,0,-1.92837
29/01/2018 17:02,2016,2015,B,Other Reporting Airports,LANDS END (ST JUST),NEWQUAY,17,17,0,0,0,0,0
29/01/2018 17:02,2016,2015,B,Other Reporting Airports,LEEDS BRADFORD,LIVERPOOL (JOHN LENNON),21,21,0,0,0,0,0
29/01/2018 17:02,2016,2015,B,Other Reporting Airports,LEEDS BRADFORD,MANCHESTER,5,5,0,0,0,0,0
29/01/2018 17:02,2016,2015,B,Other Reporting Airports,LEEDS BRADFORD,NEWCASTLE,21,21,0,0,0,0,0
29/01/2018 17:02,2016,2015,B,Other Reporting Airports,LEEDS BRADFORD,NEWQUAY,3171,3171,0,0,0,0,0
29/01/2018 17:02,2016,2015,B,Other Reporting Airports,LEEDS BRADFORD,NORTHOLT,9,0,9,0,0,0,0
29/01/2018 17:02,2016,2015,B,Other Reporting Airports,LEEDS BRADFORD,NORWICH,1,1,0,17,0,17,-94.11765
29/01/2018 17:02,2016,2015,B,Other Reporting Airports,LEEDS BRADFORD,SOUTHAMPTON,40850,40850,0,45772,45716,56,-10.7533
29/01/2018 17:02,2016,2015,B,Other Reporting Airports,LERWICK (TINGWALL),OUT SKERRIES,0,0,0,69,69,0,-100
29/01/2018 17:02,2016,2015,B,Other Reporting Airports,LERWICK (TINGWALL),PAPA STOUR,53,53,0,64,64,0,-17.1875
29/01/2018 17:02,2016,2015,B,Other Reporting Airports,LERWICK (TINGWALL),SUMBURGH,2,2,0,0,0,0,0
29/01/2018 17:02,2016,2015,B,Other Reporting Airports,LIVERPOOL (JOHN LENNON),MANCHESTER,38,38,0,0,0,0,0
29/01/2018 17:02,2016,2015,B,Other Reporting Airports,LIVERPOOL (JOHN LENNON),NEWCASTLE,406,0,406,478,0,478,-15.06276
29/01/2018 17:02,2016,2015,B,Other Reporting Airports,LIVERPOOL (JOHN LENNON),NEWQUAY,1851,1851,0,5224,5224,0,-64.56738
29/01/2018 17:02,2016,2015,B,Other Reporting Airports,LIVERPOOL (JOHN LENNON),NORWICH,253,0,253,220,0,220,15
29/01/2018 17:02,2016,2015,B,Other Reporting Airports,LIVERPOOL (JOHN LENNON),OXFORD (KIDLINGTON),0,0,0,72,0,72,-100
29/01/2018 17:02,2016,2015,B,Other Reporting Airports,LIVERPOOL (JOHN LENNON),SOUTHAMPTON,327,0,327,351,0,351,-6.83761
29/01/2018 17:02,2016,2015,B,Other Reporting Airports,MANCHESTER,NEWCASTLE,391,3,388,712,0,712,-45.08427
29/01/2018 17:02,2016,2015,B,Other Reporting Airports,MANCHESTER,NEWQUAY,66480,66480,0,54580,54580,0,21.80286
29/01/2018 17:02,2016,2015,B,Other Reporting Airports,MANCHESTER,NORWICH,25847,25461,386,27702,27356,346,-6.69627
29/01/2018 17:02,2016,2015,B,Other Reporting Airports,MANCHESTER,PRESTWICK,57,0,57,0,0,0,0
29/01/2018 17:02,2016,2015,B,Other Reporting Airports,MANCHESTER,SOUTHAMPTON,188597,188286,311,149884,149657,227,25.82864
29/01/2018 17:02,2016,2015,B,Other Reporting Airports,MANCHESTER,STORNOWAY,0,0,0,68,0,68,-100
29/01/2018 17:02,2016,2015,B,Other Reporting Airports,NEWCASTLE,NEWQUAY,1922,1922,0,2148,2148,0,-10.52142
29/01/2018 17:02,2016,2015,B,Other Reporting Airports,NEWCASTLE,NORWICH,255,0,255,189,0,189,34.92063
29/01/2018 17:02,2016,2015,B,Other Reporting Airports,NEWCASTLE,PRESTWICK,0,0,0,10,0,10,-100
29/01/2018 17:02,2016,2015,B,Other Reporting Airports,NEWCASTLE,SOUTHAMPTON,117767,117462,305,109455,109141,314,7.59399
29/01/2018 17:02,2016,2015,B,Other Reporting Airports,NEWQUAY,NORWICH,48,48,0,0,0,0,0
29/01/2018 17:02,2016,2015,B,Other Reporting Airports,NEWQUAY,SOUTHAMPTON,117,117,0,0,0,0,0
29/01/2018 17:02,2016,2015,B,Other Reporting Airports,NORWICH,SOUTHAMPTON,87,0,87,65,0,65,33.84615
29/01/2018 17:02,2016,2015,B,Other Reporting Airports,NORWICH,WARTON,6,6,0,0,0,0,0
29/01/2018 17:02,2016,2015,B,Other Reporting Airports,OXFORD (KIDLINGTON),SOUTHAMPTON,48,48,0,0,0,0,0
29/01/2018 17:02,2016,2015,B,Other Reporting Airports,SCATSTA,SUMBURGH,68,0,68,36,0,36,88.88889
29/01/2018 17:02,2016,2015,B,Other Reporting Airports,STORNOWAY,TIREE,28,28,0,0,0,0,0
29/01/2018 17:02,2016,2015,B,Other Reporting Airports,STORNOWAY,WICK JOHN O GROATS,21,21,0,0,0,0,0

