rundate,report_period,region_num,foreign_region,foreign_country,uk_group,uk_apt,foreign_apt,ty_t_pax,ty_s_pax,ty_c_pax,ly_t_pax,ly_s_pax,ly_c_pax,pc_change
29/01/2018 17:06,2016,,Unknown,Unknown,1,GATWICK,Unknown,53,53,0,0,0,0,0
29/01/2018 17:06,2016,,Unknown,Unknown,1,STANSTED,Unknown,1271,1271,0,0,0,0,0
29/01/2018 17:06,2016,,Unknown,Unknown,2,BELFAST CITY (GEORGE BEST),Unknown,2665,0,2665,0,0,0,0
29/01/2018 17:06,2016,,Unknown,Unknown,2,BRISTOL,Unknown,2110,0,2110,0,0,0,0
29/01/2018 17:06,2016,,Unknown,Unknown,2,GLASGOW,Unknown,895,0,895,0,0,0,0
29/01/2018 17:06,2016,,Unknown,Unknown,2,LEEDS BRADFORD,Unknown,974,974,0,0,0,0,0
29/01/2018 17:06,2016,,Unknown,Unknown,2,MANCHESTER,Unknown,6336,5879,457,0,0,0,0
29/01/2018 17:06,2016,,Unknown,Unknown,2,NEWCASTLE,Unknown,69,0,69,0,0,0,0
29/01/2018 17:06,2016,1,WESTERN EUROPE-EU,AUSTRIA,1,GATWICK,GRAZ,0,0,0,622,0,622,-100
29/01/2018 17:06,2016,1,WESTERN EUROPE-EU,AUSTRIA,1,GATWICK,INNSBRUCK,192361,169395,22966,189040,128271,60769,1.75677
29/01/2018 17:06,2016,1,WESTERN EUROPE-EU,AUSTRIA,1,GATWICK,SALZBURG,138933,118692,20241,141575,111277,30298,-1.86615
29/01/2018 17:06,2016,1,WESTERN EUROPE-EU,AUSTRIA,1,GATWICK,VIENNA,251430,251430,0,203630,203529,101,23.47395
29/01/2018 17:06,2016,1,WESTERN EUROPE-EU,AUSTRIA,1,HEATHROW,INNSBRUCK,3969,3969,0,0,0,0,0
29/01/2018 17:06,2016,1,WESTERN EUROPE-EU,AUSTRIA,1,HEATHROW,SALZBURG,8981,8981,0,1585,1585,0,466.62461
29/01/2018 17:06,2016,1,WESTERN EUROPE-EU,AUSTRIA,1,HEATHROW,VIENNA,794806,794806,0,787631,787631,0,0.91096
29/01/2018 17:06,2016,1,WESTERN EUROPE-EU,AUSTRIA,1,LONDON CITY,GRAZ,711,0,711,0,0,0,0
29/01/2018 17:06,2016,1,WESTERN EUROPE-EU,AUSTRIA,1,LUTON,GRAZ,920,0,920,613,0,613,50.08157
29/01/2018 17:06,2016,1,WESTERN EUROPE-EU,AUSTRIA,1,LUTON,INNSBRUCK,6932,6932,0,850,782,68,715.52941
29/01/2018 17:06,2016,1,WESTERN EUROPE-EU,AUSTRIA,1,LUTON,KLAGENFURT,19,0,19,75,0,75,-74.66667
29/01/2018 17:06,2016,1,WESTERN EUROPE-EU,AUSTRIA,1,LUTON,SALZBURG,8646,4980,3666,8614,4841,3773,0.37149
29/01/2018 17:06,2016,1,WESTERN EUROPE-EU,AUSTRIA,1,LUTON,VIENNA,52839,52831,8,5498,5434,64,861.05857
29/01/2018 17:06,2016,1,WESTERN EUROPE-EU,AUSTRIA,1,STANSTED,INNSBRUCK,9260,0,9260,8995,0,8995,2.94608
29/01/2018 17:06,2016,1,WESTERN EUROPE-EU,AUSTRIA,1,STANSTED,LINZ,32799,32799,0,45734,45734,0,-28.28312
29/01/2018 17:06,2016,1,WESTERN EUROPE-EU,AUSTRIA,1,STANSTED,SALZBURG,95893,92423,3470,97864,93705,4159,-2.01402
29/01/2018 17:06,2016,1,WESTERN EUROPE-EU,AUSTRIA,1,STANSTED,VIENNA,98741,98741,0,13766,13663,103,617.28171
29/01/2018 17:06,2016,1,WESTERN EUROPE-EU,AUSTRIA,2,BELFAST CITY (GEORGE BEST),GRAZ,41,0,41,0,0,0,0
29/01/2018 17:06,2016,1,WESTERN EUROPE-EU,AUSTRIA,2,BELFAST CITY (GEORGE BEST),SALZBURG,488,0,488,0,0,0,0
29/01/2018 17:06,2016,1,WESTERN EUROPE-EU,AUSTRIA,2,BELFAST INTERNATIONAL,SALZBURG,3141,0,3141,3530,0,3530,-11.01983
29/01/2018 17:06,2016,1,WESTERN EUROPE-EU,AUSTRIA,2,BELFAST INTERNATIONAL,VIENNA,0,0,0,256,256,0,-100
29/01/2018 17:06,2016,1,WESTERN EUROPE-EU,AUSTRIA,2,BIRMINGHAM,GRAZ,238,0,238,0,0,0,0
29/01/2018 17:06,2016,1,WESTERN EUROPE-EU,AUSTRIA,2,BIRMINGHAM,INNSBRUCK,15825,321,15504,17042,0,17042,-7.14118
29/01/2018 17:06,2016,1,WESTERN EUROPE-EU,AUSTRIA,2,BIRMINGHAM,LINZ,0,0,0,128,0,128,-100
29/01/2018 17:06,2016,1,WESTERN EUROPE-EU,AUSTRIA,2,BIRMINGHAM,SALZBURG,15333,3864,11469,14770,4242,10528,3.81178
29/01/2018 17:06,2016,1,WESTERN EUROPE-EU,AUSTRIA,2,BIRMINGHAM,VIENNA,0,0,0,380,0,380,-100
29/01/2018 17:06,2016,1,WESTERN EUROPE-EU,AUSTRIA,2,BOURNEMOUTH,SALZBURG,0,0,0,117,0,117,-100
29/01/2018 17:06,2016,1,WESTERN EUROPE-EU,AUSTRIA,2,BRISTOL,INNSBRUCK,19996,8177,11819,19139,8634,10505,4.47777
29/01/2018 17:06,2016,1,WESTERN EUROPE-EU,AUSTRIA,2,BRISTOL,SALZBURG,12542,7880,4662,9825,5688,4137,27.65394
29/01/2018 17:06,2016,1,WESTERN EUROPE-EU,AUSTRIA,2,BRISTOL,VIENNA,29214,29095,119,3373,3373,0,766.11325
29/01/2018 17:06,2016,1,WESTERN EUROPE-EU,AUSTRIA,2,CARDIFF WALES,VIENNA,149,0,149,0,0,0,0
29/01/2018 17:06,2016,1,WESTERN EUROPE-EU,AUSTRIA,2,EAST MIDLANDS INTERNATIONAL,GRAZ,0,0,0,94,0,94,-100
29/01/2018 17:06,2016,1,WESTERN EUROPE-EU,AUSTRIA,2,EAST MIDLANDS INTERNATIONAL,SALZBURG,4258,275,3983,3876,0,3876,9.85552
29/01/2018 17:06,2016,1,WESTERN EUROPE-EU,AUSTRIA,2,EAST MIDLANDS INTERNATIONAL,VIENNA,0,0,0,24,0,24,-100
29/01/2018 17:06,2016,1,WESTERN EUROPE-EU,AUSTRIA,2,EDINBURGH,GRAZ,128,0,128,0,0,0,0
29/01/2018 17:06,2016,1,WESTERN EUROPE-EU,AUSTRIA,2,EDINBURGH,INNSBRUCK,9000,0,9000,11465,0,11465,-21.50022
29/01/2018 17:06,2016,1,WESTERN EUROPE-EU,AUSTRIA,2,EDINBURGH,LINZ,0,0,0,377,0,377,-100
29/01/2018 17:06,2016,1,WESTERN EUROPE-EU,AUSTRIA,2,EDINBURGH,SALZBURG,7755,5036,2719,5051,4488,563,53.53395
29/01/2018 17:06,2016,1,WESTERN EUROPE-EU,AUSTRIA,2,EDINBURGH,VIENNA,52526,52526,0,947,0,947,5446.56811
29/01/2018 17:06,2016,1,WESTERN EUROPE-EU,AUSTRIA,2,EXETER,GRAZ,179,0,179,240,0,240,-25.41667
29/01/2018 17:06,2016,1,WESTERN EUROPE-EU,AUSTRIA,2,EXETER,INNSBRUCK,114,0,114,55,0,55,107.27273
29/01/2018 17:06,2016,1,WESTERN EUROPE-EU,AUSTRIA,2,EXETER,LINZ,113,0,113,356,0,356,-68.25843
29/01/2018 17:06,2016,1,WESTERN EUROPE-EU,AUSTRIA,2,EXETER,SALZBURG,217,0,217,321,0,321,-32.39875
29/01/2018 17:06,2016,1,WESTERN EUROPE-EU,AUSTRIA,2,EXETER,VIENNA,928,0,928,1476,0,1476,-37.12737
29/01/2018 17:06,2016,1,WESTERN EUROPE-EU,AUSTRIA,2,GLASGOW,GRAZ,0,0,0,413,0,413,-100
29/01/2018 17:06,2016,1,WESTERN EUROPE-EU,AUSTRIA,2,GLASGOW,LINZ,0,0,0,631,0,631,-100
29/01/2018 17:06,2016,1,WESTERN EUROPE-EU,AUSTRIA,2,GLASGOW,SALZBURG,9298,2820,6478,7767,285,7482,19.7116
29/01/2018 17:06,2016,1,WESTERN EUROPE-EU,AUSTRIA,2,GLASGOW,VIENNA,869,0,869,2309,0,2309,-62.36466
29/01/2018 17:06,2016,1,WESTERN EUROPE-EU,AUSTRIA,2,HUMBERSIDE,SALZBURG,80,0,80,76,0,76,5.26316
29/01/2018 17:06,2016,1,WESTERN EUROPE-EU,AUSTRIA,2,JERSEY,VIENNA,1293,0,1293,1442,1442,0,-10.33287
29/01/2018 17:06,2016,1,WESTERN EUROPE-EU,AUSTRIA,2,LEEDS BRADFORD,INNSBRUCK,2083,0,2083,1279,0,1279,62.86161
29/01/2018 17:06,2016,1,WESTERN EUROPE-EU,AUSTRIA,2,LEEDS BRADFORD,SALZBURG,4857,4857,0,4389,4389,0,10.66302
29/01/2018 17:06,2016,1,WESTERN EUROPE-EU,AUSTRIA,2,LEEDS BRADFORD,VIENNA,292,292,0,278,0,278,5.03597
29/01/2018 17:06,2016,1,WESTERN EUROPE-EU,AUSTRIA,2,LIVERPOOL (JOHN LENNON),INNSBRUCK,0,0,0,4236,4236,0,-100
29/01/2018 17:06,2016,1,WESTERN EUROPE-EU,AUSTRIA,2,LIVERPOOL (JOHN LENNON),SALZBURG,4538,4538,0,4570,4570,0,-0.70022
29/01/2018 17:06,2016,1,WESTERN EUROPE-EU,AUSTRIA,2,MANCHESTER,INNSBRUCK,48117,19002,29115,48977,11131,37846,-1.75593
29/01/2018 17:06,2016,1,WESTERN EUROPE-EU,AUSTRIA,2,MANCHESTER,SALZBURG,31894,10378,21516,35488,5824,29664,-10.12737
29/01/2018 17:06,2016,1,WESTERN EUROPE-EU,AUSTRIA,2,MANCHESTER,VIENNA,96706,96706,0,50136,50129,7,92.88735
29/01/2018 17:06,2016,1,WESTERN EUROPE-EU,AUSTRIA,2,NEWCASTLE,INNSBRUCK,4506,394,4112,4579,0,4579,-1.59423
29/01/2018 17:06,2016,1,WESTERN EUROPE-EU,AUSTRIA,2,NEWCASTLE,SALZBURG,8903,5106,3797,10005,0,10005,-11.01449
29/01/2018 17:06,2016,1,WESTERN EUROPE-EU,AUSTRIA,2,NEWCASTLE,VIENNA,515,292,223,292,292,0,76.36986
29/01/2018 17:06,2016,1,WESTERN EUROPE-EU,AUSTRIA,2,SOUTHAMPTON,INNSBRUCK,1619,0,1619,2476,0,2476,-34.61228
29/01/2018 17:06,2016,1,WESTERN EUROPE-EU,AUSTRIA,2,SOUTHAMPTON,SALZBURG,0,0,0,1626,1626,0,-100
29/01/2018 17:06,2016,1,WESTERN EUROPE-EU,BELGIUM,1,GATWICK,BRUSSELS,14742,14742,0,93791,93791,0,-84.28207
29/01/2018 17:06,2016,1,WESTERN EUROPE-EU,BELGIUM,1,HEATHROW,BRUSSELS,571967,571967,0,628148,628148,0,-8.94391
29/01/2018 17:06,2016,1,WESTERN EUROPE-EU,BELGIUM,1,HEATHROW,LIEGE,3076,3076,0,0,0,0,0
29/01/2018 17:06,2016,1,WESTERN EUROPE-EU,BELGIUM,1,LONDON CITY,ANTWERP,54885,54885,0,58548,58548,0,-6.25641
29/01/2018 17:06,2016,1,WESTERN EUROPE-EU,BELGIUM,1,LUTON,BRUSSELS,50,0,50,168,0,168,-70.2381
29/01/2018 17:06,2016,1,WESTERN EUROPE-EU,BELGIUM,1,LUTON,LIEGE,10,0,10,99,0,99,-89.89899
29/01/2018 17:06,2016,1,WESTERN EUROPE-EU,BELGIUM,1,LUTON,OSTEND,152,152,0,74,0,74,105.40541
29/01/2018 17:06,2016,1,WESTERN EUROPE-EU,BELGIUM,1,SOUTHEND,ANTWERP,313,313,0,663,663,0,-52.79035
29/01/2018 17:06,2016,1,WESTERN EUROPE-EU,BELGIUM,1,STANSTED,BRUSSELS,0,0,0,98,0,98,-100
29/01/2018 17:06,2016,1,WESTERN EUROPE-EU,BELGIUM,2,ABERDEEN,KORTRIJK/WEVELGEM,51,0,51,0,0,0,0
29/01/2018 17:06,2016,1,WESTERN EUROPE-EU,BELGIUM,2,ABERDEEN,OSTEND,0,0,0,43,0,43,-100
29/01/2018 17:06,2016,1,WESTERN EUROPE-EU,BELGIUM,2,BELFAST CITY (GEORGE BEST),ANTWERP,152,152,0,0,0,0,0
29/01/2018 17:06,2016,1,WESTERN EUROPE-EU,BELGIUM,2,BELFAST CITY (GEORGE BEST),BRUSSELS,19841,19841,0,0,0,0,0
29/01/2018 17:06,2016,1,WESTERN EUROPE-EU,BELGIUM,2,BIRMINGHAM,ANTWERP,962,962,0,764,665,99,25.91623
29/01/2018 17:06,2016,1,WESTERN EUROPE-EU,BELGIUM,2,BIRMINGHAM,BRUSSELS,132995,132995,0,143643,143643,0,-7.41282
29/01/2018 17:06,2016,1,WESTERN EUROPE-EU,BELGIUM,2,BIRMINGHAM,OSTEND,180,130,50,0,0,0,0
29/01/2018 17:06,2016,1,WESTERN EUROPE-EU,BELGIUM,2,BRISTOL,ANTWERP,89,0,89,55,0,55,61.81818
29/01/2018 17:06,2016,1,WESTERN EUROPE-EU,BELGIUM,2,BRISTOL,BRUSSELS,56447,56447,0,56638,56638,0,-0.33723
29/01/2018 17:06,2016,1,WESTERN EUROPE-EU,BELGIUM,2,CARDIFF WALES,ANTWERP,0,0,0,86,0,86,-100
29/01/2018 17:06,2016,1,WESTERN EUROPE-EU,BELGIUM,2,CARDIFF WALES,BRUSSELS,51,51,0,217,0,217,-76.4977
29/01/2018 17:06,2016,1,WESTERN EUROPE-EU,BELGIUM,2,CARDIFF WALES,OSTEND,248,0,248,0,0,0,0
29/01/2018 17:06,2016,1,WESTERN EUROPE-EU,BELGIUM,2,DURHAM TEES VALLEY,LIEGE,0,0,0,20,0,20,-100
29/01/2018 17:06,2016,1,WESTERN EUROPE-EU,BELGIUM,2,EAST MIDLANDS INTERNATIONAL,BRUSSELS,14366,14366,0,23668,23592,76,-39.30201
29/01/2018 17:06,2016,1,WESTERN EUROPE-EU,BELGIUM,2,EAST MIDLANDS INTERNATIONAL,LIEGE,0,0,0,12,0,12,-100
29/01/2018 17:06,2016,1,WESTERN EUROPE-EU,BELGIUM,2,EAST MIDLANDS INTERNATIONAL,OSTEND,266,132,134,0,0,0,0
29/01/2018 17:06,2016,1,WESTERN EUROPE-EU,BELGIUM,2,EDINBURGH,ANTWERP,1212,1173,39,0,0,0,0
29/01/2018 17:06,2016,1,WESTERN EUROPE-EU,BELGIUM,2,EDINBURGH,BRUSSELS,106685,106382,303,100433,99928,505,6.22505
29/01/2018 17:06,2016,1,WESTERN EUROPE-EU,BELGIUM,2,EDINBURGH,CHARLEROI,82129,82129,0,71701,71701,0,14.54373
29/01/2018 17:06,2016,1,WESTERN EUROPE-EU,BELGIUM,2,EXETER,BRUSSELS,80,80,0,0,0,0,0
29/01/2018 17:06,2016,1,WESTERN EUROPE-EU,BELGIUM,2,GLASGOW,ANTWERP,39,0,39,0,0,0,0
29/01/2018 17:06,2016,1,WESTERN EUROPE-EU,BELGIUM,2,GLASGOW,CHARLEROI,4623,4623,0,0,0,0,0
29/01/2018 17:06,2016,1,WESTERN EUROPE-EU,BELGIUM,2,ISLE OF MAN,ANTWERP,0,0,0,80,0,80,-100
29/01/2018 17:06,2016,1,WESTERN EUROPE-EU,BELGIUM,2,LIVERPOOL (JOHN LENNON),ANTWERP,32,0,32,0,0,0,0
29/01/2018 17:06,2016,1,WESTERN EUROPE-EU,BELGIUM,2,MANCHESTER,ANTWERP,703,703,0,199,0,199,253.26633
29/01/2018 17:06,2016,1,WESTERN EUROPE-EU,BELGIUM,2,MANCHESTER,BRUSSELS,192836,192836,0,200093,199676,417,-3.62681
29/01/2018 17:06,2016,1,WESTERN EUROPE-EU,BELGIUM,2,MANCHESTER,CHARLEROI,182653,182653,0,183551,183551,0,-0.48924
29/01/2018 17:06,2016,1,WESTERN EUROPE-EU,BELGIUM,2,MANCHESTER,OSTEND,57,0,57,1688,0,1688,-96.62322
29/01/2018 17:06,2016,1,WESTERN EUROPE-EU,BELGIUM,2,NEWCASTLE,ANTWERP,88,0,88,0,0,0,0
29/01/2018 17:06,2016,1,WESTERN EUROPE-EU,BELGIUM,2,NEWCASTLE,BRUSSELS,19431,19378,53,26403,26403,0,-26.40609
29/01/2018 17:06,2016,1,WESTERN EUROPE-EU,BELGIUM,2,NEWCASTLE,LIEGE,6,0,6,0,0,0,0
29/01/2018 17:06,2016,1,WESTERN EUROPE-EU,BELGIUM,2,OXFORD (KIDLINGTON),ANTWERP,0,0,0,122,0,122,-100
29/01/2018 17:06,2016,1,WESTERN EUROPE-EU,BELGIUM,2,PRESTWICK,KORTRIJK/WEVELGEM,24,0,24,0,0,0,0
29/01/2018 17:06,2016,1,WESTERN EUROPE-EU,BELGIUM,2,SOUTHAMPTON,ANTWERP,181,181,0,629,629,0,-71.22417
29/01/2018 17:06,2016,1,WESTERN EUROPE-EU,CROATIA,1,GATWICK,DUBROVNIK,221326,220003,1323,199741,199109,632,10.80649
29/01/2018 17:06,2016,1,WESTERN EUROPE-EU,CROATIA,1,GATWICK,PULA,44969,28127,16842,31582,16226,15356,42.38807
29/01/2018 17:06,2016,1,WESTERN EUROPE-EU,CROATIA,1,GATWICK,SPLIT,150287,141776,8511,124661,118420,6241,20.55655
29/01/2018 17:06,2016,1,WESTERN EUROPE-EU,CROATIA,1,GATWICK,ZAGREB,375,375,0,0,0,0,0
29/01/2018 17:06,2016,1,WESTERN EUROPE-EU,CROATIA,1,HEATHROW,DUBROVNIK,143,143,0,0,0,0,0
29/01/2018 17:06,2016,1,WESTERN EUROPE-EU,CROATIA,1,HEATHROW,RIJEKA,2928,2928,0,89,89,0,3189.88764
29/01/2018 17:06,2016,1,WESTERN EUROPE-EU,CROATIA,1,HEATHROW,SPLIT,32240,32240,0,18445,18445,0,74.78992
29/01/2018 17:06,2016,1,WESTERN EUROPE-EU,CROATIA,1,HEATHROW,ZAGREB,179912,179912,0,181789,181479,310,-1.03252
29/01/2018 17:06,2016,1,WESTERN EUROPE-EU,CROATIA,1,LUTON,DUBROVNIK,14018,13979,39,0,0,0,0
29/01/2018 17:06,2016,1,WESTERN EUROPE-EU,CROATIA,1,LUTON,SPLIT,62532,62532,0,49424,49424,0,26.52153
29/01/2018 17:06,2016,1,WESTERN EUROPE-EU,CROATIA,1,LUTON,ZAGREB,0,0,0,194,0,194,-100
29/01/2018 17:06,2016,1,WESTERN EUROPE-EU,CROATIA,1,STANSTED,DUBROVNIK,28837,28196,641,19137,19137,0,50.68715
29/01/2018 17:06,2016,1,WESTERN EUROPE-EU,CROATIA,1,STANSTED,OSIJEK,20702,20702,0,20980,20980,0,-1.32507
29/01/2018 17:06,2016,1,WESTERN EUROPE-EU,CROATIA,1,STANSTED,PULA,23048,23048,0,22927,22927,0,0.52776
29/01/2018 17:06,2016,1,WESTERN EUROPE-EU,CROATIA,1,STANSTED,RIJEKA,10958,10958,0,8670,8670,0,26.38985
29/01/2018 17:06,2016,1,WESTERN EUROPE-EU,CROATIA,1,STANSTED,SPLIT,26774,26774,0,16002,16002,0,67.31659
29/01/2018 17:06,2016,1,WESTERN EUROPE-EU,CROATIA,1,STANSTED,ZADAR,32662,32479,183,33211,33211,0,-1.65307
29/01/2018 17:06,2016,1,WESTERN EUROPE-EU,CROATIA,2,ABERDEEN,RIJEKA,0,0,0,359,0,359,-100
29/01/2018 17:06,2016,1,WESTERN EUROPE-EU,CROATIA,2,BELFAST INTERNATIONAL,DUBROVNIK,5858,5858,0,5860,5860,0,-0.03413
29/01/2018 17:06,2016,1,WESTERN EUROPE-EU,CROATIA,2,BELFAST INTERNATIONAL,SPLIT,5952,5658,294,5442,5146,296,9.37155
29/01/2018 17:06,2016,1,WESTERN EUROPE-EU,CROATIA,2,BELFAST INTERNATIONAL,ZAGREB,163,0,163,0,0,0,0
29/01/2018 17:06,2016,1,WESTERN EUROPE-EU,CROATIA,2,BIRMINGHAM,DUBROVNIK,38061,37290,771,27595,27595,0,37.92716
29/01/2018 17:06,2016,1,WESTERN EUROPE-EU,CROATIA,2,BIRMINGHAM,PULA,14238,0,14238,15261,0,15261,-6.70336
29/01/2018 17:06,2016,1,WESTERN EUROPE-EU,CROATIA,2,BIRMINGHAM,ZAGREB,121,0,121,0,0,0,0
29/01/2018 17:06,2016,1,WESTERN EUROPE-EU,CROATIA,2,BRISTOL,DUBROVNIK,22942,21469,1473,9076,9076,0,152.77655
29/01/2018 17:06,2016,1,WESTERN EUROPE-EU,CROATIA,2,BRISTOL,PULA,6985,0,6985,6860,0,6860,1.82216
29/01/2018 17:06,2016,1,WESTERN EUROPE-EU,CROATIA,2,BRISTOL,SPLIT,18474,18474,0,16897,16897,0,9.33302
29/01/2018 17:06,2016,1,WESTERN EUROPE-EU,CROATIA,2,CARDIFF WALES,DUBROVNIK,0,0,0,185,0,185,-100
29/01/2018 17:06,2016,1,WESTERN EUROPE-EU,CROATIA,2,EAST MIDLANDS INTERNATIONAL,DUBROVNIK,14241,13893,348,12425,12425,0,14.61569
29/01/2018 17:06,2016,1,WESTERN EUROPE-EU,CROATIA,2,EAST MIDLANDS INTERNATIONAL,PULA,6177,0,6177,0,0,0,0
29/01/2018 17:06,2016,1,WESTERN EUROPE-EU,CROATIA,2,EDINBURGH,DUBROVNIK,29897,29897,0,23290,23290,0,28.3684
29/01/2018 17:06,2016,1,WESTERN EUROPE-EU,CROATIA,2,EDINBURGH,PULA,4761,4761,0,5015,5015,0,-5.06481
29/01/2018 17:06,2016,1,WESTERN EUROPE-EU,CROATIA,2,EDINBURGH,SPLIT,4905,4905,0,5030,5030,0,-2.48509
29/01/2018 17:06,2016,1,WESTERN EUROPE-EU,CROATIA,2,EDINBURGH,ZAGREB,342,0,342,0,0,0,0
29/01/2018 17:06,2016,1,WESTERN EUROPE-EU,CROATIA,2,GLASGOW,DUBROVNIK,10888,5486,5402,11141,10588,553,-2.27089
29/01/2018 17:06,2016,1,WESTERN EUROPE-EU,CROATIA,2,GLASGOW,SPLIT,11422,11422,0,11439,11439,0,-0.14861
29/01/2018 17:06,2016,1,WESTERN EUROPE-EU,CROATIA,2,HUMBERSIDE,DUBROVNIK,90,0,90,0,0,0,0
29/01/2018 17:06,2016,1,WESTERN EUROPE-EU,CROATIA,2,LEEDS BRADFORD,DUBROVNIK,14230,14230,0,12569,12569,0,13.21505
29/01/2018 17:06,2016,1,WESTERN EUROPE-EU,CROATIA,2,LEEDS BRADFORD,PULA,5226,5226,0,4966,4966,0,5.2356
29/01/2018 17:06,2016,1,WESTERN EUROPE-EU,CROATIA,2,LEEDS BRADFORD,SPLIT,5776,5776,0,4980,4980,0,15.98394
29/01/2018 17:06,2016,1,WESTERN EUROPE-EU,CROATIA,2,MANCHESTER,DUBROVNIK,60068,59672,396,49104,49104,0,22.32812
29/01/2018 17:06,2016,1,WESTERN EUROPE-EU,CROATIA,2,MANCHESTER,PULA,28388,13255,15133,24246,8751,15495,17.08323
29/01/2018 17:06,2016,1,WESTERN EUROPE-EU,CROATIA,2,MANCHESTER,SPLIT,35545,27029,8516,31054,22913,8141,14.46191
29/01/2018 17:06,2016,1,WESTERN EUROPE-EU,CROATIA,2,MANCHESTER,ZADAR,16054,14948,1106,20168,20168,0,-20.39865
29/01/2018 17:06,2016,1,WESTERN EUROPE-EU,CROATIA,2,MANCHESTER,ZAGREB,0,0,0,96,0,96,-100
29/01/2018 17:06,2016,1,WESTERN EUROPE-EU,CROATIA,2,NEWCASTLE,DUBROVNIK,19590,19590,0,19896,19896,0,-1.538
29/01/2018 17:06,2016,1,WESTERN EUROPE-EU,CROATIA,2,NEWCASTLE,SPLIT,6699,6699,0,8852,8852,0,-24.32219
29/01/2018 17:06,2016,1,WESTERN EUROPE-EU,CYPRUS,1,GATWICK,LARNACA,283878,229224,54654,279014,198666,80348,1.74328
29/01/2018 17:06,2016,1,WESTERN EUROPE-EU,CYPRUS,1,GATWICK,PAPHOS,395399,293918,101481,357614,248397,109217,10.56586
29/01/2018 17:06,2016,1,WESTERN EUROPE-EU,CYPRUS,1,HEATHROW,LARNACA,306994,306994,0,279038,279038,0,10.01871
29/01/2018 17:06,2016,1,WESTERN EUROPE-EU,CYPRUS,1,LUTON,LARNACA,81058,71912,9146,53307,44367,8940,52.05883
29/01/2018 17:06,2016,1,WESTERN EUROPE-EU,CYPRUS,1,LUTON,PAPHOS,97412,61974,35438,77908,48363,29545,25.03466
29/01/2018 17:06,2016,1,WESTERN EUROPE-EU,CYPRUS,1,STANSTED,LARNACA,49805,49805,0,2413,2287,126,1964.02818
29/01/2018 17:06,2016,1,WESTERN EUROPE-EU,CYPRUS,1,STANSTED,PAPHOS,167666,131368,36298,156241,134665,21576,7.31242
29/01/2018 17:06,2016,1,WESTERN EUROPE-EU,CYPRUS,2,BELFAST INTERNATIONAL,LARNACA,19162,0,19162,19327,0,19327,-0.85373
29/01/2018 17:06,2016,1,WESTERN EUROPE-EU,CYPRUS,2,BIRMINGHAM,LARNACA,121834,96043,25791,109752,65886,43866,11.00846
29/01/2018 17:06,2016,1,WESTERN EUROPE-EU,CYPRUS,2,BIRMINGHAM,PAPHOS,80264,35233,45031,77985,28770,49215,2.92236
29/01/2018 17:06,2016,1,WESTERN EUROPE-EU,CYPRUS,2,BOURNEMOUTH,PAPHOS,14079,0,14079,13523,0,13523,4.11151
29/01/2018 17:06,2016,1,WESTERN EUROPE-EU,CYPRUS,2,BRISTOL,LARNACA,41821,20688,21133,25888,0,25888,61.54589
29/01/2018 17:06,2016,1,WESTERN EUROPE-EU,CYPRUS,2,BRISTOL,PAPHOS,61517,44771,16746,56062,43554,12508,9.7303
29/01/2018 17:06,2016,1,WESTERN EUROPE-EU,CYPRUS,2,CARDIFF WALES,LARNACA,18212,0,18212,17985,0,17985,1.26216
29/01/2018 17:06,2016,1,WESTERN EUROPE-EU,CYPRUS,2,CARDIFF WALES,PAPHOS,14335,0,14335,13747,0,13747,4.2773
29/01/2018 17:06,2016,1,WESTERN EUROPE-EU,CYPRUS,2,DONCASTER SHEFFIELD,LARNACA,7976,0,7976,0,0,0,0
29/01/2018 17:06,2016,1,WESTERN EUROPE-EU,CYPRUS,2,DONCASTER SHEFFIELD,PAPHOS,24156,0,24156,23159,0,23159,4.30502
29/01/2018 17:06,2016,1,WESTERN EUROPE-EU,CYPRUS,2,EAST MIDLANDS INTERNATIONAL,LARNACA,29318,19924,9394,29479,7791,21688,-0.54615
29/01/2018 17:06,2016,1,WESTERN EUROPE-EU,CYPRUS,2,EAST MIDLANDS INTERNATIONAL,PAPHOS,67560,41411,26149,68433,20177,48256,-1.2757
29/01/2018 17:06,2016,1,WESTERN EUROPE-EU,CYPRUS,2,EDINBURGH,LARNACA,16402,7807,8595,0,0,0,0
29/01/2018 17:06,2016,1,WESTERN EUROPE-EU,CYPRUS,2,EDINBURGH,PAPHOS,54083,41141,12942,44664,33902,10762,21.08857
29/01/2018 17:06,2016,1,WESTERN EUROPE-EU,CYPRUS,2,EXETER,LARNACA,9379,0,9379,9512,0,9512,-1.39823
29/01/2018 17:06,2016,1,WESTERN EUROPE-EU,CYPRUS,2,EXETER,PAPHOS,13823,0,13823,13797,0,13797,0.18845
29/01/2018 17:06,2016,1,WESTERN EUROPE-EU,CYPRUS,2,GLASGOW,LARNACA,41895,19472,22423,44102,8991,35111,-5.00431
29/01/2018 17:06,2016,1,WESTERN EUROPE-EU,CYPRUS,2,GLASGOW,PAPHOS,50017,20062,29955,45518,18472,27046,9.884
29/01/2018 17:06,2016,1,WESTERN EUROPE-EU,CYPRUS,2,LEEDS BRADFORD,LARNACA,36575,36575,0,37756,37756,0,-3.12798
29/01/2018 17:06,2016,1,WESTERN EUROPE-EU,CYPRUS,2,LEEDS BRADFORD,PAPHOS,34611,26015,8596,24541,24541,0,41.03337
29/01/2018 17:06,2016,1,WESTERN EUROPE-EU,CYPRUS,2,LIVERPOOL (JOHN LENNON),LARNACA,35083,35083,0,34555,34555,0,1.528
29/01/2018 17:06,2016,1,WESTERN EUROPE-EU,CYPRUS,2,MANCHESTER,LARNACA,147654,89193,58461,138707,38680,100027,6.45029
29/01/2018 17:06,2016,1,WESTERN EUROPE-EU,CYPRUS,2,MANCHESTER,PAPHOS,299897,201239,98658,267604,154613,112991,12.06746
29/01/2018 17:06,2016,1,WESTERN EUROPE-EU,CYPRUS,2,NEWCASTLE,LARNACA,45600,45416,184,40899,7809,33090,11.49417
29/01/2018 17:06,2016,1,WESTERN EUROPE-EU,CYPRUS,2,NEWCASTLE,PAPHOS,50092,47542,2550,46336,20379,25957,8.10601
29/01/2018 17:06,2016,1,WESTERN EUROPE-EU,DENMARK,1,GATWICK,AALBORG,33694,33694,0,33054,33054,0,1.93623
29/01/2018 17:06,2016,1,WESTERN EUROPE-EU,DENMARK,1,GATWICK,COPENHAGEN,777585,777584,1,796504,796504,0,-2.37525
29/01/2018 17:06,2016,1,WESTERN EUROPE-EU,DENMARK,1,HEATHROW,BILLUND,82007,82007,0,0,0,0,0
29/01/2018 17:06,2016,1,WESTERN EUROPE-EU,DENMARK,1,HEATHROW,COPENHAGEN,949566,949566,0,997988,997988,0,-4.85196
29/01/2018 17:06,2016,1,WESTERN EUROPE-EU,DENMARK,1,LONDON CITY,BILLUND,19457,19457,0,23458,23458,0,-17.05602
29/01/2018 17:06,2016,1,WESTERN EUROPE-EU,DENMARK,1,LUTON,AARHUS (TIRSTRUP),27,0,27,0,0,0,0
29/01/2018 17:06,2016,1,WESTERN EUROPE-EU,DENMARK,1,LUTON,BILLUND,0,0,0,25,0,25,-100
29/01/2018 17:06,2016,1,WESTERN EUROPE-EU,DENMARK,1,LUTON,COPENHAGEN,767732,767723,9,408929,408929,0,87.74213
29/01/2018 17:06,2016,1,WESTERN EUROPE-EU,DENMARK,1,LUTON,ODENSE,0,0,0,46,0,46,-100
29/01/2018 17:06,2016,1,WESTERN EUROPE-EU,DENMARK,1,LUTON,ROSKILDE,0,0,0,99,0,99,-100
29/01/2018 17:06,2016,1,WESTERN EUROPE-EU,DENMARK,1,SOUTHEND,BILLUND,324,287,37,0,0,0,0
29/01/2018 17:06,2016,1,WESTERN EUROPE-EU,DENMARK,1,STANSTED,AARHUS (TIRSTRUP),95795,95795,0,90344,90344,0,6.0336
29/01/2018 17:06,2016,1,WESTERN EUROPE-EU,DENMARK,1,STANSTED,BILLUND,211729,211729,0,258203,258203,0,-17.99902
29/01/2018 17:06,2016,1,WESTERN EUROPE-EU,DENMARK,1,STANSTED,COPENHAGEN,377,0,377,22551,22551,0,-98.32823
29/01/2018 17:06,2016,1,WESTERN EUROPE-EU,DENMARK,2,ABERDEEN,COPENHAGEN,39198,39198,0,50838,50838,0,-22.89626
29/01/2018 17:06,2016,1,WESTERN EUROPE-EU,DENMARK,2,ABERDEEN,ESBJERG,7416,7400,16,9991,9433,558,-25.7732
29/01/2018 17:06,2016,1,WESTERN EUROPE-EU,DENMARK,2,BELFAST CITY (GEORGE BEST),COPENHAGEN,95,0,95,0,0,0,0
29/01/2018 17:06,2016,1,WESTERN EUROPE-EU,DENMARK,2,BELFAST INTERNATIONAL,COPENHAGEN,129,0,129,61,0,61,111.47541
29/01/2018 17:06,2016,1,WESTERN EUROPE-EU,DENMARK,2,BIRMINGHAM,COPENHAGEN,95434,95434,0,93013,92894,119,2.60286
29/01/2018 17:06,2016,1,WESTERN EUROPE-EU,DENMARK,2,BOURNEMOUTH,BILLUND,31,31,0,88,0,88,-64.77273
29/01/2018 17:06,2016,1,WESTERN EUROPE-EU,DENMARK,2,BOURNEMOUTH,KARUP,0,0,0,47,0,47,-100
29/01/2018 17:06,2016,1,WESTERN EUROPE-EU,DENMARK,2,BRISTOL,COPENHAGEN,31156,31156,0,39254,39254,0,-20.62974
29/01/2018 17:06,2016,1,WESTERN EUROPE-EU,DENMARK,2,CARDIFF WALES,COPENHAGEN,300,300,0,0,0,0,0
29/01/2018 17:06,2016,1,WESTERN EUROPE-EU,DENMARK,2,EAST MIDLANDS INTERNATIONAL,COPENHAGEN,2116,0,2116,0,0,0,0
29/01/2018 17:06,2016,1,WESTERN EUROPE-EU,DENMARK,2,EDINBURGH,BILLUND,0,0,0,425,0,425,-100
29/01/2018 17:06,2016,1,WESTERN EUROPE-EU,DENMARK,2,EDINBURGH,COPENHAGEN,250778,250611,167,191896,191896,0,30.68433
29/01/2018 17:06,2016,1,WESTERN EUROPE-EU,DENMARK,2,EDINBURGH,ODENSE,439,0,439,0,0,0,0
29/01/2018 17:06,2016,1,WESTERN EUROPE-EU,DENMARK,2,EDINBURGH,ROSKILDE,170,0,170,0,0,0,0
29/01/2018 17:06,2016,1,WESTERN EUROPE-EU,DENMARK,2,EXETER,COPENHAGEN,0,0,0,10,0,10,-100
29/01/2018 17:06,2016,1,WESTERN EUROPE-EU,DENMARK,2,GLASGOW,COPENHAGEN,32,0,32,889,0,889,-96.40045
29/01/2018 17:06,2016,1,WESTERN EUROPE-EU,DENMARK,2,GLASGOW,ESBJERG,277,0,277,0,0,0,0
29/01/2018 17:06,2016,1,WESTERN EUROPE-EU,DENMARK,2,GLASGOW,KARUP,37,0,37,0,0,0,0
29/01/2018 17:06,2016,1,WESTERN EUROPE-EU,DENMARK,2,HUMBERSIDE,AALBORG,2229,2122,107,0,0,0,0
29/01/2018 17:06,2016,1,WESTERN EUROPE-EU,DENMARK,2,HUMBERSIDE,BILLUND,359,283,76,31,0,31,1058.06452
29/01/2018 17:06,2016,1,WESTERN EUROPE-EU,DENMARK,2,JERSEY,BILLUND,277,277,0,0,0,0,0
29/01/2018 17:06,2016,1,WESTERN EUROPE-EU,DENMARK,2,JERSEY,COPENHAGEN,1160,1160,0,0,0,0,0
29/01/2018 17:06,2016,1,WESTERN EUROPE-EU,DENMARK,2,JERSEY,ODENSE,118,59,59,0,0,0,0
29/01/2018 17:06,2016,1,WESTERN EUROPE-EU,DENMARK,2,LEEDS BRADFORD,COPENHAGEN,275,275,0,276,276,0,-0.36232
29/01/2018 17:06,2016,1,WESTERN EUROPE-EU,DENMARK,2,MANCHESTER,AARHUS (TIRSTRUP),80,0,80,7016,7016,0,-98.85975
29/01/2018 17:06,2016,1,WESTERN EUROPE-EU,DENMARK,2,MANCHESTER,BILLUND,23989,23213,776,22373,22373,0,7.22299
29/01/2018 17:06,2016,1,WESTERN EUROPE-EU,DENMARK,2,MANCHESTER,COPENHAGEN,334894,334894,0,297187,297187,0,12.68797
29/01/2018 17:06,2016,1,WESTERN EUROPE-EU,DENMARK,2,MANCHESTER,KARUP,602,0,602,0,0,0,0
29/01/2018 17:06,2016,1,WESTERN EUROPE-EU,DENMARK,2,NEWCASTLE,BILLUND,95,0,95,0,0,0,0
29/01/2018 17:06,2016,1,WESTERN EUROPE-EU,DENMARK,2,NEWCASTLE,COPENHAGEN,22371,22371,0,22798,22542,256,-1.87297
29/01/2018 17:06,2016,1,WESTERN EUROPE-EU,DENMARK,2,NEWCASTLE,ESBJERG,0,0,0,282,0,282,-100
29/01/2018 17:06,2016,1,WESTERN EUROPE-EU,DENMARK,2,NEWQUAY,BILLUND,33,0,33,0,0,0,0
29/01/2018 17:06,2016,1,WESTERN EUROPE-EU,DENMARK,2,NORWICH,BILLUND,0,0,0,182,0,182,-100
29/01/2018 17:06,2016,1,WESTERN EUROPE-EU,DENMARK,2,SOUTHAMPTON,BILLUND,0,0,0,170,0,170,-100
29/01/2018 17:06,2016,1,WESTERN EUROPE-EU,DENMARK,2,SOUTHAMPTON,KARUP,0,0,0,44,0,44,-100
29/01/2018 17:06,2016,1,WESTERN EUROPE-EU,FINLAND,1,GATWICK,ENONTEKIO,5058,0,5058,4015,0,4015,25.97758
29/01/2018 17:06,2016,1,WESTERN EUROPE-EU,FINLAND,1,GATWICK,HELSINKI,226870,226681,189,217815,217815,0,4.1572
29/01/2018 17:06,2016,1,WESTERN EUROPE-EU,FINLAND,1,GATWICK,IVALO,9043,0,9043,8738,0,8738,3.4905
29/01/2018 17:06,2016,1,WESTERN EUROPE-EU,FINLAND,1,GATWICK,KITTILA,18825,3504,15321,19581,177,19404,-3.86089
29/01/2018 17:06,2016,1,WESTERN EUROPE-EU,FINLAND,1,GATWICK,KUUSAMO,4201,0,4201,3579,0,3579,17.37916
29/01/2018 17:06,2016,1,WESTERN EUROPE-EU,FINLAND,1,GATWICK,ROVANIEMI,17448,3903,13545,10721,0,10721,62.74601
29/01/2018 17:06,2016,1,WESTERN EUROPE-EU,FINLAND,1,HEATHROW,HELSINKI,677413,677263,150,655532,655532,0,3.3379
29/01/2018 17:06,2016,1,WESTERN EUROPE-EU,FINLAND,1,LUTON,ENONTEKIO,202,0,202,378,0,378,-46.56085
29/01/2018 17:06,2016,1,WESTERN EUROPE-EU,FINLAND,1,LUTON,IVALO,886,0,886,317,0,317,179.49527
29/01/2018 17:06,2016,1,WESTERN EUROPE-EU,FINLAND,1,LUTON,KITTILA,0,0,0,62,0,62,-100
29/01/2018 17:06,2016,1,WESTERN EUROPE-EU,FINLAND,1,LUTON,TAMPERE,0,0,0,59,0,59,-100
29/01/2018 17:06,2016,1,WESTERN EUROPE-EU,FINLAND,1,LUTON,VAASA,21,0,21,0,0,0,0
29/01/2018 17:06,2016,1,WESTERN EUROPE-EU,FINLAND,1,STANSTED,ENONTEKIO,1510,0,1510,1634,0,1634,-7.58874
29/01/2018 17:06,2016,1,WESTERN EUROPE-EU,FINLAND,1,STANSTED,HELSINKI,162,0,162,0,0,0,0
29/01/2018 17:06,2016,1,WESTERN EUROPE-EU,FINLAND,1,STANSTED,IVALO,1443,0,1443,1079,0,1079,33.73494
29/01/2018 17:06,2016,1,WESTERN EUROPE-EU,FINLAND,1,STANSTED,KITTILA,1179,0,1179,0,0,0,0
29/01/2018 17:06,2016,1,WESTERN EUROPE-EU,FINLAND,1,STANSTED,ROVANIEMI,376,0,376,374,0,374,0.53476
29/01/2018 17:06,2016,1,WESTERN EUROPE-EU,FINLAND,1,STANSTED,TAMPERE,0,0,0,42021,42021,0,-100
29/01/2018 17:06,2016,1,WESTERN EUROPE-EU,FINLAND,2,ABERDEEN,ENONTEKIO,372,0,372,376,0,376,-1.06383
29/01/2018 17:06,2016,1,WESTERN EUROPE-EU,FINLAND,2,ABERDEEN,IVALO,332,0,332,0,0,0,0
29/01/2018 17:06,2016,1,WESTERN EUROPE-EU,FINLAND,2,BELFAST CITY (GEORGE BEST),HELSINKI,0,0,0,72,0,72,-100
29/01/2018 17:06,2016,1,WESTERN EUROPE-EU,FINLAND,2,BELFAST INTERNATIONAL,ENONTEKIO,374,0,374,0,0,0,0
29/01/2018 17:06,2016,1,WESTERN EUROPE-EU,FINLAND,2,BELFAST INTERNATIONAL,HELSINKI,0,0,0,360,0,360,-100
29/01/2018 17:06,2016,1,WESTERN EUROPE-EU,FINLAND,2,BELFAST INTERNATIONAL,IVALO,358,0,358,0,0,0,0
29/01/2018 17:06,2016,1,WESTERN EUROPE-EU,FINLAND,2,BELFAST INTERNATIONAL,ROVANIEMI,1702,0,1702,1692,0,1692,0.59102
29/01/2018 17:06,2016,1,WESTERN EUROPE-EU,FINLAND,2,BIRMINGHAM,ENONTEKIO,2384,167,2217,1968,0,1968,21.13821
29/01/2018 17:06,2016,1,WESTERN EUROPE-EU,FINLAND,2,BIRMINGHAM,IVALO,1417,0,1417,360,0,360,293.61111
29/01/2018 17:06,2016,1,WESTERN EUROPE-EU,FINLAND,2,BIRMINGHAM,KITTILA,3065,0,3065,947,0,947,223.65364
29/01/2018 17:06,2016,1,WESTERN EUROPE-EU,FINLAND,2,BIRMINGHAM,ROVANIEMI,3808,0,3808,3798,0,3798,0.2633
29/01/2018 17:06,2016,1,WESTERN EUROPE-EU,FINLAND,2,BOURNEMOUTH,ENONTEKIO,372,0,372,378,0,378,-1.5873
29/01/2018 17:06,2016,1,WESTERN EUROPE-EU,FINLAND,2,BOURNEMOUTH,HELSINKI,184,184,0,0,0,0,0
29/01/2018 17:06,2016,1,WESTERN EUROPE-EU,FINLAND,2,BOURNEMOUTH,IVALO,714,0,714,0,0,0,0
29/01/2018 17:06,2016,1,WESTERN EUROPE-EU,FINLAND,2,BOURNEMOUTH,KITTILA,376,0,376,0,0,0,0
29/01/2018 17:06,2016,1,WESTERN EUROPE-EU,FINLAND,2,BRISTOL,ENONTEKIO,1461,0,1461,1737,0,1737,-15.88946
29/01/2018 17:06,2016,1,WESTERN EUROPE-EU,FINLAND,2,BRISTOL,IVALO,1097,0,1097,1387,0,1387,-20.90844
29/01/2018 17:06,2016,1,WESTERN EUROPE-EU,FINLAND,2,BRISTOL,KITTILA,8701,0,8701,4757,0,4757,82.9094
29/01/2018 17:06,2016,1,WESTERN EUROPE-EU,FINLAND,2,BRISTOL,ROVANIEMI,0,0,0,432,0,432,-100
29/01/2018 17:06,2016,1,WESTERN EUROPE-EU,FINLAND,2,CARDIFF WALES,ENONTEKIO,378,0,378,336,0,336,12.5
29/01/2018 17:06,2016,1,WESTERN EUROPE-EU,FINLAND,2,CARDIFF WALES,IVALO,358,0,358,0,0,0,0
29/01/2018 17:06,2016,1,WESTERN EUROPE-EU,FINLAND,2,DONCASTER SHEFFIELD,ENONTEKIO,702,0,702,727,0,727,-3.43879
29/01/2018 17:06,2016,1,WESTERN EUROPE-EU,FINLAND,2,DONCASTER SHEFFIELD,KITTILA,391,0,391,378,0,378,3.43915
29/01/2018 17:06,2016,1,WESTERN EUROPE-EU,FINLAND,2,DONCASTER SHEFFIELD,ROVANIEMI,388,0,388,0,0,0,0
29/01/2018 17:06,2016,1,WESTERN EUROPE-EU,FINLAND,2,EAST MIDLANDS INTERNATIONAL,ENONTEKIO,704,0,704,1285,0,1285,-45.21401
29/01/2018 17:06,2016,1,WESTERN EUROPE-EU,FINLAND,2,EAST MIDLANDS INTERNATIONAL,IVALO,360,180,180,700,0,700,-48.57143
29/01/2018 17:06,2016,1,WESTERN EUROPE-EU,FINLAND,2,EAST MIDLANDS INTERNATIONAL,KITTILA,815,0,815,3060,0,3060,-73.36601
29/01/2018 17:06,2016,1,WESTERN EUROPE-EU,FINLAND,2,EAST MIDLANDS INTERNATIONAL,ROVANIEMI,756,218,538,1881,0,1881,-59.80861
29/01/2018 17:06,2016,1,WESTERN EUROPE-EU,FINLAND,2,EDINBURGH,ENONTEKIO,750,0,750,1011,0,1011,-25.81602
29/01/2018 17:06,2016,1,WESTERN EUROPE-EU,FINLAND,2,EDINBURGH,HELSINKI,24625,24076,549,0,0,0,0
29/01/2018 17:06,2016,1,WESTERN EUROPE-EU,FINLAND,2,EDINBURGH,IVALO,358,0,358,327,0,327,9.48012
29/01/2018 17:06,2016,1,WESTERN EUROPE-EU,FINLAND,2,EDINBURGH,KITTILA,365,0,365,378,0,378,-3.43915
29/01/2018 17:06,2016,1,WESTERN EUROPE-EU,FINLAND,2,EXETER,ENONTEKIO,0,0,0,334,0,334,-100
29/01/2018 17:06,2016,1,WESTERN EUROPE-EU,FINLAND,2,EXETER,IVALO,356,0,356,275,0,275,29.45455
29/01/2018 17:06,2016,1,WESTERN EUROPE-EU,FINLAND,2,EXETER,KITTILA,374,0,374,0,0,0,0
29/01/2018 17:06,2016,1,WESTERN EUROPE-EU,FINLAND,2,GLASGOW,ENONTEKIO,1031,0,1031,671,0,671,53.65127
29/01/2018 17:06,2016,1,WESTERN EUROPE-EU,FINLAND,2,GLASGOW,IVALO,1068,0,1068,345,0,345,209.56522
29/01/2018 17:06,2016,1,WESTERN EUROPE-EU,FINLAND,2,GLASGOW,KITTILA,368,0,368,882,0,882,-58.27664
29/01/2018 17:06,2016,1,WESTERN EUROPE-EU,FINLAND,2,GLASGOW,ROVANIEMI,2811,0,2811,441,0,441,537.41497
29/01/2018 17:06,2016,1,WESTERN EUROPE-EU,FINLAND,2,HUMBERSIDE,ENONTEKIO,376,0,376,372,0,372,1.07527
29/01/2018 17:06,2016,1,WESTERN EUROPE-EU,FINLAND,2,JERSEY,HELSINKI,0,0,0,109,0,109,-100
29/01/2018 17:06,2016,1,WESTERN EUROPE-EU,FINLAND,2,JERSEY,MARIEHAMN,0,0,0,340,0,340,-100
29/01/2018 17:06,2016,1,WESTERN EUROPE-EU,FINLAND,2,LEEDS BRADFORD,ENONTEKIO,1087,0,1087,1160,0,1160,-6.2931
29/01/2018 17:06,2016,1,WESTERN EUROPE-EU,FINLAND,2,LEEDS BRADFORD,IVALO,1063,0,1063,707,0,707,50.35361
29/01/2018 17:06,2016,1,WESTERN EUROPE-EU,FINLAND,2,LIVERPOOL (JOHN LENNON),HELSINKI,0,0,0,101,0,101,-100
29/01/2018 17:06,2016,1,WESTERN EUROPE-EU,FINLAND,2,LIVERPOOL (JOHN LENNON),IVALO,1056,0,1056,349,0,349,202.5788
29/01/2018 17:06,2016,1,WESTERN EUROPE-EU,FINLAND,2,MANCHESTER,ENONTEKIO,3219,0,3219,3047,0,3047,5.6449
29/01/2018 17:06,2016,1,WESTERN EUROPE-EU,FINLAND,2,MANCHESTER,HELSINKI,105493,105253,240,108057,108057,0,-2.37282
29/01/2018 17:06,2016,1,WESTERN EUROPE-EU,FINLAND,2,MANCHESTER,IVALO,7471,0,7471,7599,0,7599,-1.68443
29/01/2018 17:06,2016,1,WESTERN EUROPE-EU,FINLAND,2,MANCHESTER,KITTILA,20931,4731,16200,18015,0,18015,16.18651
29/01/2018 17:06,2016,1,WESTERN EUROPE-EU,FINLAND,2,MANCHESTER,KUUSAMO,3578,0,3578,3426,0,3426,4.43666
29/01/2018 17:06,2016,1,WESTERN EUROPE-EU,FINLAND,2,MANCHESTER,ROVANIEMI,9028,0,9028,7507,0,7507,20.26109
29/01/2018 17:06,2016,1,WESTERN EUROPE-EU,FINLAND,2,NEWCASTLE,ENONTEKIO,378,378,0,335,0,335,12.83582
29/01/2018 17:06,2016,1,WESTERN EUROPE-EU,FINLAND,2,NEWCASTLE,IVALO,1035,1035,0,652,0,652,58.74233
29/01/2018 17:06,2016,1,WESTERN EUROPE-EU,FINLAND,2,NEWCASTLE,KITTILA,3009,3009,0,0,0,0,0
29/01/2018 17:06,2016,1,WESTERN EUROPE-EU,FINLAND,2,NEWCASTLE,ROVANIEMI,1258,1258,0,818,0,818,53.78973
29/01/2018 17:06,2016,1,WESTERN EUROPE-EU,FINLAND,2,PRESTWICK,ROVANIEMI,0,0,0,368,0,368,-100
29/01/2018 17:06,2016,1,WESTERN EUROPE-EU,FINLAND,2,SOUTHAMPTON,ENONTEKIO,682,0,682,1126,0,1126,-39.43162
29/01/2018 17:06,2016,1,WESTERN EUROPE-EU,FINLAND,2,SOUTHAMPTON,IVALO,300,0,300,300,0,300,0
29/01/2018 17:06,2016,1,WESTERN EUROPE-EU,FRANCE,1,GATWICK,AJACCIO,7746,7568,178,7290,7290,0,6.25514
29/01/2018 17:06,2016,1,WESTERN EUROPE-EU,FRANCE,1,GATWICK,BASTIA,10992,10992,0,11313,10984,329,-2.83744
29/01/2018 17:06,2016,1,WESTERN EUROPE-EU,FRANCE,1,GATWICK,BIARRITZ,24547,24546,1,22046,22046,0,11.34446
29/01/2018 17:06,2016,1,WESTERN EUROPE-EU,FRANCE,1,GATWICK,BORDEAUX,313399,313397,2,293052,292783,269,6.94314
29/01/2018 17:06,2016,1,WESTERN EUROPE-EU,FRANCE,1,GATWICK,BREST,0,0,0,5592,5592,0,-100
29/01/2018 17:06,2016,1,WESTERN EUROPE-EU,FRANCE,1,GATWICK,CHAMBERY,46781,0,46781,45671,0,45671,2.43043
29/01/2018 17:06,2016,1,WESTERN EUROPE-EU,FRANCE,1,GATWICK,CLERMONT FERRAND,0,0,0,1012,0,1012,-100
29/01/2018 17:06,2016,1,WESTERN EUROPE-EU,FRANCE,1,GATWICK,FIGARI,4576,4576,0,8201,8201,0,-44.20193
29/01/2018 17:06,2016,1,WESTERN EUROPE-EU,FRANCE,1,GATWICK,GRENOBLE,125656,57000,68656,122878,40808,82070,2.26078
29/01/2018 17:06,2016,1,WESTERN EUROPE-EU,FRANCE,1,GATWICK,LA ROCHELLE,23307,23307,0,22242,22242,0,4.78824
29/01/2018 17:06,2016,1,WESTERN EUROPE-EU,FRANCE,1,GATWICK,LE HAVRE,202,0,202,0,0,0,0
29/01/2018 17:06,2016,1,WESTERN EUROPE-EU,FRANCE,1,GATWICK,LILLE,0,0,0,144,0,144,-100
29/01/2018 17:06,2016,1,WESTERN EUROPE-EU,FRANCE,1,GATWICK,LYON,213720,190325,23395,215791,186746,29045,-0.95972
29/01/2018 17:06,2016,1,WESTERN EUROPE-EU,FRANCE,1,GATWICK,MARSEILLE,152311,152311,0,149453,149031,422,1.91231
29/01/2018 17:06,2016,1,WESTERN EUROPE-EU,FRANCE,1,GATWICK,MONTPELLIER,138595,138595,0,117963,117963,0,17.49023
29/01/2018 17:06,2016,1,WESTERN EUROPE-EU,FRANCE,1,GATWICK,NANTES,143931,143857,74,117851,117536,315,22.12964
29/01/2018 17:06,2016,1,WESTERN EUROPE-EU,FRANCE,1,GATWICK,NICE,594693,593314,1379,649357,647242,2115,-8.41817
29/01/2018 17:06,2016,1,WESTERN EUROPE-EU,FRANCE,1,GATWICK,PARIS (CHARLES DE GAULLE),329847,329605,242,206338,206128,210,59.85761
29/01/2018 17:06,2016,1,WESTERN EUROPE-EU,FRANCE,1,GATWICK,PARIS (LE BOURGET),206,0,206,705,0,705,-70.78014
29/01/2018 17:06,2016,1,WESTERN EUROPE-EU,FRANCE,1,GATWICK,PARIS (ORLY),1,0,1,0,0,0,0
29/01/2018 17:06,2016,1,WESTERN EUROPE-EU,FRANCE,1,GATWICK,RENNES,2135,2102,33,0,0,0,0
29/01/2018 17:06,2016,1,WESTERN EUROPE-EU,FRANCE,1,GATWICK,STRASBOURG,9527,9527,0,49387,49387,0,-80.7095
29/01/2018 17:06,2016,1,WESTERN EUROPE-EU,FRANCE,1,GATWICK,TARBES-LOURDES INTERNATIONAL,2203,0,2203,1730,0,1730,27.34104
29/01/2018 17:06,2016,1,WESTERN EUROPE-EU,FRANCE,1,GATWICK,TOULON / HYERES,0,0,0,751,0,751,-100
29/01/2018 17:06,2016,1,WESTERN EUROPE-EU,FRANCE,1,GATWICK,TOULOUSE (BLAGNAC),281826,275473,6353,274756,266760,7996,2.57319
29/01/2018 17:06,2016,1,WESTERN EUROPE-EU,FRANCE,1,HEATHROW,BASTIA,4825,0,4825,5299,0,5299,-8.94508
29/01/2018 17:06,2016,1,WESTERN EUROPE-EU,FRANCE,1,HEATHROW,BIARRITZ,10131,10131,0,0,0,0,0
29/01/2018 17:06,2016,1,WESTERN EUROPE-EU,FRANCE,1,HEATHROW,FIGARI,5986,0,5986,3132,0,3132,91.12388
29/01/2018 17:06,2016,1,WESTERN EUROPE-EU,FRANCE,1,HEATHROW,GRENOBLE,6409,0,6409,6044,0,6044,6.03905
29/01/2018 17:06,2016,1,WESTERN EUROPE-EU,FRANCE,1,HEATHROW,LYON,254759,254759,0,232631,232631,0,9.51206
29/01/2018 17:06,2016,1,WESTERN EUROPE-EU,FRANCE,1,HEATHROW,MARSEILLE,260601,260601,0,228226,228226,0,14.1855
29/01/2018 17:06,2016,1,WESTERN EUROPE-EU,FRANCE,1,HEATHROW,NICE,541715,541715,0,497290,496805,485,8.93342
29/01/2018 17:06,2016,1,WESTERN EUROPE-EU,FRANCE,1,HEATHROW,PARIS (CHARLES DE GAULLE),1143213,1142954,259,1252777,1252777,0,-8.74569
29/01/2018 17:06,2016,1,WESTERN EUROPE-EU,FRANCE,1,HEATHROW,PARIS (LE BOURGET),0,0,0,33,0,33,-100
29/01/2018 17:06,2016,1,WESTERN EUROPE-EU,FRANCE,1,HEATHROW,PARIS (ORLY),282673,282673,0,321622,321622,0,-12.11018
29/01/2018 17:06,2016,1,WESTERN EUROPE-EU,FRANCE,1,HEATHROW,TOULOUSE (BLAGNAC),260366,260366,0,259567,259567,0,0.30782
29/01/2018 17:06,2016,1,WESTERN EUROPE-EU,FRANCE,1,LONDON CITY,ANGERS- MARCE,6208,6208,0,3285,3285,0,88.98021
29/01/2018 17:06,2016,1,WESTERN EUROPE-EU,FRANCE,1,LONDON CITY,AVIGNON,2801,2801,0,1400,1400,0,100.07143
29/01/2018 17:06,2016,1,WESTERN EUROPE-EU,FRANCE,1,LONDON CITY,BERGERAC,8810,8810,0,0,0,0,0
29/01/2018 17:06,2016,1,WESTERN EUROPE-EU,FRANCE,1,LONDON CITY,BRIVE-LA-GAILLARDE,0,0,0,2445,2445,0,-100
29/01/2018 17:06,2016,1,WESTERN EUROPE-EU,FRANCE,1,LONDON CITY,CHAMBERY,6314,6314,0,6019,6019,0,4.90115
29/01/2018 17:06,2016,1,WESTERN EUROPE-EU,FRANCE,1,LONDON CITY,DINARD,127,0,127,0,0,0,0
29/01/2018 17:06,2016,1,WESTERN EUROPE-EU,FRANCE,1,LONDON CITY,GRENOBLE,174,174,0,0,0,0,0
29/01/2018 17:06,2016,1,WESTERN EUROPE-EU,FRANCE,1,LONDON CITY,MARSEILLE,0,0,0,20,0,20,-100
29/01/2018 17:06,2016,1,WESTERN EUROPE-EU,FRANCE,1,LONDON CITY,NANTES,25971,25971,0,22281,22281,0,16.5612
29/01/2018 17:06,2016,1,WESTERN EUROPE-EU,FRANCE,1,LONDON CITY,NICE,37244,37244,0,32438,32438,0,14.81596
29/01/2018 17:06,2016,1,WESTERN EUROPE-EU,FRANCE,1,LONDON CITY,PARIS (CHARLES DE GAULLE),13036,13036,0,0,0,0,0
29/01/2018 17:06,2016,1,WESTERN EUROPE-EU,FRANCE,1,LONDON CITY,PARIS (ORLY),111015,111015,0,123214,123214,0,-9.90066
29/01/2018 17:06,2016,1,WESTERN EUROPE-EU,FRANCE,1,LONDON CITY,QUIMPER,7147,7147,0,4539,4539,0,57.45759
29/01/2018 17:06,2016,1,WESTERN EUROPE-EU,FRANCE,1,LONDON CITY,RENNES,4241,4241,0,0,0,0,0
29/01/2018 17:06,2016,1,WESTERN EUROPE-EU,FRANCE,1,LONDON CITY,TOULON / HYERES,5091,5091,0,4252,4252,0,19.73189
29/01/2018 17:06,2016,1,WESTERN EUROPE-EU,FRANCE,1,LUTON,BEZIERS,54624,54624,0,56284,56284,0,-2.94933
29/01/2018 17:06,2016,1,WESTERN EUROPE-EU,FRANCE,1,LUTON,BORDEAUX,79615,79615,0,75177,73782,1395,5.9034
29/01/2018 17:06,2016,1,WESTERN EUROPE-EU,FRANCE,1,LUTON,BREST,482,482,0,0,0,0,0
29/01/2018 17:06,2016,1,WESTERN EUROPE-EU,FRANCE,1,LUTON,CANNES,8,0,8,0,0,0,0
29/01/2018 17:06,2016,1,WESTERN EUROPE-EU,FRANCE,1,LUTON,CHAMBERY,71,0,71,327,0,327,-78.28746
29/01/2018 17:06,2016,1,WESTERN EUROPE-EU,FRANCE,1,LUTON,CLERMONT FERRAND,633,633,0,3164,0,3164,-79.99368
29/01/2018 17:06,2016,1,WESTERN EUROPE-EU,FRANCE,1,LUTON,DEAUVILLE,13,0,13,12,0,12,8.33333
29/01/2018 17:06,2016,1,WESTERN EUROPE-EU,FRANCE,1,LUTON,GRENOBLE,6079,5852,227,5382,5382,0,12.95058
29/01/2018 17:06,2016,1,WESTERN EUROPE-EU,FRANCE,1,LUTON,LILLE,92,0,92,86,0,86,6.97674
29/01/2018 17:06,2016,1,WESTERN EUROPE-EU,FRANCE,1,LUTON,LYON,87774,87292,482,86499,85519,980,1.47401
29/01/2018 17:06,2016,1,WESTERN EUROPE-EU,FRANCE,1,LUTON,LYON(BRON),0,0,0,133,0,133,-100
29/01/2018 17:06,2016,1,WESTERN EUROPE-EU,FRANCE,1,LUTON,MARSEILLE,319,0,319,0,0,0,0
29/01/2018 17:06,2016,1,WESTERN EUROPE-EU,FRANCE,1,LUTON,METZ,0,0,0,10,0,10,-100
29/01/2018 17:06,2016,1,WESTERN EUROPE-EU,FRANCE,1,LUTON,MONTPELLIER,17776,17754,22,16753,16670,83,6.10637
29/01/2018 17:06,2016,1,WESTERN EUROPE-EU,FRANCE,1,LUTON,NICE,155655,154623,1032,153468,152405,1063,1.42505
29/01/2018 17:06,2016,1,WESTERN EUROPE-EU,FRANCE,1,LUTON,NIMES,79295,79295,0,78292,78292,0,1.2811
29/01/2018 17:06,2016,1,WESTERN EUROPE-EU,FRANCE,1,LUTON,PARIS (CHARLES DE GAULLE),254009,253708,301,267014,266971,43,-4.87053
29/01/2018 17:06,2016,1,WESTERN EUROPE-EU,FRANCE,1,LUTON,PARIS (LE BOURGET),140,5,135,223,0,223,-37.21973
29/01/2018 17:06,2016,1,WESTERN EUROPE-EU,FRANCE,1,LUTON,PARIS (ORLY),80100,80100,0,0,0,0,0
29/01/2018 17:06,2016,1,WESTERN EUROPE-EU,FRANCE,1,LUTON,PAU,0,0,0,369,0,369,-100
29/01/2018 17:06,2016,1,WESTERN EUROPE-EU,FRANCE,1,LUTON,POITIERS,0,0,0,38,0,38,-100
29/01/2018 17:06,2016,1,WESTERN EUROPE-EU,FRANCE,1,LUTON,RODEZ,1,0,1,0,0,0,0
29/01/2018 17:06,2016,1,WESTERN EUROPE-EU,FRANCE,1,LUTON,ST ETIENNE,289,0,289,204,0,204,41.66667
29/01/2018 17:06,2016,1,WESTERN EUROPE-EU,FRANCE,1,LUTON,STRASBOURG,39,39,0,9,0,9,333.33333
29/01/2018 17:06,2016,1,WESTERN EUROPE-EU,FRANCE,1,LUTON,TOULON / HYERES,265,0,265,1046,0,1046,-74.66539
29/01/2018 17:06,2016,1,WESTERN EUROPE-EU,FRANCE,1,LUTON,TOULOUSE (BLAGNAC),14126,13935,191,1452,0,1452,872.86501
29/01/2018 17:06,2016,1,WESTERN EUROPE-EU,FRANCE,1,SOUTHEND,CAEN,12566,12566,0,10363,10363,0,21.25832
29/01/2018 17:06,2016,1,WESTERN EUROPE-EU,FRANCE,1,SOUTHEND,LYON,3855,3855,0,498,498,0,674.09639
29/01/2018 17:06,2016,1,WESTERN EUROPE-EU,FRANCE,1,SOUTHEND,NANTES,233,233,0,0,0,0,0
29/01/2018 17:06,2016,1,WESTERN EUROPE-EU,FRANCE,1,SOUTHEND,PARIS (CHARLES DE GAULLE),38308,38308,0,0,0,0,0
29/01/2018 17:06,2016,1,WESTERN EUROPE-EU,FRANCE,1,SOUTHEND,PARIS (ORLY),125,125,0,0,0,0,0
29/01/2018 17:06,2016,1,WESTERN EUROPE-EU,FRANCE,1,SOUTHEND,PAU,0,0,0,366,0,366,-100
29/01/2018 17:06,2016,1,WESTERN EUROPE-EU,FRANCE,1,SOUTHEND,RENNES,41957,41957,0,34468,34468,0,21.7274
29/01/2018 17:06,2016,1,WESTERN EUROPE-EU,FRANCE,1,SOUTHEND,TOULON / HYERES,62,62,0,0,0,0,0
29/01/2018 17:06,2016,1,WESTERN EUROPE-EU,FRANCE,1,STANSTED,BERGERAC,104052,104052,0,105474,105474,0,-1.3482
29/01/2018 17:06,2016,1,WESTERN EUROPE-EU,FRANCE,1,STANSTED,BIARRITZ,98183,98183,0,98115,98115,0,0.06931
29/01/2018 17:06,2016,1,WESTERN EUROPE-EU,FRANCE,1,STANSTED,BORDEAUX,59723,59723,0,46757,46574,183,27.73061
29/01/2018 17:06,2016,1,WESTERN EUROPE-EU,FRANCE,1,STANSTED,BREST,659,659,0,0,0,0,0
29/01/2018 17:06,2016,1,WESTERN EUROPE-EU,FRANCE,1,STANSTED,BRIVE-LA-GAILLARDE,19414,19414,0,18548,18548,0,4.66897
29/01/2018 17:06,2016,1,WESTERN EUROPE-EU,FRANCE,1,STANSTED,CALVI,4340,0,4340,4369,0,4369,-0.66377
29/01/2018 17:06,2016,1,WESTERN EUROPE-EU,FRANCE,1,STANSTED,CARCASSONNE,99853,99853,0,100016,100016,0,-0.16297
29/01/2018 17:06,2016,1,WESTERN EUROPE-EU,FRANCE,1,STANSTED,CHAMBERY,19296,535,18761,19143,0,19143,0.79925
29/01/2018 17:06,2016,1,WESTERN EUROPE-EU,FRANCE,1,STANSTED,CLERMONT FERRAND,0,0,0,5894,5894,0,-100
29/01/2018 17:06,2016,1,WESTERN EUROPE-EU,FRANCE,1,STANSTED,DEAUVILLE,16892,16892,0,17612,17612,0,-4.08812
29/01/2018 17:06,2016,1,WESTERN EUROPE-EU,FRANCE,1,STANSTED,DINARD,77861,77861,0,86654,86654,0,-10.14725
29/01/2018 17:06,2016,1,WESTERN EUROPE-EU,FRANCE,1,STANSTED,GRENOBLE,22233,18005,4228,20048,16624,3424,10.89884
29/01/2018 17:06,2016,1,WESTERN EUROPE-EU,FRANCE,1,STANSTED,LA ROCHELLE,61930,61930,0,60970,60970,0,1.57454
29/01/2018 17:06,2016,1,WESTERN EUROPE-EU,FRANCE,1,STANSTED,LIMOGES,99923,99923,0,94681,94681,0,5.53649
29/01/2018 17:06,2016,1,WESTERN EUROPE-EU,FRANCE,1,STANSTED,LYON,493,0,493,584,0,584,-15.58219
29/01/2018 17:06,2016,1,WESTERN EUROPE-EU,FRANCE,1,STANSTED,MARSEILLE,141294,140727,567,140144,140144,0,0.82058
29/01/2018 17:06,2016,1,WESTERN EUROPE-EU,FRANCE,1,STANSTED,NICE,63775,62660,1115,65330,65206,124,-2.38022
29/01/2018 17:06,2016,1,WESTERN EUROPE-EU,FRANCE,1,STANSTED,PARIS (CHARLES DE GAULLE),0,0,0,252,0,252,-100
29/01/2018 17:06,2016,1,WESTERN EUROPE-EU,FRANCE,1,STANSTED,PARIS (ORLY),399,107,292,0,0,0,0
29/01/2018 17:06,2016,1,WESTERN EUROPE-EU,FRANCE,1,STANSTED,PAU,177,177,0,27,0,27,555.55556
29/01/2018 17:06,2016,1,WESTERN EUROPE-EU,FRANCE,1,STANSTED,PERPIGNAN,47176,47176,0,59463,59463,0,-20.66327
29/01/2018 17:06,2016,1,WESTERN EUROPE-EU,FRANCE,1,STANSTED,POITIERS,57904,57904,0,59550,59550,0,-2.76406
29/01/2018 17:06,2016,1,WESTERN EUROPE-EU,FRANCE,1,STANSTED,RENNES,819,517,302,0,0,0,0
29/01/2018 17:06,2016,1,WESTERN EUROPE-EU,FRANCE,1,STANSTED,RODEZ,0,0,0,26382,26382,0,-100
29/01/2018 17:06,2016,1,WESTERN EUROPE-EU,FRANCE,1,STANSTED,ST ETIENNE,542,542,0,0,0,0,0
29/01/2018 17:06,2016,1,WESTERN EUROPE-EU,FRANCE,1,STANSTED,STRASBOURG,0,0,0,42579,42579,0,-100
29/01/2018 17:06,2016,1,WESTERN EUROPE-EU,FRANCE,1,STANSTED,TARBES-LOURDES INTERNATIONAL,53985,47186,6799,42951,36811,6140,25.68974
29/01/2018 17:06,2016,1,WESTERN EUROPE-EU,FRANCE,1,STANSTED,TOULOUSE (BLAGNAC),17337,17337,0,0,0,0,0
29/01/2018 17:06,2016,1,WESTERN EUROPE-EU,FRANCE,1,STANSTED,TOURS,64257,64257,0,57072,57072,0,12.58936
29/01/2018 17:06,2016,1,WESTERN EUROPE-EU,FRANCE,2,ABERDEEN,PARIS (CHARLES DE GAULLE),99975,99975,0,110739,110739,0,-9.72015
29/01/2018 17:06,2016,1,WESTERN EUROPE-EU,FRANCE,2,BELFAST CITY (GEORGE BEST),CLERMONT FERRAND,293,0,293,0,0,0,0
29/01/2018 17:06,2016,1,WESTERN EUROPE-EU,FRANCE,2,BELFAST CITY (GEORGE BEST),LYON,184,0,184,0,0,0,0
29/01/2018 17:06,2016,1,WESTERN EUROPE-EU,FRANCE,2,BELFAST CITY (GEORGE BEST),LYON(BRON),69,0,69,0,0,0,0
29/01/2018 17:06,2016,1,WESTERN EUROPE-EU,FRANCE,2,BELFAST CITY (GEORGE BEST),PARIS (CHARLES DE GAULLE),174,174,0,0,0,0,0
29/01/2018 17:06,2016,1,WESTERN EUROPE-EU,FRANCE,2,BELFAST INTERNATIONAL,BORDEAUX,7359,7169,190,7299,7299,0,0.82203
29/01/2018 17:06,2016,1,WESTERN EUROPE-EU,FRANCE,2,BELFAST INTERNATIONAL,CLERMONT FERRAND,608,0,608,0,0,0,0
29/01/2018 17:06,2016,1,WESTERN EUROPE-EU,FRANCE,2,BELFAST INTERNATIONAL,LE TOUQUET,0,0,0,78,0,78,-100
29/01/2018 17:06,2016,1,WESTERN EUROPE-EU,FRANCE,2,BELFAST INTERNATIONAL,LYON,5432,3221,2211,619,450,169,777.54443
29/01/2018 17:06,2016,1,WESTERN EUROPE-EU,FRANCE,2,BELFAST INTERNATIONAL,NICE,19210,17652,1558,20081,20081,0,-4.33743
29/01/2018 17:06,2016,1,WESTERN EUROPE-EU,FRANCE,2,BELFAST INTERNATIONAL,PARIS (CHARLES DE GAULLE),76374,73385,2989,77969,77912,57,-2.04568
29/01/2018 17:06,2016,1,WESTERN EUROPE-EU,FRANCE,2,BELFAST INTERNATIONAL,PARIS (LE BOURGET),92,0,92,80,0,80,15
29/01/2018 17:06,2016,1,WESTERN EUROPE-EU,FRANCE,2,BELFAST INTERNATIONAL,TARBES-LOURDES INTERNATIONAL,6979,0,6979,6668,0,6668,4.66407
29/01/2018 17:06,2016,1,WESTERN EUROPE-EU,FRANCE,2,BELFAST INTERNATIONAL,TOULON / HYERES,0,0,0,347,0,347,-100
29/01/2018 17:06,2016,1,WESTERN EUROPE-EU,FRANCE,2,BELFAST INTERNATIONAL,TOULOUSE (BLAGNAC),0,0,0,2834,0,2834,-100
29/01/2018 17:06,2016,1,WESTERN EUROPE-EU,FRANCE,2,BIGGIN HILL,NICE,0,0,0,40,0,40,-100
29/01/2018 17:06,2016,1,WESTERN EUROPE-EU,FRANCE,2,BIRMINGHAM,AVIGNON,3197,3197,0,3087,3087,0,3.56333
29/01/2018 17:06,2016,1,WESTERN EUROPE-EU,FRANCE,2,BIRMINGHAM,BASTIA,1891,1891,0,2018,2018,0,-6.29336
29/01/2018 17:06,2016,1,WESTERN EUROPE-EU,FRANCE,2,BIRMINGHAM,BERGERAC,13526,13526,0,6914,6914,0,95.63205
29/01/2018 17:06,2016,1,WESTERN EUROPE-EU,FRANCE,2,BIRMINGHAM,BEZIERS,181,181,0,0,0,0,0
29/01/2018 17:06,2016,1,WESTERN EUROPE-EU,FRANCE,2,BIRMINGHAM,BIARRITZ,4591,4591,0,2181,2181,0,110.49977
29/01/2018 17:06,2016,1,WESTERN EUROPE-EU,FRANCE,2,BIRMINGHAM,BORDEAUX,21885,21885,0,15784,15634,150,38.65307
29/01/2018 17:06,2016,1,WESTERN EUROPE-EU,FRANCE,2,BIRMINGHAM,BREST,4267,4267,0,2520,2520,0,69.3254
29/01/2018 17:06,2016,1,WESTERN EUROPE-EU,FRANCE,2,BIRMINGHAM,BRIVE-LA-GAILLARDE,189,0,189,0,0,0,0
29/01/2018 17:06,2016,1,WESTERN EUROPE-EU,FRANCE,2,BIRMINGHAM,CHAMBERY,20399,3060,17339,16560,3339,13221,23.18237
29/01/2018 17:06,2016,1,WESTERN EUROPE-EU,FRANCE,2,BIRMINGHAM,DEAUVILLE,0,0,0,3094,3094,0,-100
29/01/2018 17:06,2016,1,WESTERN EUROPE-EU,FRANCE,2,BIRMINGHAM,GRENOBLE,18427,11912,6515,20236,14438,5798,-8.93951
29/01/2018 17:06,2016,1,WESTERN EUROPE-EU,FRANCE,2,BIRMINGHAM,LA ROCHELLE,8491,8160,331,4429,4273,156,91.71371
29/01/2018 17:06,2016,1,WESTERN EUROPE-EU,FRANCE,2,BIRMINGHAM,LE CASTELLET,0,0,0,36,0,36,-100
29/01/2018 17:06,2016,1,WESTERN EUROPE-EU,FRANCE,2,BIRMINGHAM,LILLE,77,77,0,0,0,0,0
29/01/2018 17:06,2016,1,WESTERN EUROPE-EU,FRANCE,2,BIRMINGHAM,LIMOGES,4953,4953,0,0,0,0,0
29/01/2018 17:06,2016,1,WESTERN EUROPE-EU,FRANCE,2,BIRMINGHAM,LYON,48528,48404,124,49043,48358,685,-1.0501
29/01/2018 17:06,2016,1,WESTERN EUROPE-EU,FRANCE,2,BIRMINGHAM,NANTES,14225,14225,0,25,0,25,56800
29/01/2018 17:06,2016,1,WESTERN EUROPE-EU,FRANCE,2,BIRMINGHAM,NICE,28923,28638,285,29954,29954,0,-3.44194
29/01/2018 17:06,2016,1,WESTERN EUROPE-EU,FRANCE,2,BIRMINGHAM,PARIS (CHARLES DE GAULLE),399613,399200,413,402975,402708,267,-0.83429
29/01/2018 17:06,2016,1,WESTERN EUROPE-EU,FRANCE,2,BIRMINGHAM,PARIS (LE BOURGET),45,0,45,0,0,0,0
29/01/2018 17:06,2016,1,WESTERN EUROPE-EU,FRANCE,2,BIRMINGHAM,PARIS (ORLY),75,75,0,0,0,0,0
29/01/2018 17:06,2016,1,WESTERN EUROPE-EU,FRANCE,2,BIRMINGHAM,PERPIGNAN,11292,11292,0,8254,8254,0,36.8064
29/01/2018 17:06,2016,1,WESTERN EUROPE-EU,FRANCE,2,BIRMINGHAM,RENNES,5591,5591,0,0,0,0,0
29/01/2018 17:06,2016,1,WESTERN EUROPE-EU,FRANCE,2,BIRMINGHAM,TARBES-LOURDES INTERNATIONAL,1359,0,1359,1542,0,1542,-11.8677
29/01/2018 17:06,2016,1,WESTERN EUROPE-EU,FRANCE,2,BIRMINGHAM,TOULON / HYERES,39,0,39,145,0,145,-73.10345
29/01/2018 17:06,2016,1,WESTERN EUROPE-EU,FRANCE,2,BIRMINGHAM,TOULOUSE (BLAGNAC),9073,5460,3613,11712,7952,3760,-22.53245
29/01/2018 17:06,2016,1,WESTERN EUROPE-EU,FRANCE,2,BOURNEMOUTH,ANGERS- MARCE,31,31,0,0,0,0,0
29/01/2018 17:06,2016,1,WESTERN EUROPE-EU,FRANCE,2,BOURNEMOUTH,BERGERAC,2,2,0,0,0,0,0
29/01/2018 17:06,2016,1,WESTERN EUROPE-EU,FRANCE,2,BOURNEMOUTH,BIARRITZ,0,0,0,2245,2245,0,-100
29/01/2018 17:06,2016,1,WESTERN EUROPE-EU,FRANCE,2,BOURNEMOUTH,BORDEAUX,2,2,0,0,0,0,0
29/01/2018 17:06,2016,1,WESTERN EUROPE-EU,FRANCE,2,BOURNEMOUTH,DEAUVILLE,0,0,0,2597,2597,0,-100
29/01/2018 17:06,2016,1,WESTERN EUROPE-EU,FRANCE,2,BOURNEMOUTH,NANTES,0,0,0,68,0,68,-100
29/01/2018 17:06,2016,1,WESTERN EUROPE-EU,FRANCE,2,BOURNEMOUTH,PARIS (CHARLES DE GAULLE),1906,1906,0,12988,12988,0,-85.32492
29/01/2018 17:06,2016,1,WESTERN EUROPE-EU,FRANCE,2,BOURNEMOUTH,TOULON / HYERES,0,0,0,9029,9029,0,-100
29/01/2018 17:06,2016,1,WESTERN EUROPE-EU,FRANCE,2,BRISTOL,BASTIA,1291,0,1291,1199,0,1199,7.67306
29/01/2018 17:06,2016,1,WESTERN EUROPE-EU,FRANCE,2,BRISTOL,BERGERAC,14162,14162,0,24649,24649,0,-42.54534
29/01/2018 17:06,2016,1,WESTERN EUROPE-EU,FRANCE,2,BRISTOL,BEZIERS,35660,35660,0,39059,39059,0,-8.70222
29/01/2018 17:06,2016,1,WESTERN EUROPE-EU,FRANCE,2,BRISTOL,BORDEAUX,38361,38261,100,35214,35214,0,8.93679
29/01/2018 17:06,2016,1,WESTERN EUROPE-EU,FRANCE,2,BRISTOL,CHAMBERY,12112,0,12112,12097,0,12097,0.124
29/01/2018 17:06,2016,1,WESTERN EUROPE-EU,FRANCE,2,BRISTOL,GRENOBLE,9686,9474,212,9059,9059,0,6.92129
29/01/2018 17:06,2016,1,WESTERN EUROPE-EU,FRANCE,2,BRISTOL,LA ROCHELLE,8522,8339,183,7635,7635,0,11.61755
29/01/2018 17:06,2016,1,WESTERN EUROPE-EU,FRANCE,2,BRISTOL,LIMOGES,23346,23346,0,21369,21369,0,9.25172
29/01/2018 17:06,2016,1,WESTERN EUROPE-EU,FRANCE,2,BRISTOL,LYON,5564,5346,218,5514,5337,177,0.90678
29/01/2018 17:06,2016,1,WESTERN EUROPE-EU,FRANCE,2,BRISTOL,MARSEILLE,13513,13513,0,10717,10717,0,26.08939
29/01/2018 17:06,2016,1,WESTERN EUROPE-EU,FRANCE,2,BRISTOL,NANTES,12667,12667,0,846,846,0,1397.28132
29/01/2018 17:06,2016,1,WESTERN EUROPE-EU,FRANCE,2,BRISTOL,NICE,83467,83440,27,72405,72377,28,15.27795
29/01/2018 17:06,2016,1,WESTERN EUROPE-EU,FRANCE,2,BRISTOL,PARIS (CHARLES DE GAULLE),138949,138849,100,131899,131047,852,5.345
29/01/2018 17:06,2016,1,WESTERN EUROPE-EU,FRANCE,2,BRISTOL,PAU,76,38,38,0,0,0,0
29/01/2018 17:06,2016,1,WESTERN EUROPE-EU,FRANCE,2,BRISTOL,TARBES-LOURDES INTERNATIONAL,347,0,347,495,0,495,-29.89899
29/01/2018 17:06,2016,1,WESTERN EUROPE-EU,FRANCE,2,BRISTOL,TOULON / HYERES,240,0,240,82,0,82,192.68293
29/01/2018 17:06,2016,1,WESTERN EUROPE-EU,FRANCE,2,BRISTOL,TOULOUSE (BLAGNAC),108424,89241,19183,110399,89763,20636,-1.78897
29/01/2018 17:06,2016,1,WESTERN EUROPE-EU,FRANCE,2,CARDIFF WALES,BORDEAUX,2385,420,1965,1849,0,1849,28.98864
29/01/2018 17:06,2016,1,WESTERN EUROPE-EU,FRANCE,2,CARDIFF WALES,BRIVE-LA-GAILLARDE,84,0,84,0,0,0,0
29/01/2018 17:06,2016,1,WESTERN EUROPE-EU,FRANCE,2,CARDIFF WALES,CHAMBERY,2485,2485,0,201,201,0,1136.31841
29/01/2018 17:06,2016,1,WESTERN EUROPE-EU,FRANCE,2,CARDIFF WALES,CLERMONT FERRAND,87,0,87,92,0,92,-5.43478
29/01/2018 17:06,2016,1,WESTERN EUROPE-EU,FRANCE,2,CARDIFF WALES,DINARD,60,0,60,0,0,0,0
29/01/2018 17:06,2016,1,WESTERN EUROPE-EU,FRANCE,2,CARDIFF WALES,GRENOBLE,424,0,424,181,0,181,134.25414
29/01/2018 17:06,2016,1,WESTERN EUROPE-EU,FRANCE,2,CARDIFF WALES,LILLE,704,0,704,0,0,0,0
29/01/2018 17:06,2016,1,WESTERN EUROPE-EU,FRANCE,2,CARDIFF WALES,LYON,2945,179,2766,2002,0,2002,47.1029
29/01/2018 17:06,2016,1,WESTERN EUROPE-EU,FRANCE,2,CARDIFF WALES,MARSEILLE,377,0,377,642,0,642,-41.27726
29/01/2018 17:06,2016,1,WESTERN EUROPE-EU,FRANCE,2,CARDIFF WALES,MONTPELLIER,169,0,169,242,0,242,-30.16529
29/01/2018 17:06,2016,1,WESTERN EUROPE-EU,FRANCE,2,CARDIFF WALES,NANTES,118,0,118,45,0,45,162.22222
29/01/2018 17:06,2016,1,WESTERN EUROPE-EU,FRANCE,2,CARDIFF WALES,NICE,172,172,0,0,0,0,0
29/01/2018 17:06,2016,1,WESTERN EUROPE-EU,FRANCE,2,CARDIFF WALES,PARIS (CHARLES DE GAULLE),54104,52823,1281,30442,27628,2814,77.72814
29/01/2018 17:06,2016,1,WESTERN EUROPE-EU,FRANCE,2,CARDIFF WALES,PARIS (LE BOURGET),142,0,142,126,0,126,12.69841
29/01/2018 17:06,2016,1,WESTERN EUROPE-EU,FRANCE,2,CARDIFF WALES,PARIS (ORLY),515,229,286,13153,10759,2394,-96.08454
29/01/2018 17:06,2016,1,WESTERN EUROPE-EU,FRANCE,2,CARDIFF WALES,PAU,71,0,71,78,0,78,-8.97436
29/01/2018 17:06,2016,1,WESTERN EUROPE-EU,FRANCE,2,CARDIFF WALES,RENNES,68,0,68,0,0,0,0
29/01/2018 17:06,2016,1,WESTERN EUROPE-EU,FRANCE,2,CARDIFF WALES,TARBES-LOURDES INTERNATIONAL,699,0,699,323,0,323,116.40867
29/01/2018 17:06,2016,1,WESTERN EUROPE-EU,FRANCE,2,CARDIFF WALES,TOULON / HYERES,319,0,319,178,0,178,79.21348
29/01/2018 17:06,2016,1,WESTERN EUROPE-EU,FRANCE,2,CARDIFF WALES,TOULOUSE (BLAGNAC),1397,224,1173,2059,0,2059,-32.15153
29/01/2018 17:06,2016,1,WESTERN EUROPE-EU,FRANCE,2,DONCASTER SHEFFIELD,CHAMBERY,60,60,0,0,0,0,0
29/01/2018 17:06,2016,1,WESTERN EUROPE-EU,FRANCE,2,DONCASTER SHEFFIELD,PARIS (CHARLES DE GAULLE),48431,48431,0,0,0,0,0
29/01/2018 17:06,2016,1,WESTERN EUROPE-EU,FRANCE,2,DONCASTER SHEFFIELD,TARBES-LOURDES INTERNATIONAL,535,0,535,470,0,470,13.82979
29/01/2018 17:06,2016,1,WESTERN EUROPE-EU,FRANCE,2,DURHAM TEES VALLEY,BIARRITZ,44,0,44,0,0,0,0
29/01/2018 17:06,2016,1,WESTERN EUROPE-EU,FRANCE,2,DURHAM TEES VALLEY,TARBES-LOURDES INTERNATIONAL,684,0,684,601,0,601,13.81032
29/01/2018 17:06,2016,1,WESTERN EUROPE-EU,FRANCE,2,EAST MIDLANDS INTERNATIONAL,BEAUVAIS,178,178,0,0,0,0,0
29/01/2018 17:06,2016,1,WESTERN EUROPE-EU,FRANCE,2,EAST MIDLANDS INTERNATIONAL,BERGERAC,19284,19284,0,20722,20722,0,-6.93948
29/01/2018 17:06,2016,1,WESTERN EUROPE-EU,FRANCE,2,EAST MIDLANDS INTERNATIONAL,BORDEAUX,0,0,0,121,0,121,-100
29/01/2018 17:06,2016,1,WESTERN EUROPE-EU,FRANCE,2,EAST MIDLANDS INTERNATIONAL,CARCASSONNE,31812,31812,0,30736,30736,0,3.50078
29/01/2018 17:06,2016,1,WESTERN EUROPE-EU,FRANCE,2,EAST MIDLANDS INTERNATIONAL,CHAMBERY,12420,7057,5363,13087,7368,5719,-5.09666
29/01/2018 17:06,2016,1,WESTERN EUROPE-EU,FRANCE,2,EAST MIDLANDS INTERNATIONAL,DINARD,31943,31943,0,31931,31931,0,0.03758
29/01/2018 17:06,2016,1,WESTERN EUROPE-EU,FRANCE,2,EAST MIDLANDS INTERNATIONAL,LA ROCHELLE,0,0,0,8619,8619,0,-100
29/01/2018 17:06,2016,1,WESTERN EUROPE-EU,FRANCE,2,EAST MIDLANDS INTERNATIONAL,LIMOGES,48615,48615,0,49216,49216,0,-1.22115
29/01/2018 17:06,2016,1,WESTERN EUROPE-EU,FRANCE,2,EAST MIDLANDS INTERNATIONAL,LYON,45,0,45,103,0,103,-56.31068
29/01/2018 17:06,2016,1,WESTERN EUROPE-EU,FRANCE,2,EAST MIDLANDS INTERNATIONAL,MARSEILLE,0,0,0,85,0,85,-100
29/01/2018 17:06,2016,1,WESTERN EUROPE-EU,FRANCE,2,EAST MIDLANDS INTERNATIONAL,NANTES,128,0,128,152,0,152,-15.78947
29/01/2018 17:06,2016,1,WESTERN EUROPE-EU,FRANCE,2,EAST MIDLANDS INTERNATIONAL,PARIS (CHARLES DE GAULLE),1225,237,988,589,0,589,107.97963
29/01/2018 17:06,2016,1,WESTERN EUROPE-EU,FRANCE,2,EAST MIDLANDS INTERNATIONAL,PARIS (ORLY),104,0,104,0,0,0,0
29/01/2018 17:06,2016,1,WESTERN EUROPE-EU,FRANCE,2,EAST MIDLANDS INTERNATIONAL,RENNES,119,119,0,0,0,0,0
29/01/2018 17:06,2016,1,WESTERN EUROPE-EU,FRANCE,2,EAST MIDLANDS INTERNATIONAL,TARBES-LOURDES INTERNATIONAL,497,159,338,281,0,281,76.86833
29/01/2018 17:06,2016,1,WESTERN EUROPE-EU,FRANCE,2,EDINBURGH,BASTIA,115,0,115,0,0,0,0
29/01/2018 17:06,2016,1,WESTERN EUROPE-EU,FRANCE,2,EDINBURGH,BERGERAC,2563,2563,0,2104,2104,0,21.81559
29/01/2018 17:06,2016,1,WESTERN EUROPE-EU,FRANCE,2,EDINBURGH,BEZIERS,21391,21391,0,21424,21424,0,-0.15403
29/01/2018 17:06,2016,1,WESTERN EUROPE-EU,FRANCE,2,EDINBURGH,BORDEAUX,40886,40593,293,33250,33121,129,22.96541
29/01/2018 17:06,2016,1,WESTERN EUROPE-EU,FRANCE,2,EDINBURGH,CHAMBERY,7232,3646,3586,6874,4033,2841,5.20803
29/01/2018 17:06,2016,1,WESTERN EUROPE-EU,FRANCE,2,EDINBURGH,CLERMONT FERRAND,0,0,0,92,0,92,-100
29/01/2018 17:06,2016,1,WESTERN EUROPE-EU,FRANCE,2,EDINBURGH,GRENOBLE,5324,5324,0,4841,4659,182,9.97728
29/01/2018 17:06,2016,1,WESTERN EUROPE-EU,FRANCE,2,EDINBURGH,LYON,26290,24782,1508,19533,19533,0,34.59274
29/01/2018 17:06,2016,1,WESTERN EUROPE-EU,FRANCE,2,EDINBURGH,MARSEILLE,23416,23087,329,22338,22338,0,4.82586
29/01/2018 17:06,2016,1,WESTERN EUROPE-EU,FRANCE,2,EDINBURGH,METZ,30,0,30,0,0,0,0
29/01/2018 17:06,2016,1,WESTERN EUROPE-EU,FRANCE,2,EDINBURGH,NANTES,621,0,621,0,0,0,0
29/01/2018 17:06,2016,1,WESTERN EUROPE-EU,FRANCE,2,EDINBURGH,NICE,49302,49302,0,51057,51057,0,-3.43733
29/01/2018 17:06,2016,1,WESTERN EUROPE-EU,FRANCE,2,EDINBURGH,PARIS (CHARLES DE GAULLE),308612,305771,2841,300611,299293,1318,2.66158
29/01/2018 17:06,2016,1,WESTERN EUROPE-EU,FRANCE,2,EDINBURGH,PARIS (ORLY),69239,68853,386,0,0,0,0
29/01/2018 17:06,2016,1,WESTERN EUROPE-EU,FRANCE,2,EDINBURGH,POITIERS,7892,7892,0,6113,6113,0,29.10191
29/01/2018 17:06,2016,1,WESTERN EUROPE-EU,FRANCE,2,EDINBURGH,TARBES-LOURDES INTERNATIONAL,1382,0,1382,1101,0,1101,25.52225
29/01/2018 17:06,2016,1,WESTERN EUROPE-EU,FRANCE,2,EDINBURGH,TOULOUSE (BLAGNAC),3046,0,3046,1539,0,1539,97.92073
29/01/2018 17:06,2016,1,WESTERN EUROPE-EU,FRANCE,2,EXETER,BERGERAC,2945,2945,0,2532,2532,0,16.31122
29/01/2018 17:06,2016,1,WESTERN EUROPE-EU,FRANCE,2,EXETER,BORDEAUX,92,0,92,80,0,80,15
29/01/2018 17:06,2016,1,WESTERN EUROPE-EU,FRANCE,2,EXETER,CHAMBERY,2095,2095,0,2131,2131,0,-1.68935
29/01/2018 17:06,2016,1,WESTERN EUROPE-EU,FRANCE,2,EXETER,CLERMONT FERRAND,0,0,0,314,0,314,-100
29/01/2018 17:06,2016,1,WESTERN EUROPE-EU,FRANCE,2,EXETER,DEAUVILLE,0,0,0,1831,1831,0,-100
29/01/2018 17:06,2016,1,WESTERN EUROPE-EU,FRANCE,2,EXETER,PARIS (CHARLES DE GAULLE),40381,40381,0,43063,43063,0,-6.22808
29/01/2018 17:06,2016,1,WESTERN EUROPE-EU,FRANCE,2,EXETER,RENNES,1330,1330,0,829,829,0,60.43426
29/01/2018 17:06,2016,1,WESTERN EUROPE-EU,FRANCE,2,EXETER,TARBES-LOURDES INTERNATIONAL,136,0,136,288,0,288,-52.77778
29/01/2018 17:06,2016,1,WESTERN EUROPE-EU,FRANCE,2,EXETER,TOULOUSE (BLAGNAC),43,43,0,0,0,0,0
29/01/2018 17:06,2016,1,WESTERN EUROPE-EU,FRANCE,2,GLASGOW,BORDEAUX,5456,5456,0,5265,5265,0,3.62773
29/01/2018 17:06,2016,1,WESTERN EUROPE-EU,FRANCE,2,GLASGOW,CARCASSONNE,20412,20412,0,19404,19404,0,5.19481
29/01/2018 17:06,2016,1,WESTERN EUROPE-EU,FRANCE,2,GLASGOW,CHAMBERY,5918,0,5918,6197,0,6197,-4.50218
29/01/2018 17:06,2016,1,WESTERN EUROPE-EU,FRANCE,2,GLASGOW,GRENOBLE,224,224,0,0,0,0,0
29/01/2018 17:06,2016,1,WESTERN EUROPE-EU,FRANCE,2,GLASGOW,LYON,530,0,530,0,0,0,0
29/01/2018 17:06,2016,1,WESTERN EUROPE-EU,FRANCE,2,GLASGOW,LYON(BRON),0,0,0,18,0,18,-100
29/01/2018 17:06,2016,1,WESTERN EUROPE-EU,FRANCE,2,GLASGOW,MARSEILLE,7568,7529,39,0,0,0,0
29/01/2018 17:06,2016,1,WESTERN EUROPE-EU,FRANCE,2,GLASGOW,METZ,122,0,122,0,0,0,0
29/01/2018 17:06,2016,1,WESTERN EUROPE-EU,FRANCE,2,GLASGOW,MONTPELLIER,0,0,0,72,0,72,-100
29/01/2018 17:06,2016,1,WESTERN EUROPE-EU,FRANCE,2,GLASGOW,NICE,186,0,186,345,0,345,-46.08696
29/01/2018 17:06,2016,1,WESTERN EUROPE-EU,FRANCE,2,GLASGOW,PARIS (CHARLES DE GAULLE),152404,152404,0,110833,110722,111,37.50778
29/01/2018 17:06,2016,1,WESTERN EUROPE-EU,FRANCE,2,GLASGOW,PARIS (LE BOURGET),131,0,131,35,0,35,274.28571
29/01/2018 17:06,2016,1,WESTERN EUROPE-EU,FRANCE,2,GLASGOW,RENNES,0,0,0,35,0,35,-100
29/01/2018 17:06,2016,1,WESTERN EUROPE-EU,FRANCE,2,GLASGOW,TARBES-LOURDES INTERNATIONAL,1304,0,1304,1657,0,1657,-21.30356
29/01/2018 17:06,2016,1,WESTERN EUROPE-EU,FRANCE,2,GUERNSEY,DINARD,2814,2814,0,2698,2698,0,4.29948
29/01/2018 17:06,2016,1,WESTERN EUROPE-EU,FRANCE,2,GUERNSEY,GRENOBLE,927,798,129,822,822,0,12.77372
29/01/2018 17:06,2016,1,WESTERN EUROPE-EU,FRANCE,2,HUMBERSIDE,ANGERS- MARCE,38,0,38,0,0,0,0
29/01/2018 17:06,2016,1,WESTERN EUROPE-EU,FRANCE,2,HUMBERSIDE,NICE,330,0,330,324,0,324,1.85185
29/01/2018 17:06,2016,1,WESTERN EUROPE-EU,FRANCE,2,HUMBERSIDE,PARIS (CHARLES DE GAULLE),0,0,0,44,0,44,-100
29/01/2018 17:06,2016,1,WESTERN EUROPE-EU,FRANCE,2,HUMBERSIDE,PERPIGNAN,455,44,411,0,0,0,0
29/01/2018 17:06,2016,1,WESTERN EUROPE-EU,FRANCE,2,ISLE OF MAN,RENNES,0,0,0,238,0,238,-100
29/01/2018 17:06,2016,1,WESTERN EUROPE-EU,FRANCE,2,JERSEY,BREST,146,146,0,0,0,0,0
29/01/2018 17:06,2016,1,WESTERN EUROPE-EU,FRANCE,2,JERSEY,CHAMBERY,0,0,0,390,390,0,-100
29/01/2018 17:06,2016,1,WESTERN EUROPE-EU,FRANCE,2,JERSEY,PARIS (CHARLES DE GAULLE),0,0,0,421,130,291,-100
29/01/2018 17:06,2016,1,WESTERN EUROPE-EU,FRANCE,2,LEEDS BRADFORD,AVIGNON,71,0,71,0,0,0,0
29/01/2018 17:06,2016,1,WESTERN EUROPE-EU,FRANCE,2,LEEDS BRADFORD,BERGERAC,4486,4486,0,4680,4680,0,-4.1453
29/01/2018 17:06,2016,1,WESTERN EUROPE-EU,FRANCE,2,LEEDS BRADFORD,BORDEAUX,125,125,0,0,0,0,0
29/01/2018 17:06,2016,1,WESTERN EUROPE-EU,FRANCE,2,LEEDS BRADFORD,CHAMBERY,6259,6259,0,6857,6857,0,-8.72102
29/01/2018 17:06,2016,1,WESTERN EUROPE-EU,FRANCE,2,LEEDS BRADFORD,DINARD,0,0,0,7850,7850,0,-100
29/01/2018 17:06,2016,1,WESTERN EUROPE-EU,FRANCE,2,LEEDS BRADFORD,GRENOBLE,92,92,0,774,774,0,-88.1137
29/01/2018 17:06,2016,1,WESTERN EUROPE-EU,FRANCE,2,LEEDS BRADFORD,LIMOGES,19663,19663,0,24624,24624,0,-20.14701
29/01/2018 17:06,2016,1,WESTERN EUROPE-EU,FRANCE,2,LEEDS BRADFORD,LYON,0,0,0,465,0,465,-100
29/01/2018 17:06,2016,1,WESTERN EUROPE-EU,FRANCE,2,LEEDS BRADFORD,MONTPELLIER,11609,11609,0,11635,11635,0,-0.22346
29/01/2018 17:06,2016,1,WESTERN EUROPE-EU,FRANCE,2,LEEDS BRADFORD,NICE,16471,16471,0,17713,17713,0,-7.0118
29/01/2018 17:06,2016,1,WESTERN EUROPE-EU,FRANCE,2,LEEDS BRADFORD,PARIS (CHARLES DE GAULLE),46604,46604,0,49110,49110,0,-5.10283
29/01/2018 17:06,2016,1,WESTERN EUROPE-EU,FRANCE,2,LEEDS BRADFORD,PARIS (LE BOURGET),0,0,0,12,0,12,-100
29/01/2018 17:06,2016,1,WESTERN EUROPE-EU,FRANCE,2,LEEDS BRADFORD,PERPIGNAN,1003,0,1003,912,0,912,9.97807
29/01/2018 17:06,2016,1,WESTERN EUROPE-EU,FRANCE,2,LEEDS BRADFORD,TARBES-LOURDES INTERNATIONAL,324,0,324,321,0,321,0.93458
29/01/2018 17:06,2016,1,WESTERN EUROPE-EU,FRANCE,2,LIVERPOOL (JOHN LENNON),BERGERAC,32994,32994,0,22762,22762,0,44.95211
29/01/2018 17:06,2016,1,WESTERN EUROPE-EU,FRANCE,2,LIVERPOOL (JOHN LENNON),BORDEAUX,15819,15819,0,15710,14980,730,0.69383
29/01/2018 17:06,2016,1,WESTERN EUROPE-EU,FRANCE,2,LIVERPOOL (JOHN LENNON),CARCASSONNE,8118,8118,0,37082,37082,0,-78.10798
29/01/2018 17:06,2016,1,WESTERN EUROPE-EU,FRANCE,2,LIVERPOOL (JOHN LENNON),CHATEAUDUN,124,124,0,0,0,0,0
29/01/2018 17:06,2016,1,WESTERN EUROPE-EU,FRANCE,2,LIVERPOOL (JOHN LENNON),GRENOBLE,4001,4001,0,3547,3547,0,12.79955
29/01/2018 17:06,2016,1,WESTERN EUROPE-EU,FRANCE,2,LIVERPOOL (JOHN LENNON),LIMOGES,8182,8182,0,47380,47380,0,-82.73111
29/01/2018 17:06,2016,1,WESTERN EUROPE-EU,FRANCE,2,LIVERPOOL (JOHN LENNON),NANTES,4885,4885,0,5568,5568,0,-12.26652
29/01/2018 17:06,2016,1,WESTERN EUROPE-EU,FRANCE,2,LIVERPOOL (JOHN LENNON),NICE,90352,90352,0,86440,86440,0,4.52568
29/01/2018 17:06,2016,1,WESTERN EUROPE-EU,FRANCE,2,LIVERPOOL (JOHN LENNON),NIMES,13104,13104,0,11686,11686,0,12.13418
29/01/2018 17:06,2016,1,WESTERN EUROPE-EU,FRANCE,2,LIVERPOOL (JOHN LENNON),PARIS (CHARLES DE GAULLE),81396,81396,0,88943,88818,125,-8.48521
29/01/2018 17:06,2016,1,WESTERN EUROPE-EU,FRANCE,2,LIVERPOOL (JOHN LENNON),PERPIGNAN,126,0,126,273,0,273,-53.84615
29/01/2018 17:06,2016,1,WESTERN EUROPE-EU,FRANCE,2,LIVERPOOL (JOHN LENNON),STRASBOURG,358,0,358,0,0,0,0
29/01/2018 17:06,2016,1,WESTERN EUROPE-EU,FRANCE,2,LIVERPOOL (JOHN LENNON),TARBES-LOURDES INTERNATIONAL,1020,0,1020,1479,0,1479,-31.03448
29/01/2018 17:06,2016,1,WESTERN EUROPE-EU,FRANCE,2,LYDD,CHAMBERY,31,0,31,24,0,24,29.16667
29/01/2018 17:06,2016,1,WESTERN EUROPE-EU,FRANCE,2,MANCHESTER,BASTIA,4466,4466,0,3893,3893,0,14.71873
29/01/2018 17:06,2016,1,WESTERN EUROPE-EU,FRANCE,2,MANCHESTER,BEAUVAIS,41991,41991,0,30858,30858,0,36.07816
29/01/2018 17:06,2016,1,WESTERN EUROPE-EU,FRANCE,2,MANCHESTER,BERGERAC,4775,4775,0,1341,1341,0,256.07755
29/01/2018 17:06,2016,1,WESTERN EUROPE-EU,FRANCE,2,MANCHESTER,BEZIERS,21723,21723,0,22566,22566,0,-3.73571
29/01/2018 17:06,2016,1,WESTERN EUROPE-EU,FRANCE,2,MANCHESTER,BIARRITZ,43,0,43,0,0,0,0
29/01/2018 17:06,2016,1,WESTERN EUROPE-EU,FRANCE,2,MANCHESTER,CALVI,2977,0,2977,2764,0,2764,7.70622
29/01/2018 17:06,2016,1,WESTERN EUROPE-EU,FRANCE,2,MANCHESTER,CARCASSONNE,31545,31545,0,0,0,0,0
29/01/2018 17:06,2016,1,WESTERN EUROPE-EU,FRANCE,2,MANCHESTER,CHAMBERY,25972,14001,11971,26725,15198,11527,-2.81759
29/01/2018 17:06,2016,1,WESTERN EUROPE-EU,FRANCE,2,MANCHESTER,CLERMONT FERRAND,0,0,0,80,0,80,-100
29/01/2018 17:06,2016,1,WESTERN EUROPE-EU,FRANCE,2,MANCHESTER,GRENOBLE,35782,30636,5146,39933,15381,24552,-10.39491
29/01/2018 17:06,2016,1,WESTERN EUROPE-EU,FRANCE,2,MANCHESTER,LA ROCHELLE,3312,3312,0,3249,3249,0,1.93906
29/01/2018 17:06,2016,1,WESTERN EUROPE-EU,FRANCE,2,MANCHESTER,LILLE,65,65,0,0,0,0,0
29/01/2018 17:06,2016,1,WESTERN EUROPE-EU,FRANCE,2,MANCHESTER,LIMOGES,37938,37938,0,0,0,0,0
29/01/2018 17:06,2016,1,WESTERN EUROPE-EU,FRANCE,2,MANCHESTER,LYON,35257,34461,796,13745,8175,5570,156.50782
29/01/2018 17:06,2016,1,WESTERN EUROPE-EU,FRANCE,2,MANCHESTER,MARSEILLE,26559,26212,347,14731,14731,0,80.29326
29/01/2018 17:06,2016,1,WESTERN EUROPE-EU,FRANCE,2,MANCHESTER,MONTPELLIER,200,0,200,0,0,0,0
29/01/2018 17:06,2016,1,WESTERN EUROPE-EU,FRANCE,2,MANCHESTER,NANTES,18652,18652,0,17772,17692,80,4.95161
29/01/2018 17:06,2016,1,WESTERN EUROPE-EU,FRANCE,2,MANCHESTER,NICE,41483,40799,684,40105,39602,503,3.43598
29/01/2018 17:06,2016,1,WESTERN EUROPE-EU,FRANCE,2,MANCHESTER,PARIS (CHARLES DE GAULLE),567409,565460,1949,477743,477306,437,18.76867
29/01/2018 17:06,2016,1,WESTERN EUROPE-EU,FRANCE,2,MANCHESTER,PARIS (LE BOURGET),64,0,64,0,0,0,0
29/01/2018 17:06,2016,1,WESTERN EUROPE-EU,FRANCE,2,MANCHESTER,PARIS (ORLY),522,522,0,0,0,0,0
29/01/2018 17:06,2016,1,WESTERN EUROPE-EU,FRANCE,2,MANCHESTER,PAU,78,0,78,80,0,80,-2.5
29/01/2018 17:06,2016,1,WESTERN EUROPE-EU,FRANCE,2,MANCHESTER,PERPIGNAN,972,0,972,979,0,979,-0.71502
29/01/2018 17:06,2016,1,WESTERN EUROPE-EU,FRANCE,2,MANCHESTER,RENNES,3231,3231,0,2258,2258,0,43.09123
29/01/2018 17:06,2016,1,WESTERN EUROPE-EU,FRANCE,2,MANCHESTER,TARBES-LOURDES INTERNATIONAL,3897,0,3897,3105,0,3105,25.50725
29/01/2018 17:06,2016,1,WESTERN EUROPE-EU,FRANCE,2,MANCHESTER,TOULOUSE (BLAGNAC),22613,17325,5288,16981,11478,5503,33.16648
29/01/2018 17:06,2016,1,WESTERN EUROPE-EU,FRANCE,2,NEWCASTLE,BRIVE-LA-GAILLARDE,80,0,80,73,0,73,9.58904
29/01/2018 17:06,2016,1,WESTERN EUROPE-EU,FRANCE,2,NEWCASTLE,CHAMBERY,3767,3767,0,4294,4294,0,-12.27294
29/01/2018 17:06,2016,1,WESTERN EUROPE-EU,FRANCE,2,NEWCASTLE,GRENOBLE,160,160,0,0,0,0,0
29/01/2018 17:06,2016,1,WESTERN EUROPE-EU,FRANCE,2,NEWCASTLE,LILLE,39,0,39,0,0,0,0
29/01/2018 17:06,2016,1,WESTERN EUROPE-EU,FRANCE,2,NEWCASTLE,LYON,39,0,39,0,0,0,0
29/01/2018 17:06,2016,1,WESTERN EUROPE-EU,FRANCE,2,NEWCASTLE,NICE,21387,21387,0,21112,21102,10,1.30258
29/01/2018 17:06,2016,1,WESTERN EUROPE-EU,FRANCE,2,NEWCASTLE,PARIS (CHARLES DE GAULLE),148784,148784,0,153870,153815,55,-3.30539
29/01/2018 17:06,2016,1,WESTERN EUROPE-EU,FRANCE,2,NEWCASTLE,PERPIGNAN,185,0,185,71,0,71,160.56338
29/01/2018 17:06,2016,1,WESTERN EUROPE-EU,FRANCE,2,NEWCASTLE,TARBES-LOURDES INTERNATIONAL,1102,0,1102,860,0,860,28.13953
29/01/2018 17:06,2016,1,WESTERN EUROPE-EU,FRANCE,2,NEWCASTLE,TOULOUSE (BLAGNAC),148,0,148,0,0,0,0
29/01/2018 17:06,2016,1,WESTERN EUROPE-EU,FRANCE,2,NEWQUAY,CHAMBERY,4,4,0,0,0,0,0
29/01/2018 17:06,2016,1,WESTERN EUROPE-EU,FRANCE,2,NEWQUAY,TOULON / HYERES,0,0,0,97,0,97,-100
29/01/2018 17:06,2016,1,WESTERN EUROPE-EU,FRANCE,2,NORWICH,CHAMBERY,151,151,0,0,0,0,0
29/01/2018 17:06,2016,1,WESTERN EUROPE-EU,FRANCE,2,NORWICH,NANTES,0,0,0,60,0,60,-100
29/01/2018 17:06,2016,1,WESTERN EUROPE-EU,FRANCE,2,PRESTWICK,PARIS (CHARLES DE GAULLE),46,4,42,0,0,0,0
29/01/2018 17:06,2016,1,WESTERN EUROPE-EU,FRANCE,2,PRESTWICK,PARIS (LE BOURGET),41,0,41,0,0,0,0
29/01/2018 17:06,2016,1,WESTERN EUROPE-EU,FRANCE,2,PRESTWICK,TARBES-LOURDES INTERNATIONAL,0,0,0,221,0,221,-100
29/01/2018 17:06,2016,1,WESTERN EUROPE-EU,FRANCE,2,SOUTHAMPTON,AVIGNON,4566,4566,0,4149,4149,0,10.05061
29/01/2018 17:06,2016,1,WESTERN EUROPE-EU,FRANCE,2,SOUTHAMPTON,BASTIA,2310,2310,0,5089,5089,0,-54.60798
29/01/2018 17:06,2016,1,WESTERN EUROPE-EU,FRANCE,2,SOUTHAMPTON,BERGERAC,36257,36257,0,33283,33283,0,8.93549
29/01/2018 17:06,2016,1,WESTERN EUROPE-EU,FRANCE,2,SOUTHAMPTON,BIARRITZ,3868,3868,0,0,0,0,0
29/01/2018 17:06,2016,1,WESTERN EUROPE-EU,FRANCE,2,SOUTHAMPTON,BORDEAUX,4724,4724,0,1962,1962,0,140.77472
29/01/2018 17:06,2016,1,WESTERN EUROPE-EU,FRANCE,2,SOUTHAMPTON,BREST,4372,4372,0,3308,3308,0,32.16445
29/01/2018 17:06,2016,1,WESTERN EUROPE-EU,FRANCE,2,SOUTHAMPTON,CHAMBERY,9509,5353,4156,6604,5908,696,43.98849
29/01/2018 17:06,2016,1,WESTERN EUROPE-EU,FRANCE,2,SOUTHAMPTON,GRENOBLE,0,0,0,1637,1637,0,-100
29/01/2018 17:06,2016,1,WESTERN EUROPE-EU,FRANCE,2,SOUTHAMPTON,LA ROCHELLE,16678,16678,0,14213,14213,0,17.34328
29/01/2018 17:06,2016,1,WESTERN EUROPE-EU,FRANCE,2,SOUTHAMPTON,LIMOGES,14183,14183,0,19308,19308,0,-26.5434
29/01/2018 17:06,2016,1,WESTERN EUROPE-EU,FRANCE,2,SOUTHAMPTON,LYON,11374,11374,0,0,0,0,0
29/01/2018 17:06,2016,1,WESTERN EUROPE-EU,FRANCE,2,SOUTHAMPTON,NANTES,25297,24871,426,20517,20517,0,23.29775
29/01/2018 17:06,2016,1,WESTERN EUROPE-EU,FRANCE,2,SOUTHAMPTON,PARIS (CHARLES DE GAULLE),25389,25389,0,0,0,0,0
29/01/2018 17:06,2016,1,WESTERN EUROPE-EU,FRANCE,2,SOUTHAMPTON,PARIS (LE BOURGET),35,0,35,0,0,0,0
29/01/2018 17:06,2016,1,WESTERN EUROPE-EU,FRANCE,2,SOUTHAMPTON,PARIS (ORLY),64961,64961,0,70028,70028,0,-7.23568
29/01/2018 17:06,2016,1,WESTERN EUROPE-EU,FRANCE,2,SOUTHAMPTON,PERPIGNAN,2808,2808,0,2395,2395,0,17.24426
29/01/2018 17:06,2016,1,WESTERN EUROPE-EU,FRANCE,2,SOUTHAMPTON,RENNES,19044,19044,0,18073,18073,0,5.37266
29/01/2018 17:06,2016,1,WESTERN EUROPE-EU,FRANCE,2,SOUTHAMPTON,TARBES-LOURDES INTERNATIONAL,645,0,645,813,0,813,-20.66421
29/01/2018 17:06,2016,1,WESTERN EUROPE-EU,FRANCE,2,SOUTHAMPTON,TOULON / HYERES,4527,4527,0,0,0,0,0
29/01/2018 17:06,2016,1,WESTERN EUROPE-EU,FRANCE,2,WICK JOHN O GROATS,PARIS (CHARLES DE GAULLE),0,0,0,120,0,120,-100
29/01/2018 17:06,2016,1,WESTERN EUROPE-EU,GERMANY,1,GATWICK,BERLIN (SCHONEFELD),592605,591843,762,548993,547556,1437,7.944
29/01/2018 17:06,2016,1,WESTERN EUROPE-EU,GERMANY,1,GATWICK,BERLIN (TEGEL),0,0,0,213,0,213,-100
29/01/2018 17:06,2016,1,WESTERN EUROPE-EU,GERMANY,1,GATWICK,BREMEN,10,0,10,0,0,0,0
29/01/2018 17:06,2016,1,WESTERN EUROPE-EU,GERMANY,1,GATWICK,COLOGNE BONN,11625,11313,312,103592,103570,22,-88.77809
29/01/2018 17:06,2016,1,WESTERN EUROPE-EU,GERMANY,1,GATWICK,DUSSELDORF,14202,14077,125,93910,93910,0,-84.87701
29/01/2018 17:06,2016,1,WESTERN EUROPE-EU,GERMANY,1,GATWICK,ERFURT,0,0,0,9308,9308,0,-100
29/01/2018 17:06,2016,1,WESTERN EUROPE-EU,GERMANY,1,GATWICK,FRANKFURT MAIN,36,36,0,0,0,0,0
29/01/2018 17:06,2016,1,WESTERN EUROPE-EU,GERMANY,1,GATWICK,FRIEDRICHSHAFEN,25219,13344,11875,19294,12270,7024,30.70903
29/01/2018 17:06,2016,1,WESTERN EUROPE-EU,GERMANY,1,GATWICK,HAMBURG,157823,157823,0,174641,174641,0,-9.63004
29/01/2018 17:06,2016,1,WESTERN EUROPE-EU,GERMANY,1,GATWICK,LEIPZIG,0,0,0,133,0,133,-100
29/01/2018 17:06,2016,1,WESTERN EUROPE-EU,GERMANY,1,GATWICK,MUNICH,236275,236272,3,231744,231532,212,1.95517
29/01/2018 17:06,2016,1,WESTERN EUROPE-EU,GERMANY,1,GATWICK,STUTTGART,131095,131094,1,103540,103540,0,26.6129
29/01/2018 17:06,2016,1,WESTERN EUROPE-EU,GERMANY,1,HEATHROW,BERLIN (TEGEL),811434,811434,0,822496,822496,0,-1.34493
29/01/2018 17:06,2016,1,WESTERN EUROPE-EU,GERMANY,1,HEATHROW,COLOGNE BONN,178918,178918,0,168657,168657,0,6.08395
29/01/2018 17:06,2016,1,WESTERN EUROPE-EU,GERMANY,1,HEATHROW,DORTMUND,117,117,0,0,0,0,0
29/01/2018 17:06,2016,1,WESTERN EUROPE-EU,GERMANY,1,HEATHROW,DUSSELDORF,718470,718470,0,663142,663142,0,8.34331
29/01/2018 17:06,2016,1,WESTERN EUROPE-EU,GERMANY,1,HEATHROW,FRANKFURT MAIN,1493204,1493204,0,1530986,1530986,0,-2.46782
29/01/2018 17:06,2016,1,WESTERN EUROPE-EU,GERMANY,1,HEATHROW,FRIEDRICHSHAFEN,665,0,665,797,0,797,-16.56211
29/01/2018 17:06,2016,1,WESTERN EUROPE-EU,GERMANY,1,HEATHROW,HAMBURG,577265,577265,0,577653,577653,0,-0.06717
29/01/2018 17:06,2016,1,WESTERN EUROPE-EU,GERMANY,1,HEATHROW,HANOVER,202112,202112,0,199781,199781,0,1.16678
29/01/2018 17:06,2016,1,WESTERN EUROPE-EU,GERMANY,1,HEATHROW,MUNICH,1215546,1215546,0,1230618,1230618,0,-1.22475
29/01/2018 17:06,2016,1,WESTERN EUROPE-EU,GERMANY,1,HEATHROW,STUTTGART,315768,315768,0,333656,333656,0,-5.36121
29/01/2018 17:06,2016,1,WESTERN EUROPE-EU,GERMANY,1,LONDON CITY,BERLIN (TEGEL),54729,54729,0,0,0,0,0
29/01/2018 17:06,2016,1,WESTERN EUROPE-EU,GERMANY,1,LONDON CITY,BREMEN,1720,1720,0,0,0,0,0
29/01/2018 17:06,2016,1,WESTERN EUROPE-EU,GERMANY,1,LONDON CITY,DRESDEN,0,0,0,14097,14097,0,-100
29/01/2018 17:06,2016,1,WESTERN EUROPE-EU,GERMANY,1,LONDON CITY,DUSSELDORF,74580,74580,0,59830,59830,0,24.65318
29/01/2018 17:06,2016,1,WESTERN EUROPE-EU,GERMANY,1,LONDON CITY,FRANKFURT MAIN,241084,241084,0,240973,240973,0,0.04606
29/01/2018 17:06,2016,1,WESTERN EUROPE-EU,GERMANY,1,LONDON CITY,HAMBURG,35378,35378,0,12425,12425,0,184.73239
29/01/2018 17:06,2016,1,WESTERN EUROPE-EU,GERMANY,1,LONDON CITY,HANOVER,19,0,19,0,0,0,0
29/01/2018 17:06,2016,1,WESTERN EUROPE-EU,GERMANY,1,LONDON CITY,STUTTGART,144,0,144,0,0,0,0
29/01/2018 17:06,2016,1,WESTERN EUROPE-EU,GERMANY,1,LUTON,BERLIN (SCHONEFELD),174320,174228,92,182834,182458,376,-4.65668
29/01/2018 17:06,2016,1,WESTERN EUROPE-EU,GERMANY,1,LUTON,BERLIN (TEGEL),114,114,0,149,0,149,-23.48993
29/01/2018 17:06,2016,1,WESTERN EUROPE-EU,GERMANY,1,LUTON,COLOGNE BONN,710,154,556,447,0,447,58.83669
29/01/2018 17:06,2016,1,WESTERN EUROPE-EU,GERMANY,1,LUTON,DORTMUND,90149,90149,0,108709,108709,0,-17.0731
29/01/2018 17:06,2016,1,WESTERN EUROPE-EU,GERMANY,1,LUTON,DUSSELDORF,5,0,5,0,0,0,0
29/01/2018 17:06,2016,1,WESTERN EUROPE-EU,GERMANY,1,LUTON,ERFURT,1,0,1,0,0,0,0
29/01/2018 17:06,2016,1,WESTERN EUROPE-EU,GERMANY,1,LUTON,FRANKFURT MAIN,10,0,10,42,0,42,-76.19048
29/01/2018 17:06,2016,1,WESTERN EUROPE-EU,GERMANY,1,LUTON,FRIEDRICHSHAFEN,8,0,8,157,0,157,-94.90446
29/01/2018 17:06,2016,1,WESTERN EUROPE-EU,GERMANY,1,LUTON,HAHN,50,0,50,0,0,0,0
29/01/2018 17:06,2016,1,WESTERN EUROPE-EU,GERMANY,1,LUTON,HAMBURG,89949,89949,0,84039,84003,36,7.03245
29/01/2018 17:06,2016,1,WESTERN EUROPE-EU,GERMANY,1,LUTON,HANOVER,76,0,76,452,0,452,-83.18584
29/01/2018 17:06,2016,1,WESTERN EUROPE-EU,GERMANY,1,LUTON,INGOLSTADT-MANCHING,0,0,0,41,0,41,-100
29/01/2018 17:06,2016,1,WESTERN EUROPE-EU,GERMANY,1,LUTON,KARLSRUHE/BADEN BADEN,0,0,0,3,0,3,-100
29/01/2018 17:06,2016,1,WESTERN EUROPE-EU,GERMANY,1,LUTON,KASSEL,2,0,2,0,0,0,0
29/01/2018 17:06,2016,1,WESTERN EUROPE-EU,GERMANY,1,LUTON,MAGDEBURG COCHSTEDT,0,0,0,11,0,11,-100
29/01/2018 17:06,2016,1,WESTERN EUROPE-EU,GERMANY,1,LUTON,MUNICH,74486,74481,5,61626,61162,464,20.86782
29/01/2018 17:06,2016,1,WESTERN EUROPE-EU,GERMANY,1,LUTON,MUNSTER-OSNABRUCK,0,0,0,90,0,90,-100
29/01/2018 17:06,2016,1,WESTERN EUROPE-EU,GERMANY,1,LUTON,NUREMBERG,10,0,10,24,0,24,-58.33333
29/01/2018 17:06,2016,1,WESTERN EUROPE-EU,GERMANY,1,LUTON,PADERBORN,0,0,0,102,0,102,-100
29/01/2018 17:06,2016,1,WESTERN EUROPE-EU,GERMANY,1,LUTON,STUTTGART,49,0,49,0,0,0,0
29/01/2018 17:06,2016,1,WESTERN EUROPE-EU,GERMANY,1,SOUTHEND,BERLIN (SCHONEFELD),4824,4824,0,54904,54904,0,-91.21375
29/01/2018 17:06,2016,1,WESTERN EUROPE-EU,GERMANY,1,SOUTHEND,BERLIN (TEGEL),57,57,0,0,0,0,0
29/01/2018 17:06,2016,1,WESTERN EUROPE-EU,GERMANY,1,SOUTHEND,DUSSELDORF,225,225,0,0,0,0,0
29/01/2018 17:06,2016,1,WESTERN EUROPE-EU,GERMANY,1,SOUTHEND,FRANKFURT MAIN,197,197,0,0,0,0,0
29/01/2018 17:06,2016,1,WESTERN EUROPE-EU,GERMANY,1,SOUTHEND,MUNSTER-OSNABRUCK,178,178,0,13761,13761,0,-98.70649
29/01/2018 17:06,2016,1,WESTERN EUROPE-EU,GERMANY,1,STANSTED,BERLIN (SCHONEFELD),456246,456246,0,331488,331488,0,37.63575
29/01/2018 17:06,2016,1,WESTERN EUROPE-EU,GERMANY,1,STANSTED,BERLIN (TEGEL),4032,3704,328,94,0,94,4189.3617
29/01/2018 17:06,2016,1,WESTERN EUROPE-EU,GERMANY,1,STANSTED,BREMEN,193273,193273,0,195930,195854,76,-1.3561
29/01/2018 17:06,2016,1,WESTERN EUROPE-EU,GERMANY,1,STANSTED,COLOGNE BONN,451630,449918,1712,389788,389788,0,15.86555
29/01/2018 17:06,2016,1,WESTERN EUROPE-EU,GERMANY,1,STANSTED,DORTMUND,118353,118353,0,109469,109469,0,8.11554
29/01/2018 17:06,2016,1,WESTERN EUROPE-EU,GERMANY,1,STANSTED,DUSSELDORF,0,0,0,35518,35239,279,-100
29/01/2018 17:06,2016,1,WESTERN EUROPE-EU,GERMANY,1,STANSTED,FRANKFURT MAIN,361,0,361,0,0,0,0
29/01/2018 17:06,2016,1,WESTERN EUROPE-EU,GERMANY,1,STANSTED,FRIEDRICHSHAFEN,187,187,0,0,0,0,0
29/01/2018 17:06,2016,1,WESTERN EUROPE-EU,GERMANY,1,STANSTED,HAHN,218822,218822,0,237194,237194,0,-7.74556
29/01/2018 17:06,2016,1,WESTERN EUROPE-EU,GERMANY,1,STANSTED,HAMBURG,36675,36675,0,97,0,97,37709.27835
29/01/2018 17:06,2016,1,WESTERN EUROPE-EU,GERMANY,1,STANSTED,HANOVER,66158,65596,562,77445,77445,0,-14.57421
29/01/2018 17:06,2016,1,WESTERN EUROPE-EU,GERMANY,1,STANSTED,KARLSRUHE/BADEN BADEN,111953,111953,0,105207,105207,0,6.41212
29/01/2018 17:06,2016,1,WESTERN EUROPE-EU,GERMANY,1,STANSTED,LEIPZIG,49310,49310,0,59259,59259,0,-16.78901
29/01/2018 17:06,2016,1,WESTERN EUROPE-EU,GERMANY,1,STANSTED,MEMMINGEN ALLGAU,99577,99577,0,103681,103681,0,-3.9583
29/01/2018 17:06,2016,1,WESTERN EUROPE-EU,GERMANY,1,STANSTED,MUNICH,109047,108035,1012,107084,105417,1667,1.83314
29/01/2018 17:06,2016,1,WESTERN EUROPE-EU,GERMANY,1,STANSTED,MUNSTER-OSNABRUCK,0,0,0,89,0,89,-100
29/01/2018 17:06,2016,1,WESTERN EUROPE-EU,GERMANY,1,STANSTED,NIEDERRHEIN,95800,95800,0,125665,125665,0,-23.76557
29/01/2018 17:06,2016,1,WESTERN EUROPE-EU,GERMANY,1,STANSTED,NUREMBERG,137742,137742,0,121858,121858,0,13.03484
29/01/2018 17:06,2016,1,WESTERN EUROPE-EU,GERMANY,1,STANSTED,STUTTGART,74721,74721,0,69423,69382,41,7.63148
29/01/2018 17:06,2016,1,WESTERN EUROPE-EU,GERMANY,2,ABERDEEN,DRESDEN,0,0,0,41,0,41,-100
29/01/2018 17:06,2016,1,WESTERN EUROPE-EU,GERMANY,2,ABERDEEN,DUSSELDORF,0,0,0,95,0,95,-100
29/01/2018 17:06,2016,1,WESTERN EUROPE-EU,GERMANY,2,ABERDEEN,FRANKFURT MAIN,127324,127324,0,151684,151684,0,-16.0597
29/01/2018 17:06,2016,1,WESTERN EUROPE-EU,GERMANY,2,ABERDEEN,FRIEDRICHSHAFEN,252,0,252,0,0,0,0
29/01/2018 17:06,2016,1,WESTERN EUROPE-EU,GERMANY,2,ABERDEEN,STUTTGART,0,0,0,1,0,1,-100
29/01/2018 17:06,2016,1,WESTERN EUROPE-EU,GERMANY,2,BELFAST INTERNATIONAL,BERLIN (SCHONEFELD),15209,15209,0,0,0,0,0
29/01/2018 17:06,2016,1,WESTERN EUROPE-EU,GERMANY,2,BELFAST INTERNATIONAL,DUSSELDORF,98,0,98,0,0,0,0
29/01/2018 17:06,2016,1,WESTERN EUROPE-EU,GERMANY,2,BELFAST INTERNATIONAL,HAMBURG,0,0,0,272,0,272,-100
29/01/2018 17:06,2016,1,WESTERN EUROPE-EU,GERMANY,2,BELFAST INTERNATIONAL,HANOVER,393,0,393,0,0,0,0
29/01/2018 17:06,2016,1,WESTERN EUROPE-EU,GERMANY,2,BIRMINGHAM,BERLIN (SCHONEFELD),355,175,180,0,0,0,0
29/01/2018 17:06,2016,1,WESTERN EUROPE-EU,GERMANY,2,BIRMINGHAM,BERLIN (TEGEL),69468,69468,0,49077,49077,0,41.54899
29/01/2018 17:06,2016,1,WESTERN EUROPE-EU,GERMANY,2,BIRMINGHAM,BRAUNSCHWEIG,0,0,0,11,0,11,-100
29/01/2018 17:06,2016,1,WESTERN EUROPE-EU,GERMANY,2,BIRMINGHAM,COLOGNE BONN,0,0,0,7250,6863,387,-100
29/01/2018 17:06,2016,1,WESTERN EUROPE-EU,GERMANY,2,BIRMINGHAM,DUSSELDORF,241690,241567,123,219051,218964,87,10.33504
29/01/2018 17:06,2016,1,WESTERN EUROPE-EU,GERMANY,2,BIRMINGHAM,FRANKFURT MAIN,310788,310788,0,314685,314509,176,-1.23838
29/01/2018 17:06,2016,1,WESTERN EUROPE-EU,GERMANY,2,BIRMINGHAM,HAHN,228,0,228,0,0,0,0
29/01/2018 17:06,2016,1,WESTERN EUROPE-EU,GERMANY,2,BIRMINGHAM,HAMBURG,30764,30764,0,38017,38017,0,-19.07831
29/01/2018 17:06,2016,1,WESTERN EUROPE-EU,GERMANY,2,BIRMINGHAM,HANOVER,48856,48856,0,56850,47182,9668,-14.06157
29/01/2018 17:06,2016,1,WESTERN EUROPE-EU,GERMANY,2,BIRMINGHAM,LEIPZIG,0,0,0,124,0,124,-100
29/01/2018 17:06,2016,1,WESTERN EUROPE-EU,GERMANY,2,BIRMINGHAM,MEMMINGEN ALLGAU,0,0,0,86,0,86,-100
29/01/2018 17:06,2016,1,WESTERN EUROPE-EU,GERMANY,2,BIRMINGHAM,MUNICH,196363,195409,954,185185,183658,1527,6.03613
29/01/2018 17:06,2016,1,WESTERN EUROPE-EU,GERMANY,2,BIRMINGHAM,MUNSTER-OSNABRUCK,151,0,151,0,0,0,0
29/01/2018 17:06,2016,1,WESTERN EUROPE-EU,GERMANY,2,BIRMINGHAM,NUREMBERG,0,0,0,49,0,49,-100
29/01/2018 17:06,2016,1,WESTERN EUROPE-EU,GERMANY,2,BIRMINGHAM,PADERBORN,11859,4652,7207,10849,0,10849,9.30961
29/01/2018 17:06,2016,1,WESTERN EUROPE-EU,GERMANY,2,BIRMINGHAM,STUTTGART,80254,80254,0,70567,70480,87,13.72738
29/01/2018 17:06,2016,1,WESTERN EUROPE-EU,GERMANY,2,BOURNEMOUTH,COLOGNE BONN,56,56,0,0,0,0,0
29/01/2018 17:06,2016,1,WESTERN EUROPE-EU,GERMANY,2,BOURNEMOUTH,DUSSELDORF,21,21,0,0,0,0,0
29/01/2018 17:06,2016,1,WESTERN EUROPE-EU,GERMANY,2,BOURNEMOUTH,LUBECK,0,0,0,41,0,41,-100
29/01/2018 17:06,2016,1,WESTERN EUROPE-EU,GERMANY,2,BOURNEMOUTH,MANNHEIM,0,0,0,64,0,64,-100
29/01/2018 17:06,2016,1,WESTERN EUROPE-EU,GERMANY,2,BRISTOL,BERLIN (SCHONEFELD),82579,82579,0,83224,83224,0,-0.77502
29/01/2018 17:06,2016,1,WESTERN EUROPE-EU,GERMANY,2,BRISTOL,COLOGNE BONN,186,0,186,151,0,151,23.17881
29/01/2018 17:06,2016,1,WESTERN EUROPE-EU,GERMANY,2,BRISTOL,DUSSELDORF,14741,14741,0,8355,8355,0,76.43327
29/01/2018 17:06,2016,1,WESTERN EUROPE-EU,GERMANY,2,BRISTOL,FRANKFURT MAIN,43344,43344,0,44026,44026,0,-1.54908
29/01/2018 17:06,2016,1,WESTERN EUROPE-EU,GERMANY,2,BRISTOL,HAMBURG,13707,13707,0,16128,16128,0,-15.01116
29/01/2018 17:06,2016,1,WESTERN EUROPE-EU,GERMANY,2,BRISTOL,HANOVER,23,0,23,0,0,0,0
29/01/2018 17:06,2016,1,WESTERN EUROPE-EU,GERMANY,2,BRISTOL,MUNICH,36372,36124,248,30567,29938,629,18.99107
29/01/2018 17:06,2016,1,WESTERN EUROPE-EU,GERMANY,2,CARDIFF WALES,BERLIN (TEGEL),3110,3110,0,0,0,0,0
29/01/2018 17:06,2016,1,WESTERN EUROPE-EU,GERMANY,2,CARDIFF WALES,DUSSELDORF,3633,3633,0,6123,6123,0,-40.66634
29/01/2018 17:06,2016,1,WESTERN EUROPE-EU,GERMANY,2,CARDIFF WALES,HANOVER,0,0,0,46,0,46,-100
29/01/2018 17:06,2016,1,WESTERN EUROPE-EU,GERMANY,2,CARDIFF WALES,LAHR,0,0,0,93,0,93,-100
29/01/2018 17:06,2016,1,WESTERN EUROPE-EU,GERMANY,2,CARDIFF WALES,MUNICH,18674,18674,0,7531,7453,78,147.96176
29/01/2018 17:06,2016,1,WESTERN EUROPE-EU,GERMANY,2,DONCASTER SHEFFIELD,BERLIN (TEGEL),19755,19755,0,0,0,0,0
29/01/2018 17:06,2016,1,WESTERN EUROPE-EU,GERMANY,2,DONCASTER SHEFFIELD,DUSSELDORF,2821,2821,0,0,0,0,0
29/01/2018 17:06,2016,1,WESTERN EUROPE-EU,GERMANY,2,DONCASTER SHEFFIELD,HAHN,0,0,0,66,0,66,-100
29/01/2018 17:06,2016,1,WESTERN EUROPE-EU,GERMANY,2,DURHAM TEES VALLEY,COLOGNE BONN,0,0,0,8,0,8,-100
29/01/2018 17:06,2016,1,WESTERN EUROPE-EU,GERMANY,2,DURHAM TEES VALLEY,DUSSELDORF,0,0,0,40,0,40,-100
29/01/2018 17:06,2016,1,WESTERN EUROPE-EU,GERMANY,2,DURHAM TEES VALLEY,FRIEDRICHSHAFEN,241,0,241,0,0,0,0
29/01/2018 17:06,2016,1,WESTERN EUROPE-EU,GERMANY,2,DURHAM TEES VALLEY,GEILENKIRCHEN,9,0,9,0,0,0,0
29/01/2018 17:06,2016,1,WESTERN EUROPE-EU,GERMANY,2,DURHAM TEES VALLEY,PADERBORN,0,0,0,48,0,48,-100
29/01/2018 17:06,2016,1,WESTERN EUROPE-EU,GERMANY,2,EAST MIDLANDS INTERNATIONAL,BADEN BADEN,82,0,82,0,0,0,0
29/01/2018 17:06,2016,1,WESTERN EUROPE-EU,GERMANY,2,EAST MIDLANDS INTERNATIONAL,BERLIN (SCHONEFELD),51152,51152,0,51043,51043,0,0.21355
29/01/2018 17:06,2016,1,WESTERN EUROPE-EU,GERMANY,2,EAST MIDLANDS INTERNATIONAL,DUSSELDORF,13083,13083,0,0,0,0,0
29/01/2018 17:06,2016,1,WESTERN EUROPE-EU,GERMANY,2,EAST MIDLANDS INTERNATIONAL,GEILENKIRCHEN,0,0,0,38,0,38,-100
29/01/2018 17:06,2016,1,WESTERN EUROPE-EU,GERMANY,2,EAST MIDLANDS INTERNATIONAL,HANOVER,92,92,0,0,0,0,0
29/01/2018 17:06,2016,1,WESTERN EUROPE-EU,GERMANY,2,EDINBURGH,BERLIN (SCHONEFELD),68704,68704,0,51636,51636,0,33.05446
29/01/2018 17:06,2016,1,WESTERN EUROPE-EU,GERMANY,2,EDINBURGH,BREMEN,29314,29314,0,29356,29356,0,-0.14307
29/01/2018 17:06,2016,1,WESTERN EUROPE-EU,GERMANY,2,EDINBURGH,COLOGNE BONN,51351,51351,0,50874,50874,0,0.93761
29/01/2018 17:06,2016,1,WESTERN EUROPE-EU,GERMANY,2,EDINBURGH,DUSSELDORF,20123,20123,0,0,0,0,0
29/01/2018 17:06,2016,1,WESTERN EUROPE-EU,GERMANY,2,EDINBURGH,FRANKFURT MAIN,197174,197174,0,192077,192077,0,2.65362
29/01/2018 17:06,2016,1,WESTERN EUROPE-EU,GERMANY,2,EDINBURGH,FRIEDRICHSHAFEN,55,0,55,0,0,0,0
29/01/2018 17:06,2016,1,WESTERN EUROPE-EU,GERMANY,2,EDINBURGH,HAHN,38492,38492,0,36232,36232,0,6.23758
29/01/2018 17:06,2016,1,WESTERN EUROPE-EU,GERMANY,2,EDINBURGH,HAMBURG,61194,61090,104,59204,59204,0,3.36126
29/01/2018 17:06,2016,1,WESTERN EUROPE-EU,GERMANY,2,EDINBURGH,LEIPZIG,111,0,111,0,0,0,0
29/01/2018 17:06,2016,1,WESTERN EUROPE-EU,GERMANY,2,EDINBURGH,MUNICH,99972,99972,0,95437,95147,290,4.75183
29/01/2018 17:06,2016,1,WESTERN EUROPE-EU,GERMANY,2,EDINBURGH,MUNSTER-OSNABRUCK,85,0,85,0,0,0,0
29/01/2018 17:06,2016,1,WESTERN EUROPE-EU,GERMANY,2,EDINBURGH,NIEDERRHEIN,55678,55678,0,50930,50930,0,9.3226
29/01/2018 17:06,2016,1,WESTERN EUROPE-EU,GERMANY,2,EDINBURGH,STUTTGART,47630,47598,32,6945,6945,0,585.81713
29/01/2018 17:06,2016,1,WESTERN EUROPE-EU,GERMANY,2,EXETER,DUSSELDORF,51,51,0,0,0,0,0
29/01/2018 17:06,2016,1,WESTERN EUROPE-EU,GERMANY,2,EXETER,FRANKFURT MAIN,28,28,0,0,0,0,0
29/01/2018 17:06,2016,1,WESTERN EUROPE-EU,GERMANY,2,EXETER,FRIEDRICHSHAFEN,214,0,214,138,0,138,55.07246
29/01/2018 17:06,2016,1,WESTERN EUROPE-EU,GERMANY,2,GLASGOW,BERLIN (SCHONEFELD),168558,168558,0,88061,88061,0,91.4105
29/01/2018 17:06,2016,1,WESTERN EUROPE-EU,GERMANY,2,GLASGOW,BRAUNSCHWEIG,84,0,84,34,0,34,147.05882
29/01/2018 17:06,2016,1,WESTERN EUROPE-EU,GERMANY,2,GLASGOW,BUCHEL,0,0,0,33,0,33,-100
29/01/2018 17:06,2016,1,WESTERN EUROPE-EU,GERMANY,2,GLASGOW,COLOGNE BONN,672,0,672,168,0,168,300
29/01/2018 17:06,2016,1,WESTERN EUROPE-EU,GERMANY,2,GLASGOW,DUSSELDORF,37338,36757,581,34987,34987,0,6.71964
29/01/2018 17:06,2016,1,WESTERN EUROPE-EU,GERMANY,2,GLASGOW,ERFURT,161,0,161,0,0,0,0
29/01/2018 17:06,2016,1,WESTERN EUROPE-EU,GERMANY,2,GLASGOW,FRANKFURT MAIN,0,0,0,476,158,318,-100
29/01/2018 17:06,2016,1,WESTERN EUROPE-EU,GERMANY,2,GLASGOW,FRIEDRICHSHAFEN,118,0,118,0,0,0,0
29/01/2018 17:06,2016,1,WESTERN EUROPE-EU,GERMANY,2,GLASGOW,MEMMINGEN ALLGAU,0,0,0,35,0,35,-100
29/01/2018 17:06,2016,1,WESTERN EUROPE-EU,GERMANY,2,GLASGOW,MUNICH,4395,4395,0,4320,4320,0,1.73611
29/01/2018 17:06,2016,1,WESTERN EUROPE-EU,GERMANY,2,GLASGOW,NIEDERRHEIN,284,0,284,0,0,0,0
29/01/2018 17:06,2016,1,WESTERN EUROPE-EU,GERMANY,2,GUERNSEY,DUSSELDORF,2858,2858,0,2463,2463,0,16.03735
29/01/2018 17:06,2016,1,WESTERN EUROPE-EU,GERMANY,2,GUERNSEY,STUTTGART,1818,1818,0,1894,1894,0,-4.01267
29/01/2018 17:06,2016,1,WESTERN EUROPE-EU,GERMANY,2,HUMBERSIDE,FRIEDRICHSHAFEN,210,0,210,136,0,136,54.41176
29/01/2018 17:06,2016,1,WESTERN EUROPE-EU,GERMANY,2,HUMBERSIDE,HAMBURG,54,0,54,0,0,0,0
29/01/2018 17:06,2016,1,WESTERN EUROPE-EU,GERMANY,2,ISLE OF MAN,BREMEN,0,0,0,280,0,280,-100
29/01/2018 17:06,2016,1,WESTERN EUROPE-EU,GERMANY,2,ISLE OF MAN,FRIEDRICHSHAFEN,0,0,0,70,0,70,-100
29/01/2018 17:06,2016,1,WESTERN EUROPE-EU,GERMANY,2,JERSEY,BERLIN (TEGEL),1630,1630,0,0,0,0,0
29/01/2018 17:06,2016,1,WESTERN EUROPE-EU,GERMANY,2,JERSEY,BREMEN,264,264,0,288,0,288,-8.33333
29/01/2018 17:06,2016,1,WESTERN EUROPE-EU,GERMANY,2,JERSEY,DRESDEN,290,290,0,286,0,286,1.3986
29/01/2018 17:06,2016,1,WESTERN EUROPE-EU,GERMANY,2,JERSEY,DUSSELDORF,8819,8819,0,6751,6751,0,30.6325
29/01/2018 17:06,2016,1,WESTERN EUROPE-EU,GERMANY,2,JERSEY,ERFURT,274,274,0,392,0,392,-30.10204
29/01/2018 17:06,2016,1,WESTERN EUROPE-EU,GERMANY,2,JERSEY,FRANKFURT MAIN,0,0,0,51,0,51,-100
29/01/2018 17:06,2016,1,WESTERN EUROPE-EU,GERMANY,2,JERSEY,FRIEDRICHSHAFEN,372,221,151,472,0,472,-21.18644
29/01/2018 17:06,2016,1,WESTERN EUROPE-EU,GERMANY,2,JERSEY,HANOVER,2210,2210,0,2537,2537,0,-12.88924
29/01/2018 17:06,2016,1,WESTERN EUROPE-EU,GERMANY,2,JERSEY,KARLSRUHE/BADEN BADEN,254,254,0,148,0,148,71.62162
29/01/2018 17:06,2016,1,WESTERN EUROPE-EU,GERMANY,2,JERSEY,KOBLENZ,0,0,0,2684,868,1816,-100
29/01/2018 17:06,2016,1,WESTERN EUROPE-EU,GERMANY,2,JERSEY,LUBECK,284,284,0,0,0,0,0
29/01/2018 17:06,2016,1,WESTERN EUROPE-EU,GERMANY,2,JERSEY,MUNICH,2884,2884,0,2551,2551,0,13.0537
29/01/2018 17:06,2016,1,WESTERN EUROPE-EU,GERMANY,2,JERSEY,PADERBORN,0,0,0,404,0,404,-100
29/01/2018 17:06,2016,1,WESTERN EUROPE-EU,GERMANY,2,JERSEY,STUTTGART,2580,2580,0,2602,2380,222,-0.8455
29/01/2018 17:06,2016,1,WESTERN EUROPE-EU,GERMANY,2,LEEDS BRADFORD,BERLIN (SCHONEFELD),2456,2456,0,285,0,285,761.75439
29/01/2018 17:06,2016,1,WESTERN EUROPE-EU,GERMANY,2,LEEDS BRADFORD,COLOGNE BONN,289,289,0,44,44,0,556.81818
29/01/2018 17:06,2016,1,WESTERN EUROPE-EU,GERMANY,2,LEEDS BRADFORD,DUSSELDORF,49150,49150,0,50664,50506,158,-2.98832
29/01/2018 17:06,2016,1,WESTERN EUROPE-EU,GERMANY,2,LEEDS BRADFORD,FRIEDRICHSHAFEN,210,0,210,424,0,424,-50.4717
29/01/2018 17:06,2016,1,WESTERN EUROPE-EU,GERMANY,2,LEEDS BRADFORD,MUNICH,270,270,0,0,0,0,0
29/01/2018 17:06,2016,1,WESTERN EUROPE-EU,GERMANY,2,LEEDS BRADFORD,MUNSTER-OSNABRUCK,0,0,0,117,117,0,-100
29/01/2018 17:06,2016,1,WESTERN EUROPE-EU,GERMANY,2,LIVERPOOL (JOHN LENNON),BERLIN (SCHONEFELD),70562,70562,0,75544,75544,0,-6.59483
29/01/2018 17:06,2016,1,WESTERN EUROPE-EU,GERMANY,2,LIVERPOOL (JOHN LENNON),DORTMUND,1463,0,1463,0,0,0,0
29/01/2018 17:06,2016,1,WESTERN EUROPE-EU,GERMANY,2,LIVERPOOL (JOHN LENNON),DRESDEN,122,0,122,0,0,0,0
29/01/2018 17:06,2016,1,WESTERN EUROPE-EU,GERMANY,2,LIVERPOOL (JOHN LENNON),FRANKFURT MAIN,41,0,41,0,0,0,0
29/01/2018 17:06,2016,1,WESTERN EUROPE-EU,GERMANY,2,LIVERPOOL (JOHN LENNON),MUNICH,759,0,759,0,0,0,0
29/01/2018 17:06,2016,1,WESTERN EUROPE-EU,GERMANY,2,LYDD,BREMEN,0,0,0,196,0,196,-100
29/01/2018 17:06,2016,1,WESTERN EUROPE-EU,GERMANY,2,LYDD,HAMBURG,0,0,0,73,0,73,-100
29/01/2018 17:06,2016,1,WESTERN EUROPE-EU,GERMANY,2,MANCHESTER,BERLIN (SCHONEFELD),181456,181361,95,96317,96317,0,88.39457
29/01/2018 17:06,2016,1,WESTERN EUROPE-EU,GERMANY,2,MANCHESTER,BERLIN (TEGEL),62,62,0,0,0,0,0
29/01/2018 17:06,2016,1,WESTERN EUROPE-EU,GERMANY,2,MANCHESTER,BRAUNSCHWEIG,0,0,0,601,0,601,-100
29/01/2018 17:06,2016,1,WESTERN EUROPE-EU,GERMANY,2,MANCHESTER,BREMEN,27485,27485,0,15366,15366,0,78.86893
29/01/2018 17:06,2016,1,WESTERN EUROPE-EU,GERMANY,2,MANCHESTER,COLOGNE BONN,51609,49660,1949,55570,55084,486,-7.12795
29/01/2018 17:06,2016,1,WESTERN EUROPE-EU,GERMANY,2,MANCHESTER,DUSSELDORF,209525,209119,406,182794,181385,1409,14.62357
29/01/2018 17:06,2016,1,WESTERN EUROPE-EU,GERMANY,2,MANCHESTER,FRANKFURT MAIN,386522,386223,299,390202,390017,185,-0.9431
29/01/2018 17:06,2016,1,WESTERN EUROPE-EU,GERMANY,2,MANCHESTER,FRIEDRICHSHAFEN,0,0,0,1978,1978,0,-100
29/01/2018 17:06,2016,1,WESTERN EUROPE-EU,GERMANY,2,MANCHESTER,HAMBURG,154769,154544,225,136140,136140,0,13.68371
29/01/2018 17:06,2016,1,WESTERN EUROPE-EU,GERMANY,2,MANCHESTER,HANOVER,54532,54091,441,46763,44856,1907,16.61356
29/01/2018 17:06,2016,1,WESTERN EUROPE-EU,GERMANY,2,MANCHESTER,MAGDEBURG COCHSTEDT,0,0,0,86,0,86,-100
29/01/2018 17:06,2016,1,WESTERN EUROPE-EU,GERMANY,2,MANCHESTER,MUNICH,342496,341791,705,324630,323083,1547,5.5035
29/01/2018 17:06,2016,1,WESTERN EUROPE-EU,GERMANY,2,MANCHESTER,NUREMBERG,18437,17893,544,0,0,0,0
29/01/2018 17:06,2016,1,WESTERN EUROPE-EU,GERMANY,2,MANCHESTER,STUTTGART,99795,99598,197,76452,76452,0,30.53288
29/01/2018 17:06,2016,1,WESTERN EUROPE-EU,GERMANY,2,NEWCASTLE,BERLIN (SCHONEFELD),6986,6986,0,267,0,267,2516.4794
29/01/2018 17:06,2016,1,WESTERN EUROPE-EU,GERMANY,2,NEWCASTLE,DUSSELDORF,41630,41630,0,39232,39155,77,6.11236
29/01/2018 17:06,2016,1,WESTERN EUROPE-EU,GERMANY,2,NEWCASTLE,FRIEDRICHSHAFEN,36,0,36,0,0,0,0
29/01/2018 17:06,2016,1,WESTERN EUROPE-EU,GERMANY,2,NEWCASTLE,HAMBURG,330,0,330,0,0,0,0
29/01/2018 17:06,2016,1,WESTERN EUROPE-EU,GERMANY,2,NEWCASTLE,HANOVER,0,0,0,72,0,72,-100
29/01/2018 17:06,2016,1,WESTERN EUROPE-EU,GERMANY,2,NEWCASTLE,MUNICH,289,289,0,0,0,0,0
29/01/2018 17:06,2016,1,WESTERN EUROPE-EU,GERMANY,2,NEWCASTLE,STUTTGART,104,0,104,0,0,0,0
29/01/2018 17:06,2016,1,WESTERN EUROPE-EU,GERMANY,2,NEWQUAY,COLOGNE BONN,105,0,105,0,0,0,0
29/01/2018 17:06,2016,1,WESTERN EUROPE-EU,GERMANY,2,NEWQUAY,DUSSELDORF,3704,3704,0,2643,2643,0,40.14378
29/01/2018 17:06,2016,1,WESTERN EUROPE-EU,GERMANY,2,NEWQUAY,FRANKFURT MAIN,94,0,94,0,0,0,0
29/01/2018 17:06,2016,1,WESTERN EUROPE-EU,GERMANY,2,NEWQUAY,HAHN,16933,16933,0,0,0,0,0
29/01/2018 17:06,2016,1,WESTERN EUROPE-EU,GERMANY,2,NORWICH,BREMEN,0,0,0,31,0,31,-100
29/01/2018 17:06,2016,1,WESTERN EUROPE-EU,GERMANY,2,NORWICH,FRIEDRICHSHAFEN,0,0,0,280,0,280,-100
29/01/2018 17:06,2016,1,WESTERN EUROPE-EU,GERMANY,2,OXFORD (KIDLINGTON),COLOGNE BONN,76,76,0,0,0,0,0
29/01/2018 17:06,2016,1,WESTERN EUROPE-EU,GERMANY,2,OXFORD (KIDLINGTON),FRANKFURT MAIN,61,61,0,0,0,0,0
29/01/2018 17:06,2016,1,WESTERN EUROPE-EU,GERMANY,2,OXFORD (KIDLINGTON),HAMBURG,89,89,0,0,0,0,0
29/01/2018 17:06,2016,1,WESTERN EUROPE-EU,GERMANY,2,OXFORD (KIDLINGTON),MUNICH,96,96,0,0,0,0,0
29/01/2018 17:06,2016,1,WESTERN EUROPE-EU,GERMANY,2,PRESTWICK,COLOGNE BONN,730,730,0,0,0,0,0
29/01/2018 17:06,2016,1,WESTERN EUROPE-EU,GERMANY,2,SOUTHAMPTON,DUSSELDORF,29498,29498,0,3973,3973,0,642.46162
29/01/2018 17:06,2016,1,WESTERN EUROPE-EU,GERMANY,2,SOUTHAMPTON,FRIEDRICHSHAFEN,56,0,56,138,0,138,-59.42029
29/01/2018 17:06,2016,1,WESTERN EUROPE-EU,GERMANY,2,SOUTHAMPTON,HAMBURG,2518,2518,0,3704,3660,44,-32.01944
29/01/2018 17:06,2016,1,WESTERN EUROPE-EU,GERMANY,2,SOUTHAMPTON,MUNICH,27312,27312,0,0,0,0,0
29/01/2018 17:06,2016,1,WESTERN EUROPE-EU,GERMANY,2,SOUTHAMPTON,MUNSTER-OSNABRUCK,55,0,55,0,0,0,0
29/01/2018 17:06,2016,1,WESTERN EUROPE-EU,GERMANY,2,SOUTHAMPTON,NIEDERRHEIN,0,0,0,362,0,362,-100
29/01/2018 17:06,2016,1,WESTERN EUROPE-EU,GERMANY,2,WARTON,MUNICH,0,0,0,39,0,39,-100
29/01/2018 17:06,2016,1,WESTERN EUROPE-EU,GIBRALTAR,1,GATWICK,GIBRALTAR,190333,190333,0,133882,133882,0,42.16474
29/01/2018 17:06,2016,1,WESTERN EUROPE-EU,GIBRALTAR,1,HEATHROW,GIBRALTAR,135692,135692,0,118688,118688,0,14.32664
29/01/2018 17:06,2016,1,WESTERN EUROPE-EU,GIBRALTAR,1,LUTON,GIBRALTAR,59625,59625,0,60821,60821,0,-1.96643
29/01/2018 17:06,2016,1,WESTERN EUROPE-EU,GIBRALTAR,2,BIRMINGHAM,GIBRALTAR,43147,43002,145,38088,38088,0,13.2824
29/01/2018 17:06,2016,1,WESTERN EUROPE-EU,GIBRALTAR,2,BRISTOL,GIBRALTAR,41607,41607,0,28721,28721,0,44.86613
29/01/2018 17:06,2016,1,WESTERN EUROPE-EU,GIBRALTAR,2,GLASGOW,GIBRALTAR,60,0,60,0,0,0,0
29/01/2018 17:06,2016,1,WESTERN EUROPE-EU,GIBRALTAR,2,JERSEY,GIBRALTAR,0,0,0,355,0,355,-100
29/01/2018 17:06,2016,1,WESTERN EUROPE-EU,GIBRALTAR,2,MANCHESTER,GIBRALTAR,74061,74061,0,59538,59538,0,24.39282
29/01/2018 17:06,2016,1,WESTERN EUROPE-EU,GREECE,1,GATWICK,ATHENS,192751,192751,0,186693,186693,0,3.2449
29/01/2018 17:06,2016,1,WESTERN EUROPE-EU,GREECE,1,GATWICK,CHANIA,108876,85715,23161,73421,49741,23680,48.29
29/01/2018 17:06,2016,1,WESTERN EUROPE-EU,GREECE,1,GATWICK,CORFU,241922,174113,67809,227753,125924,101829,6.22121
29/01/2018 17:06,2016,1,WESTERN EUROPE-EU,GREECE,1,GATWICK,HERAKLION,322900,253694,69206,286863,186455,100408,12.56244
29/01/2018 17:06,2016,1,WESTERN EUROPE-EU,GREECE,1,GATWICK,KALAMATA,39650,39598,52,38093,31141,6952,4.08737
29/01/2018 17:06,2016,1,WESTERN EUROPE-EU,GREECE,1,GATWICK,KAVALA,20061,6140,13921,13544,0,13544,48.11725
29/01/2018 17:06,2016,1,WESTERN EUROPE-EU,GREECE,1,GATWICK,KEFALLINIA,109527,74036,35491,114962,50202,64760,-4.72765
29/01/2018 17:06,2016,1,WESTERN EUROPE-EU,GREECE,1,GATWICK,KOS,105800,38478,67322,104173,26934,77239,1.56183
29/01/2018 17:06,2016,1,WESTERN EUROPE-EU,GREECE,1,GATWICK,LEMNOS,1194,0,1194,162,0,162,637.03704
29/01/2018 17:06,2016,1,WESTERN EUROPE-EU,GREECE,1,GATWICK,MIKONOS,80598,80598,0,75402,67696,7706,6.89106
29/01/2018 17:06,2016,1,WESTERN EUROPE-EU,GREECE,1,GATWICK,MYTILINI,9901,9901,0,9972,0,9972,-0.71199
29/01/2018 17:06,2016,1,WESTERN EUROPE-EU,GREECE,1,GATWICK,PREVEZA,95843,58551,37292,79610,31021,48589,20.39065
29/01/2018 17:06,2016,1,WESTERN EUROPE-EU,GREECE,1,GATWICK,RHODES,186917,117991,68926,165510,75633,89877,12.93396
29/01/2018 17:06,2016,1,WESTERN EUROPE-EU,GREECE,1,GATWICK,SALONIKA,155848,146032,9816,137430,127335,10095,13.40173
29/01/2018 17:06,2016,1,WESTERN EUROPE-EU,GREECE,1,GATWICK,SAMOS,9959,0,9959,11248,0,11248,-11.45982
29/01/2018 17:06,2016,1,WESTERN EUROPE-EU,GREECE,1,GATWICK,SKIATHOS,45779,17336,28443,47191,0,47191,-2.9921
29/01/2018 17:06,2016,1,WESTERN EUROPE-EU,GREECE,1,GATWICK,THIRA (SANTORINI),106961,95045,11916,101313,81922,19391,5.5748
29/01/2018 17:06,2016,1,WESTERN EUROPE-EU,GREECE,1,GATWICK,VOLOS NEA ANCHILOS,2528,0,2528,4973,0,4973,-49.16549
29/01/2018 17:06,2016,1,WESTERN EUROPE-EU,GREECE,1,GATWICK,ZAKINTHOS,153071,93082,59989,159235,52736,106499,-3.87101
29/01/2018 17:06,2016,1,WESTERN EUROPE-EU,GREECE,1,HEATHROW,ATHENS,736458,734410,2048,699094,697046,2048,5.34463
29/01/2018 17:06,2016,1,WESTERN EUROPE-EU,GREECE,1,HEATHROW,CHANIA,11396,11396,0,0,0,0,0
29/01/2018 17:06,2016,1,WESTERN EUROPE-EU,GREECE,1,HEATHROW,CORFU,46588,41533,5055,25663,21399,4264,81.53762
29/01/2018 17:06,2016,1,WESTERN EUROPE-EU,GREECE,1,HEATHROW,HERAKLION,132,132,0,0,0,0,0
29/01/2018 17:06,2016,1,WESTERN EUROPE-EU,GREECE,1,HEATHROW,KALAMATA,21822,11317,10505,10401,0,10401,109.80675
29/01/2018 17:06,2016,1,WESTERN EUROPE-EU,GREECE,1,HEATHROW,KOS,14525,12090,2435,20708,11142,9566,-29.85803
29/01/2018 17:06,2016,1,WESTERN EUROPE-EU,GREECE,1,HEATHROW,LEMNOS,14685,0,14685,14644,0,14644,0.27998
29/01/2018 17:06,2016,1,WESTERN EUROPE-EU,GREECE,1,HEATHROW,MIKONOS,11132,11132,0,10213,10213,0,8.99834
29/01/2018 17:06,2016,1,WESTERN EUROPE-EU,GREECE,1,HEATHROW,PREVEZA,17317,0,17317,6216,0,6216,178.58752
29/01/2018 17:06,2016,1,WESTERN EUROPE-EU,GREECE,1,HEATHROW,RHODES,11396,0,11396,11633,0,11633,-2.03731
29/01/2018 17:06,2016,1,WESTERN EUROPE-EU,GREECE,1,HEATHROW,THIRA (SANTORINI),23994,23994,0,15511,15511,0,54.69022
29/01/2018 17:06,2016,1,WESTERN EUROPE-EU,GREECE,1,LONDON CITY,MIKONOS,6896,6896,0,5440,5440,0,26.76471
29/01/2018 17:06,2016,1,WESTERN EUROPE-EU,GREECE,1,LONDON CITY,THIRA (SANTORINI),3438,3438,0,2513,2513,0,36.8086
29/01/2018 17:06,2016,1,WESTERN EUROPE-EU,GREECE,1,LUTON,ATHENS,170,170,0,678,2,676,-74.92625
29/01/2018 17:06,2016,1,WESTERN EUROPE-EU,GREECE,1,LUTON,CORFU,56800,42352,14448,51248,40037,11211,10.83359
29/01/2018 17:06,2016,1,WESTERN EUROPE-EU,GREECE,1,LUTON,HERAKLION,30338,20629,9709,30213,20739,9474,0.41373
29/01/2018 17:06,2016,1,WESTERN EUROPE-EU,GREECE,1,LUTON,KALAMATA,746,0,746,0,0,0,0
29/01/2018 17:06,2016,1,WESTERN EUROPE-EU,GREECE,1,LUTON,KEFALLINIA,7414,0,7414,7478,0,7478,-0.85584
29/01/2018 17:06,2016,1,WESTERN EUROPE-EU,GREECE,1,LUTON,MIKONOS,12192,12192,0,12662,12644,18,-3.71189
29/01/2018 17:06,2016,1,WESTERN EUROPE-EU,GREECE,1,LUTON,PATRAS,0,0,0,318,0,318,-100
29/01/2018 17:06,2016,1,WESTERN EUROPE-EU,GREECE,1,LUTON,RHODES,18462,0,18462,16601,0,16601,11.21017
29/01/2018 17:06,2016,1,WESTERN EUROPE-EU,GREECE,1,LUTON,SKIATHOS,8573,0,8573,8219,0,8219,4.30709
29/01/2018 17:06,2016,1,WESTERN EUROPE-EU,GREECE,1,LUTON,THIRA (SANTORINI),9,0,9,0,0,0,0
29/01/2018 17:06,2016,1,WESTERN EUROPE-EU,GREECE,1,LUTON,ZAKINTHOS,7326,0,7326,17478,10047,7431,-58.08445
29/01/2018 17:06,2016,1,WESTERN EUROPE-EU,GREECE,1,STANSTED,ATHENS,246555,246427,128,247544,247544,0,-0.39952
29/01/2018 17:06,2016,1,WESTERN EUROPE-EU,GREECE,1,STANSTED,CHANIA,25441,25441,0,24724,24724,0,2.90002
29/01/2018 17:06,2016,1,WESTERN EUROPE-EU,GREECE,1,STANSTED,CORFU,57109,41934,15175,40476,23468,17008,41.09349
29/01/2018 17:06,2016,1,WESTERN EUROPE-EU,GREECE,1,STANSTED,HERAKLION,16014,0,16014,15956,0,15956,0.3635
29/01/2018 17:06,2016,1,WESTERN EUROPE-EU,GREECE,1,STANSTED,KEFALLINIA,30107,21331,8776,26424,11443,14981,13.93809
29/01/2018 17:06,2016,1,WESTERN EUROPE-EU,GREECE,1,STANSTED,KOS,42820,33309,9511,38028,21784,16244,12.60124
29/01/2018 17:06,2016,1,WESTERN EUROPE-EU,GREECE,1,STANSTED,MIKONOS,91,91,0,0,0,0,0
29/01/2018 17:06,2016,1,WESTERN EUROPE-EU,GREECE,1,STANSTED,PREVEZA,0,0,0,1882,0,1882,-100
29/01/2018 17:06,2016,1,WESTERN EUROPE-EU,GREECE,1,STANSTED,RHODES,65635,47185,18450,59726,34546,25180,9.89351
29/01/2018 17:06,2016,1,WESTERN EUROPE-EU,GREECE,1,STANSTED,SALONIKA,116452,116452,0,117625,117212,413,-0.99724
29/01/2018 17:06,2016,1,WESTERN EUROPE-EU,GREECE,1,STANSTED,SKIATHOS,9073,9073,0,6082,0,6082,49.1779
29/01/2018 17:06,2016,1,WESTERN EUROPE-EU,GREECE,1,STANSTED,ZAKINTHOS,38292,30698,7594,20945,4,20941,82.82168
29/01/2018 17:06,2016,1,WESTERN EUROPE-EU,GREECE,2,ABERDEEN,CORFU,7039,0,7039,7427,0,7427,-5.22418
29/01/2018 17:06,2016,1,WESTERN EUROPE-EU,GREECE,2,BELFAST INTERNATIONAL,ATHENS,0,0,0,154,0,154,-100
29/01/2018 17:06,2016,1,WESTERN EUROPE-EU,GREECE,2,BELFAST INTERNATIONAL,CORFU,7191,0,7191,12135,0,12135,-40.74166
29/01/2018 17:06,2016,1,WESTERN EUROPE-EU,GREECE,2,BELFAST INTERNATIONAL,HERAKLION,8681,0,8681,13697,0,13697,-36.62116
29/01/2018 17:06,2016,1,WESTERN EUROPE-EU,GREECE,2,BELFAST INTERNATIONAL,RHODES,6671,0,6671,4841,0,4841,37.80211
29/01/2018 17:06,2016,1,WESTERN EUROPE-EU,GREECE,2,BELFAST INTERNATIONAL,ZAKINTHOS,6177,6177,0,4672,4672,0,32.21318
29/01/2018 17:06,2016,1,WESTERN EUROPE-EU,GREECE,2,BIRMINGHAM,ATHENS,8892,8375,517,13324,13173,151,-33.26328
29/01/2018 17:06,2016,1,WESTERN EUROPE-EU,GREECE,2,BIRMINGHAM,CHANIA,7879,0,7879,9336,0,9336,-15.60626
29/01/2018 17:06,2016,1,WESTERN EUROPE-EU,GREECE,2,BIRMINGHAM,CORFU,68330,35829,32501,47552,0,47552,43.69532
29/01/2018 17:06,2016,1,WESTERN EUROPE-EU,GREECE,2,BIRMINGHAM,HERAKLION,51858,32764,19094,48375,13933,34442,7.2
29/01/2018 17:06,2016,1,WESTERN EUROPE-EU,GREECE,2,BIRMINGHAM,KALAMATA,5591,5591,0,5851,1119,4732,-4.44368
29/01/2018 17:06,2016,1,WESTERN EUROPE-EU,GREECE,2,BIRMINGHAM,KAVALA,7332,0,7332,8843,0,8843,-17.08696
29/01/2018 17:06,2016,1,WESTERN EUROPE-EU,GREECE,2,BIRMINGHAM,KEFALLINIA,27425,8481,18944,30704,0,30704,-10.67939
29/01/2018 17:06,2016,1,WESTERN EUROPE-EU,GREECE,2,BIRMINGHAM,KOS,37103,18622,18481,33952,0,33952,9.28075
29/01/2018 17:06,2016,1,WESTERN EUROPE-EU,GREECE,2,BIRMINGHAM,MYTILINI,0,0,0,8692,0,8692,-100
29/01/2018 17:06,2016,1,WESTERN EUROPE-EU,GREECE,2,BIRMINGHAM,PREVEZA,6921,6921,0,6845,6845,0,1.1103
29/01/2018 17:06,2016,1,WESTERN EUROPE-EU,GREECE,2,BIRMINGHAM,RHODES,50820,19527,31293,52476,0,52476,-3.15573
29/01/2018 17:06,2016,1,WESTERN EUROPE-EU,GREECE,2,BIRMINGHAM,SKIATHOS,14706,0,14706,8874,0,8874,65.72008
29/01/2018 17:06,2016,1,WESTERN EUROPE-EU,GREECE,2,BIRMINGHAM,THIRA (SANTORINI),13787,6197,7590,13145,0,13145,4.88399
29/01/2018 17:06,2016,1,WESTERN EUROPE-EU,GREECE,2,BIRMINGHAM,ZAKINTHOS,65470,41584,23886,54050,0,54050,21.12858
29/01/2018 17:06,2016,1,WESTERN EUROPE-EU,GREECE,2,BOURNEMOUTH,ATHENS,413,0,413,0,0,0,0
29/01/2018 17:06,2016,1,WESTERN EUROPE-EU,GREECE,2,BOURNEMOUTH,CORFU,7699,0,7699,7559,0,7559,1.8521
29/01/2018 17:06,2016,1,WESTERN EUROPE-EU,GREECE,2,BOURNEMOUTH,RHODES,9162,0,9162,9526,0,9526,-3.82112
29/01/2018 17:06,2016,1,WESTERN EUROPE-EU,GREECE,2,BRISTOL,CHANIA,23987,23987,0,22208,22208,0,8.01063
29/01/2018 17:06,2016,1,WESTERN EUROPE-EU,GREECE,2,BRISTOL,CORFU,55874,37401,18473,46214,25501,20713,20.90276
29/01/2018 17:06,2016,1,WESTERN EUROPE-EU,GREECE,2,BRISTOL,HERAKLION,48581,27353,21228,42938,17412,25526,13.14221
29/01/2018 17:06,2016,1,WESTERN EUROPE-EU,GREECE,2,BRISTOL,KEFALLINIA,16329,8136,8193,8949,0,8949,82.46731
29/01/2018 17:06,2016,1,WESTERN EUROPE-EU,GREECE,2,BRISTOL,KOS,20121,9230,10891,19773,0,19773,1.75998
29/01/2018 17:06,2016,1,WESTERN EUROPE-EU,GREECE,2,BRISTOL,RHODES,28717,7768,20949,18685,0,18685,53.69013
29/01/2018 17:06,2016,1,WESTERN EUROPE-EU,GREECE,2,BRISTOL,SALONIKA,6187,0,6187,6256,0,6256,-1.10294
29/01/2018 17:06,2016,1,WESTERN EUROPE-EU,GREECE,2,BRISTOL,SKIATHOS,8020,8020,0,7471,0,7471,7.34841
29/01/2018 17:06,2016,1,WESTERN EUROPE-EU,GREECE,2,BRISTOL,THIRA (SANTORINI),9218,0,9218,6945,0,6945,32.72858
29/01/2018 17:06,2016,1,WESTERN EUROPE-EU,GREECE,2,BRISTOL,ZAKINTHOS,52080,34778,17302,51940,7357,44583,0.26954
29/01/2018 17:06,2016,1,WESTERN EUROPE-EU,GREECE,2,CARDIFF WALES,CORFU,9577,0,9577,9552,0,9552,0.26173
29/01/2018 17:06,2016,1,WESTERN EUROPE-EU,GREECE,2,CARDIFF WALES,HERAKLION,9259,0,9259,9122,0,9122,1.50186
29/01/2018 17:06,2016,1,WESTERN EUROPE-EU,GREECE,2,CARDIFF WALES,KEFALLINIA,7474,0,7474,7649,0,7649,-2.28788
29/01/2018 17:06,2016,1,WESTERN EUROPE-EU,GREECE,2,CARDIFF WALES,KOS,8551,0,8551,8182,0,8182,4.5099
29/01/2018 17:06,2016,1,WESTERN EUROPE-EU,GREECE,2,CARDIFF WALES,RHODES,16731,0,16731,16121,0,16121,3.78388
29/01/2018 17:06,2016,1,WESTERN EUROPE-EU,GREECE,2,CARDIFF WALES,ZAKINTHOS,21358,0,21358,21315,0,21315,0.20174
29/01/2018 17:06,2016,1,WESTERN EUROPE-EU,GREECE,2,DONCASTER SHEFFIELD,ANDRAVIDA,0,0,0,45,0,45,-100
29/01/2018 17:06,2016,1,WESTERN EUROPE-EU,GREECE,2,DONCASTER SHEFFIELD,CORFU,17510,0,17510,17298,0,17298,1.22558
29/01/2018 17:06,2016,1,WESTERN EUROPE-EU,GREECE,2,DONCASTER SHEFFIELD,HERAKLION,6591,0,6591,0,0,0,0
29/01/2018 17:06,2016,1,WESTERN EUROPE-EU,GREECE,2,DONCASTER SHEFFIELD,RHODES,9558,0,9558,9097,0,9097,5.0676
29/01/2018 17:06,2016,1,WESTERN EUROPE-EU,GREECE,2,DONCASTER SHEFFIELD,ZAKINTHOS,7970,0,7970,7695,0,7695,3.57375
29/01/2018 17:06,2016,1,WESTERN EUROPE-EU,GREECE,2,EAST MIDLANDS INTERNATIONAL,CHANIA,28109,28109,0,16384,16384,0,71.56372
29/01/2018 17:06,2016,1,WESTERN EUROPE-EU,GREECE,2,EAST MIDLANDS INTERNATIONAL,CORFU,60583,44977,15606,49732,17010,32722,21.81895
29/01/2018 17:06,2016,1,WESTERN EUROPE-EU,GREECE,2,EAST MIDLANDS INTERNATIONAL,HERAKLION,41272,25225,16047,33036,17178,15858,24.93038
29/01/2018 17:06,2016,1,WESTERN EUROPE-EU,GREECE,2,EAST MIDLANDS INTERNATIONAL,KEFALLINIA,12445,4945,7500,0,0,0,0
29/01/2018 17:06,2016,1,WESTERN EUROPE-EU,GREECE,2,EAST MIDLANDS INTERNATIONAL,KOS,25003,8632,16371,15025,5944,9081,66.40932
29/01/2018 17:06,2016,1,WESTERN EUROPE-EU,GREECE,2,EAST MIDLANDS INTERNATIONAL,RHODES,54124,35895,18229,56006,29009,26997,-3.36035
29/01/2018 17:06,2016,1,WESTERN EUROPE-EU,GREECE,2,EAST MIDLANDS INTERNATIONAL,SALONIKA,7074,0,7074,7988,0,7988,-11.44216
29/01/2018 17:06,2016,1,WESTERN EUROPE-EU,GREECE,2,EAST MIDLANDS INTERNATIONAL,SKIATHOS,8218,8218,0,8137,0,8137,0.99545
29/01/2018 17:06,2016,1,WESTERN EUROPE-EU,GREECE,2,EAST MIDLANDS INTERNATIONAL,ZAKINTHOS,48467,33355,15112,38726,5996,32730,25.15364
29/01/2018 17:06,2016,1,WESTERN EUROPE-EU,GREECE,2,EDINBURGH,ATHENS,33862,33862,0,35040,35040,0,-3.36187
29/01/2018 17:06,2016,1,WESTERN EUROPE-EU,GREECE,2,EDINBURGH,CORFU,22734,13640,9094,21323,11731,9592,6.61727
29/01/2018 17:06,2016,1,WESTERN EUROPE-EU,GREECE,2,EDINBURGH,HERAKLION,33175,33175,0,18524,18524,0,79.09199
29/01/2018 17:06,2016,1,WESTERN EUROPE-EU,GREECE,2,EDINBURGH,KEFALLINIA,4713,4713,0,0,0,0,0
29/01/2018 17:06,2016,1,WESTERN EUROPE-EU,GREECE,2,EDINBURGH,RHODES,6249,6249,0,0,0,0,0
29/01/2018 17:06,2016,1,WESTERN EUROPE-EU,GREECE,2,EDINBURGH,ZAKINTHOS,7646,7646,0,0,0,0,0
29/01/2018 17:06,2016,1,WESTERN EUROPE-EU,GREECE,2,EXETER,CORFU,9134,0,9134,9625,0,9625,-5.1013
29/01/2018 17:06,2016,1,WESTERN EUROPE-EU,GREECE,2,EXETER,HERAKLION,0,0,0,5568,0,5568,-100
29/01/2018 17:06,2016,1,WESTERN EUROPE-EU,GREECE,2,EXETER,RHODES,7767,0,7767,0,0,0,0
29/01/2018 17:06,2016,1,WESTERN EUROPE-EU,GREECE,2,EXETER,SALONIKA,0,0,0,7655,0,7655,-100
29/01/2018 17:06,2016,1,WESTERN EUROPE-EU,GREECE,2,GLASGOW,CHANIA,7170,7170,0,6881,6881,0,4.19997
29/01/2018 17:06,2016,1,WESTERN EUROPE-EU,GREECE,2,GLASGOW,CORFU,31523,15323,16200,33537,6046,27491,-6.00531
29/01/2018 17:06,2016,1,WESTERN EUROPE-EU,GREECE,2,GLASGOW,HERAKLION,48925,33171,15754,50395,21742,28653,-2.91696
29/01/2018 17:06,2016,1,WESTERN EUROPE-EU,GREECE,2,GLASGOW,KOS,16812,16812,0,27070,19075,7995,-37.89435
29/01/2018 17:06,2016,1,WESTERN EUROPE-EU,GREECE,2,GLASGOW,RHODES,27123,12600,14523,26613,8524,18089,1.91636
29/01/2018 17:06,2016,1,WESTERN EUROPE-EU,GREECE,2,GLASGOW,ZAKINTHOS,24427,16421,8006,26149,5920,20229,-6.58534
29/01/2018 17:06,2016,1,WESTERN EUROPE-EU,GREECE,2,JERSEY,KAVALA,0,0,0,110,0,110,-100
29/01/2018 17:06,2016,1,WESTERN EUROPE-EU,GREECE,2,LEEDS BRADFORD,CHANIA,20570,20570,0,20959,20959,0,-1.856
29/01/2018 17:06,2016,1,WESTERN EUROPE-EU,GREECE,2,LEEDS BRADFORD,CORFU,26755,18042,8713,28941,15673,13268,-7.5533
29/01/2018 17:06,2016,1,WESTERN EUROPE-EU,GREECE,2,LEEDS BRADFORD,HERAKLION,29812,29812,0,39111,30213,8898,-23.77592
29/01/2018 17:06,2016,1,WESTERN EUROPE-EU,GREECE,2,LEEDS BRADFORD,KEFALLINIA,4895,4895,0,4609,4609,0,6.20525
29/01/2018 17:06,2016,1,WESTERN EUROPE-EU,GREECE,2,LEEDS BRADFORD,KOS,9295,9295,0,5800,5800,0,60.25862
29/01/2018 17:06,2016,1,WESTERN EUROPE-EU,GREECE,2,LEEDS BRADFORD,RHODES,19869,10853,9016,20092,10460,9632,-1.10989
29/01/2018 17:06,2016,1,WESTERN EUROPE-EU,GREECE,2,LEEDS BRADFORD,ZAKINTHOS,12034,12034,0,7858,7858,0,53.14329
29/01/2018 17:06,2016,1,WESTERN EUROPE-EU,GREECE,2,LIVERPOOL (JOHN LENNON),ATHENS,0,0,0,44,0,44,-100
29/01/2018 17:06,2016,1,WESTERN EUROPE-EU,GREECE,2,LIVERPOOL (JOHN LENNON),HERAKLION,95,0,95,0,0,0,0
29/01/2018 17:06,2016,1,WESTERN EUROPE-EU,GREECE,2,LIVERPOOL (JOHN LENNON),KOS,5443,5443,0,3266,3266,0,66.65646
29/01/2018 17:06,2016,1,WESTERN EUROPE-EU,GREECE,2,LIVERPOOL (JOHN LENNON),RHODES,28858,28858,0,21617,21617,0,33.49678
29/01/2018 17:06,2016,1,WESTERN EUROPE-EU,GREECE,2,LIVERPOOL (JOHN LENNON),ZAKINTHOS,13419,13419,0,6947,6947,0,93.16252
29/01/2018 17:06,2016,1,WESTERN EUROPE-EU,GREECE,2,MANCHESTER,ATHENS,86699,85115,1584,82860,81849,1011,4.63312
29/01/2018 17:06,2016,1,WESTERN EUROPE-EU,GREECE,2,MANCHESTER,CHANIA,45451,22567,22884,35483,21403,14080,28.09233
29/01/2018 17:06,2016,1,WESTERN EUROPE-EU,GREECE,2,MANCHESTER,CORFU,183501,126187,57314,155247,72170,83077,18.19939
29/01/2018 17:06,2016,1,WESTERN EUROPE-EU,GREECE,2,MANCHESTER,HERAKLION,184360,116704,67656,161238,69677,91561,14.34029
29/01/2018 17:06,2016,1,WESTERN EUROPE-EU,GREECE,2,MANCHESTER,KALAMATA,12765,12765,0,12420,2097,10323,2.77778
29/01/2018 17:06,2016,1,WESTERN EUROPE-EU,GREECE,2,MANCHESTER,KAVALA,13906,6471,7435,7646,0,7646,81.87287
29/01/2018 17:06,2016,1,WESTERN EUROPE-EU,GREECE,2,MANCHESTER,KEFALLINIA,81090,39858,41232,84315,20675,63640,-3.82494
29/01/2018 17:06,2016,1,WESTERN EUROPE-EU,GREECE,2,MANCHESTER,KOS,84247,37530,46717,105846,26760,79086,-20.40606
29/01/2018 17:06,2016,1,WESTERN EUROPE-EU,GREECE,2,MANCHESTER,MIKONOS,13636,13636,0,11814,11814,0,15.42238
29/01/2018 17:06,2016,1,WESTERN EUROPE-EU,GREECE,2,MANCHESTER,MYTILINI,8437,8437,0,9470,0,9470,-10.90813
29/01/2018 17:06,2016,1,WESTERN EUROPE-EU,GREECE,2,MANCHESTER,PREVEZA,45430,30115,15315,42215,8910,33305,7.61578
29/01/2018 17:06,2016,1,WESTERN EUROPE-EU,GREECE,2,MANCHESTER,RHODES,142415,71468,70947,136462,32959,103503,4.36239
29/01/2018 17:06,2016,1,WESTERN EUROPE-EU,GREECE,2,MANCHESTER,SALONIKA,46991,38394,8597,35190,28597,6593,33.5351
29/01/2018 17:06,2016,1,WESTERN EUROPE-EU,GREECE,2,MANCHESTER,SKIATHOS,54858,26186,28672,48019,0,48019,14.24228
29/01/2018 17:06,2016,1,WESTERN EUROPE-EU,GREECE,2,MANCHESTER,THIRA (SANTORINI),49665,40642,9023,49712,22891,26821,-0.09454
29/01/2018 17:06,2016,1,WESTERN EUROPE-EU,GREECE,2,MANCHESTER,VOLOS NEA ANCHILOS,0,0,0,2679,0,2679,-100
29/01/2018 17:06,2016,1,WESTERN EUROPE-EU,GREECE,2,MANCHESTER,ZAKINTHOS,117630,70565,47065,116308,27607,88701,1.13664
29/01/2018 17:06,2016,1,WESTERN EUROPE-EU,GREECE,2,NEWCASTLE,ATHENS,0,0,0,162,0,162,-100
29/01/2018 17:06,2016,1,WESTERN EUROPE-EU,GREECE,2,NEWCASTLE,CORFU,45743,45743,0,47123,13330,33793,-2.92851
29/01/2018 17:06,2016,1,WESTERN EUROPE-EU,GREECE,2,NEWCASTLE,HERAKLION,31987,31987,0,23180,8953,14227,37.99396
29/01/2018 17:06,2016,1,WESTERN EUROPE-EU,GREECE,2,NEWCASTLE,KAVALA,0,0,0,2003,0,2003,-100
29/01/2018 17:06,2016,1,WESTERN EUROPE-EU,GREECE,2,NEWCASTLE,KEFALLINIA,13087,13087,0,13269,0,13269,-1.37162
29/01/2018 17:06,2016,1,WESTERN EUROPE-EU,GREECE,2,NEWCASTLE,KOS,17835,17835,0,16697,0,16697,6.8156
29/01/2018 17:06,2016,1,WESTERN EUROPE-EU,GREECE,2,NEWCASTLE,RHODES,45663,45663,0,40248,15582,24666,13.45408
29/01/2018 17:06,2016,1,WESTERN EUROPE-EU,GREECE,2,NEWCASTLE,SKIATHOS,7846,7846,0,5195,0,5195,51.02984
29/01/2018 17:06,2016,1,WESTERN EUROPE-EU,GREECE,2,NEWCASTLE,THIRA (SANTORINI),8036,8036,0,7214,0,7214,11.39451
29/01/2018 17:06,2016,1,WESTERN EUROPE-EU,GREECE,2,NEWCASTLE,ZAKINTHOS,42227,42227,0,34936,4733,30203,20.86959
29/01/2018 17:06,2016,1,WESTERN EUROPE-EU,GREECE,2,NORWICH,CORFU,0,0,0,7438,0,7438,-100
29/01/2018 17:06,2016,1,WESTERN EUROPE-EU,GREECE,2,PRESTWICK,CORFU,5835,5832,3,5659,5659,0,3.11009
29/01/2018 17:06,2016,1,WESTERN EUROPE-EU,IRISH REPUBLIC,1,GATWICK,CORK,119889,119889,0,118177,118177,0,1.44867
29/01/2018 17:06,2016,1,WESTERN EUROPE-EU,IRISH REPUBLIC,1,GATWICK,DUBLIN,1306914,1306914,0,1083542,1083399,143,20.61498
29/01/2018 17:06,2016,1,WESTERN EUROPE-EU,IRISH REPUBLIC,1,GATWICK,IRELAND WEST(KNOCK),75707,75707,0,74658,74658,0,1.40507
29/01/2018 17:06,2016,1,WESTERN EUROPE-EU,IRISH REPUBLIC,1,GATWICK,SHANNON,109791,109791,0,110125,110125,0,-0.30329
29/01/2018 17:06,2016,1,WESTERN EUROPE-EU,IRISH REPUBLIC,1,HEATHROW,CORK,390581,390581,0,384831,384831,0,1.49416
29/01/2018 17:06,2016,1,WESTERN EUROPE-EU,IRISH REPUBLIC,1,HEATHROW,DUBLIN,1750502,1750502,0,1682855,1682855,0,4.01978
29/01/2018 17:06,2016,1,WESTERN EUROPE-EU,IRISH REPUBLIC,1,HEATHROW,SHANNON,264179,264179,0,234066,234066,0,12.86517
29/01/2018 17:06,2016,1,WESTERN EUROPE-EU,IRISH REPUBLIC,1,LONDON CITY,CORK,35361,35361,0,16961,16961,0,108.48417
29/01/2018 17:06,2016,1,WESTERN EUROPE-EU,IRISH REPUBLIC,1,LONDON CITY,DUBLIN,449657,449562,95,451474,451474,0,-0.40246
29/01/2018 17:06,2016,1,WESTERN EUROPE-EU,IRISH REPUBLIC,1,LUTON,CORK,193,161,32,0,0,0,0
29/01/2018 17:06,2016,1,WESTERN EUROPE-EU,IRISH REPUBLIC,1,LUTON,DUBLIN,349852,349658,194,337349,336668,681,3.70625
29/01/2018 17:06,2016,1,WESTERN EUROPE-EU,IRISH REPUBLIC,1,LUTON,IRELAND WEST(KNOCK),132441,132441,0,126117,126117,0,5.01439
29/01/2018 17:06,2016,1,WESTERN EUROPE-EU,IRISH REPUBLIC,1,LUTON,KERRY COUNTY,112476,112476,0,108083,107839,244,4.06447
29/01/2018 17:06,2016,1,WESTERN EUROPE-EU,IRISH REPUBLIC,1,LUTON,SHANNON,5,0,5,0,0,0,0
29/01/2018 17:06,2016,1,WESTERN EUROPE-EU,IRISH REPUBLIC,1,LUTON,WATERFORD,10926,10926,0,23123,23090,33,-52.74835
29/01/2018 17:06,2016,1,WESTERN EUROPE-EU,IRISH REPUBLIC,1,SOUTHEND,CORK,240,240,0,0,0,0,0
29/01/2018 17:06,2016,1,WESTERN EUROPE-EU,IRISH REPUBLIC,1,SOUTHEND,DUBLIN,1090,1090,0,4450,4450,0,-75.50562
29/01/2018 17:06,2016,1,WESTERN EUROPE-EU,IRISH REPUBLIC,1,STANSTED,CORK,339382,339382,0,320140,320140,0,6.0105
29/01/2018 17:06,2016,1,WESTERN EUROPE-EU,IRISH REPUBLIC,1,STANSTED,DUBLIN,914920,914857,63,879764,879574,190,3.99607
29/01/2018 17:06,2016,1,WESTERN EUROPE-EU,IRISH REPUBLIC,1,STANSTED,IRELAND WEST(KNOCK),162762,162762,0,157012,157012,0,3.66214
29/01/2018 17:06,2016,1,WESTERN EUROPE-EU,IRISH REPUBLIC,1,STANSTED,KERRY COUNTY,74890,74890,0,72487,72487,0,3.31508
29/01/2018 17:06,2016,1,WESTERN EUROPE-EU,IRISH REPUBLIC,1,STANSTED,SHANNON,238632,238632,0,231941,231941,0,2.88479
29/01/2018 17:06,2016,1,WESTERN EUROPE-EU,IRISH REPUBLIC,2,ABERDEEN,DONEGAL,0,0,0,359,0,359,-100
29/01/2018 17:06,2016,1,WESTERN EUROPE-EU,IRISH REPUBLIC,2,ABERDEEN,DUBLIN,38064,38064,0,40467,40364,103,-5.93817
29/01/2018 17:06,2016,1,WESTERN EUROPE-EU,IRISH REPUBLIC,2,BELFAST INTERNATIONAL,CORK,158,0,158,35,0,35,351.42857
29/01/2018 17:06,2016,1,WESTERN EUROPE-EU,IRISH REPUBLIC,2,BELFAST INTERNATIONAL,DUBLIN,377,0,377,1517,0,1517,-75.14832
29/01/2018 17:06,2016,1,WESTERN EUROPE-EU,IRISH REPUBLIC,2,BELFAST INTERNATIONAL,KERRY COUNTY,2,0,2,0,0,0,0
29/01/2018 17:06,2016,1,WESTERN EUROPE-EU,IRISH REPUBLIC,2,BELFAST INTERNATIONAL,SHANNON,0,0,0,271,0,271,-100
29/01/2018 17:06,2016,1,WESTERN EUROPE-EU,IRISH REPUBLIC,2,BIRMINGHAM,CORK,74856,74811,45,76961,76961,0,-2.73515
29/01/2018 17:06,2016,1,WESTERN EUROPE-EU,IRISH REPUBLIC,2,BIRMINGHAM,DUBLIN,921542,921260,282,780743,780486,257,18.03398
29/01/2018 17:06,2016,1,WESTERN EUROPE-EU,IRISH REPUBLIC,2,BIRMINGHAM,IRELAND WEST(KNOCK),23663,23663,0,5182,5134,48,356.63836
29/01/2018 17:06,2016,1,WESTERN EUROPE-EU,IRISH REPUBLIC,2,BIRMINGHAM,SHANNON,32019,31886,133,18952,18865,87,68.94787
29/01/2018 17:06,2016,1,WESTERN EUROPE-EU,IRISH REPUBLIC,2,BIRMINGHAM,WATERFORD,2694,2694,0,11151,11151,0,-75.84073
29/01/2018 17:06,2016,1,WESTERN EUROPE-EU,IRISH REPUBLIC,2,BOURNEMOUTH,DUBLIN,3013,3013,0,13954,13954,0,-78.40763
29/01/2018 17:06,2016,1,WESTERN EUROPE-EU,IRISH REPUBLIC,2,BRISTOL,CORK,41039,41029,10,41433,41415,18,-0.95093
29/01/2018 17:06,2016,1,WESTERN EUROPE-EU,IRISH REPUBLIC,2,BRISTOL,DUBLIN,399094,398803,291,378261,375696,2565,5.50757
29/01/2018 17:06,2016,1,WESTERN EUROPE-EU,IRISH REPUBLIC,2,BRISTOL,IRELAND WEST(KNOCK),29187,29187,0,27980,27980,0,4.3138
29/01/2018 17:06,2016,1,WESTERN EUROPE-EU,IRISH REPUBLIC,2,BRISTOL,SHANNON,0,0,0,312,312,0,-100
29/01/2018 17:06,2016,1,WESTERN EUROPE-EU,IRISH REPUBLIC,2,CAMPBELTOWN,DUBLIN,0,0,0,36,0,36,-100
29/01/2018 17:06,2016,1,WESTERN EUROPE-EU,IRISH REPUBLIC,2,CARDIFF WALES,CORK,11622,11473,149,5486,5207,279,111.84834
29/01/2018 17:06,2016,1,WESTERN EUROPE-EU,IRISH REPUBLIC,2,CARDIFF WALES,DUBLIN,110320,108159,2161,120518,107963,12555,-8.46181
29/01/2018 17:06,2016,1,WESTERN EUROPE-EU,IRISH REPUBLIC,2,CARDIFF WALES,SHANNON,283,0,283,2347,1374,973,-87.94205
29/01/2018 17:06,2016,1,WESTERN EUROPE-EU,IRISH REPUBLIC,2,CITY OF DERRY (EGLINTON),DUBLIN,0,0,0,28,28,0,-100
29/01/2018 17:06,2016,1,WESTERN EUROPE-EU,IRISH REPUBLIC,2,CITY OF DERRY (EGLINTON),SHANNON,0,0,0,37,0,37,-100
29/01/2018 17:06,2016,1,WESTERN EUROPE-EU,IRISH REPUBLIC,2,DONCASTER SHEFFIELD,DUBLIN,21628,21580,48,10669,10669,0,102.71816
29/01/2018 17:06,2016,1,WESTERN EUROPE-EU,IRISH REPUBLIC,2,DUNDEE,DUBLIN,0,0,0,232,0,232,-100
29/01/2018 17:06,2016,1,WESTERN EUROPE-EU,IRISH REPUBLIC,2,DURHAM TEES VALLEY,DUBLIN,0,0,0,7,0,7,-100
29/01/2018 17:06,2016,1,WESTERN EUROPE-EU,IRISH REPUBLIC,2,EAST MIDLANDS INTERNATIONAL,DUBLIN,246371,246371,0,175610,175610,0,40.2944
29/01/2018 17:06,2016,1,WESTERN EUROPE-EU,IRISH REPUBLIC,2,EAST MIDLANDS INTERNATIONAL,IRELAND WEST(KNOCK),68165,68165,0,70881,70881,0,-3.83177
29/01/2018 17:06,2016,1,WESTERN EUROPE-EU,IRISH REPUBLIC,2,EDINBURGH,CORK,37572,37572,0,40034,39968,66,-6.14977
29/01/2018 17:06,2016,1,WESTERN EUROPE-EU,IRISH REPUBLIC,2,EDINBURGH,DUBLIN,597472,595985,1487,540651,539258,1393,10.50974
29/01/2018 17:06,2016,1,WESTERN EUROPE-EU,IRISH REPUBLIC,2,EDINBURGH,IRELAND WEST(KNOCK),19652,19322,330,0,0,0,0
29/01/2018 17:06,2016,1,WESTERN EUROPE-EU,IRISH REPUBLIC,2,EDINBURGH,SHANNON,23277,23237,40,1107,357,750,2002.71003
29/01/2018 17:06,2016,1,WESTERN EUROPE-EU,IRISH REPUBLIC,2,EXETER,CORK,71,71,0,0,0,0,0
29/01/2018 17:06,2016,1,WESTERN EUROPE-EU,IRISH REPUBLIC,2,EXETER,DUBLIN,35682,35682,0,30875,30875,0,15.56923
29/01/2018 17:06,2016,1,WESTERN EUROPE-EU,IRISH REPUBLIC,2,GLASGOW,CORK,23578,23469,109,21457,21457,0,9.88489
29/01/2018 17:06,2016,1,WESTERN EUROPE-EU,IRISH REPUBLIC,2,GLASGOW,DONEGAL,11829,11829,0,9401,9401,0,25.82704
29/01/2018 17:06,2016,1,WESTERN EUROPE-EU,IRISH REPUBLIC,2,GLASGOW,DUBLIN,486886,486156,730,448820,448530,290,8.48135
29/01/2018 17:06,2016,1,WESTERN EUROPE-EU,IRISH REPUBLIC,2,GLASGOW,SHANNON,397,0,397,0,0,0,0
29/01/2018 17:06,2016,1,WESTERN EUROPE-EU,IRISH REPUBLIC,2,INVERNESS,DUBLIN,19016,19016,0,24469,24469,0,-22.28534
29/01/2018 17:06,2016,1,WESTERN EUROPE-EU,IRISH REPUBLIC,2,ISLE OF MAN,DUBLIN,42156,42057,99,36578,36578,0,15.2496
29/01/2018 17:06,2016,1,WESTERN EUROPE-EU,IRISH REPUBLIC,2,JERSEY,CORK,2823,2823,0,2428,2428,0,16.26853
29/01/2018 17:06,2016,1,WESTERN EUROPE-EU,IRISH REPUBLIC,2,JERSEY,DUBLIN,15790,15790,0,14369,14369,0,9.88935
29/01/2018 17:06,2016,1,WESTERN EUROPE-EU,IRISH REPUBLIC,2,LEEDS BRADFORD,CORK,5666,5666,0,0,0,0,0
29/01/2018 17:06,2016,1,WESTERN EUROPE-EU,IRISH REPUBLIC,2,LEEDS BRADFORD,DUBLIN,294014,294014,0,284308,284308,0,3.4139
29/01/2018 17:06,2016,1,WESTERN EUROPE-EU,IRISH REPUBLIC,2,LEEDS BRADFORD,SHANNON,56,0,56,0,0,0,0
29/01/2018 17:06,2016,1,WESTERN EUROPE-EU,IRISH REPUBLIC,2,LIVERPOOL (JOHN LENNON),CORK,79103,79103,0,77811,77811,0,1.66043
29/01/2018 17:06,2016,1,WESTERN EUROPE-EU,IRISH REPUBLIC,2,LIVERPOOL (JOHN LENNON),DUBLIN,542245,541862,383,335605,335605,0,61.57238
29/01/2018 17:06,2016,1,WESTERN EUROPE-EU,IRISH REPUBLIC,2,LIVERPOOL (JOHN LENNON),IRELAND WEST(KNOCK),82827,82827,0,82429,82429,0,0.48284
29/01/2018 17:06,2016,1,WESTERN EUROPE-EU,IRISH REPUBLIC,2,MANCHESTER,CORK,91372,91372,0,80479,80479,0,13.53521
29/01/2018 17:06,2016,1,WESTERN EUROPE-EU,IRISH REPUBLIC,2,MANCHESTER,DUBLIN,978649,977136,1513,858657,856774,1883,13.97438
29/01/2018 17:06,2016,1,WESTERN EUROPE-EU,IRISH REPUBLIC,2,MANCHESTER,IRELAND WEST(KNOCK),30224,30224,0,26233,26233,0,15.21366
29/01/2018 17:06,2016,1,WESTERN EUROPE-EU,IRISH REPUBLIC,2,MANCHESTER,KERRY COUNTY,122,0,122,0,0,0,0
29/01/2018 17:06,2016,1,WESTERN EUROPE-EU,IRISH REPUBLIC,2,MANCHESTER,SHANNON,83490,83490,0,104224,104224,0,-19.89369
29/01/2018 17:06,2016,1,WESTERN EUROPE-EU,IRISH REPUBLIC,2,NEWCASTLE,CORK,16400,16400,0,12891,12891,0,27.22054
29/01/2018 17:06,2016,1,WESTERN EUROPE-EU,IRISH REPUBLIC,2,NEWCASTLE,DUBLIN,232538,232451,87,198492,198425,67,17.15233
29/01/2018 17:06,2016,1,WESTERN EUROPE-EU,IRISH REPUBLIC,2,NEWQUAY,DUBLIN,21753,21650,103,8291,8291,0,162.36883
29/01/2018 17:06,2016,1,WESTERN EUROPE-EU,IRISH REPUBLIC,2,PRESTWICK,DUBLIN,154,154,0,0,0,0,0
29/01/2018 17:06,2016,1,WESTERN EUROPE-EU,IRISH REPUBLIC,2,PRESTWICK,SHANNON,104,0,104,0,0,0,0
29/01/2018 17:06,2016,1,WESTERN EUROPE-EU,IRISH REPUBLIC,2,SOUTHAMPTON,CORK,16452,16452,0,0,0,0,0
29/01/2018 17:06,2016,1,WESTERN EUROPE-EU,IRISH REPUBLIC,2,SOUTHAMPTON,DUBLIN,132603,132603,0,132217,132217,0,0.29194
29/01/2018 17:06,2016,1,WESTERN EUROPE-EU,IRISH REPUBLIC,2,SUMBURGH,DUBLIN,0,0,0,4358,0,4358,-100
29/01/2018 17:06,2016,1,WESTERN EUROPE-EU,ITALY,1,GATWICK,ALGHERO (FERTILIA),8605,214,8391,9283,0,9283,-7.30367
29/01/2018 17:06,2016,1,WESTERN EUROPE-EU,ITALY,1,GATWICK,BARI (PALESE),79954,79868,86,79979,79979,0,-0.03126
29/01/2018 17:06,2016,1,WESTERN EUROPE-EU,ITALY,1,GATWICK,BOLOGNA,92005,92005,0,90775,90089,686,1.355
29/01/2018 17:06,2016,1,WESTERN EUROPE-EU,ITALY,1,GATWICK,BRINDISI,10600,10600,0,14449,14449,0,-26.63852
29/01/2018 17:06,2016,1,WESTERN EUROPE-EU,ITALY,1,GATWICK,CAGLIARI (ELMAS),26378,26378,0,20355,20355,0,29.58978
29/01/2018 17:06,2016,1,WESTERN EUROPE-EU,ITALY,1,GATWICK,CATANIA (FONTANAROSSA),191860,180528,11332,180337,169553,10784,6.3897
29/01/2018 17:06,2016,1,WESTERN EUROPE-EU,ITALY,1,GATWICK,FLORENCE,87116,87116,0,88196,88094,102,-1.22455
29/01/2018 17:06,2016,1,WESTERN EUROPE-EU,ITALY,1,GATWICK,GENOA,83906,78284,5622,93027,87020,6007,-9.80468
29/01/2018 17:06,2016,1,WESTERN EUROPE-EU,ITALY,1,GATWICK,MILAN (LINATE),291940,291940,0,146681,146681,0,99.03055
29/01/2018 17:06,2016,1,WESTERN EUROPE-EU,ITALY,1,GATWICK,MILAN (MALPENSA),550593,550593,0,528232,528232,0,4.23318
29/01/2018 17:06,2016,1,WESTERN EUROPE-EU,ITALY,1,GATWICK,NAPLES,444187,412097,32090,416099,376433,39666,6.75032
29/01/2018 17:06,2016,1,WESTERN EUROPE-EU,ITALY,1,GATWICK,OLBIA,89661,89661,0,78789,78789,0,13.79888
29/01/2018 17:06,2016,1,WESTERN EUROPE-EU,ITALY,1,GATWICK,PALERMO,60800,60800,0,59502,59502,0,2.18144
29/01/2018 17:06,2016,1,WESTERN EUROPE-EU,ITALY,1,GATWICK,PISA,237093,236810,283,213521,213242,279,11.03966
29/01/2018 17:06,2016,1,WESTERN EUROPE-EU,ITALY,1,GATWICK,ROME (CIAMPINO),0,0,0,11757,11757,0,-100
29/01/2018 17:06,2016,1,WESTERN EUROPE-EU,ITALY,1,GATWICK,ROME (FIUMICINO),747299,745277,2022,740882,740431,451,0.86613
29/01/2018 17:06,2016,1,WESTERN EUROPE-EU,ITALY,1,GATWICK,TURIN,160262,142471,17791,148961,121317,27644,7.58655
29/01/2018 17:06,2016,1,WESTERN EUROPE-EU,ITALY,1,GATWICK,VENICE,731801,718488,13313,657709,644180,13529,11.26516
29/01/2018 17:06,2016,1,WESTERN EUROPE-EU,ITALY,1,GATWICK,VERONA VILLAFRANCA,281322,261594,19728,282084,262505,19579,-0.27013
29/01/2018 17:06,2016,1,WESTERN EUROPE-EU,ITALY,1,HEATHROW,BOLOGNA,250269,250269,0,243953,243953,0,2.58902
29/01/2018 17:06,2016,1,WESTERN EUROPE-EU,ITALY,1,HEATHROW,CAGLIARI (ELMAS),10713,0,10713,12934,0,12934,-17.1718
29/01/2018 17:06,2016,1,WESTERN EUROPE-EU,ITALY,1,HEATHROW,FLORENCE,140,140,0,0,0,0,0
29/01/2018 17:06,2016,1,WESTERN EUROPE-EU,ITALY,1,HEATHROW,MILAN (LINATE),616405,616405,0,672882,672882,0,-8.3933
29/01/2018 17:06,2016,1,WESTERN EUROPE-EU,ITALY,1,HEATHROW,MILAN (MALPENSA),235928,235928,0,236022,236022,0,-0.03983
29/01/2018 17:06,2016,1,WESTERN EUROPE-EU,ITALY,1,HEATHROW,OLBIA,26075,21653,4422,14999,9912,5087,73.84492
29/01/2018 17:06,2016,1,WESTERN EUROPE-EU,ITALY,1,HEATHROW,PALERMO,11194,11194,0,0,0,0,0
29/01/2018 17:06,2016,1,WESTERN EUROPE-EU,ITALY,1,HEATHROW,PISA,110180,110180,0,104601,104601,0,5.3336
29/01/2018 17:06,2016,1,WESTERN EUROPE-EU,ITALY,1,HEATHROW,ROME (FIUMICINO),988708,984145,4563,972111,968068,4043,1.70732
29/01/2018 17:06,2016,1,WESTERN EUROPE-EU,ITALY,1,HEATHROW,VENICE,149466,146942,2524,121326,119268,2058,23.19371
29/01/2018 17:06,2016,1,WESTERN EUROPE-EU,ITALY,1,LONDON CITY,BOLOGNA,98,98,0,0,0,0,0
29/01/2018 17:06,2016,1,WESTERN EUROPE-EU,ITALY,1,LONDON CITY,FLORENCE,98773,98773,0,95725,95725,0,3.18412
29/01/2018 17:06,2016,1,WESTERN EUROPE-EU,ITALY,1,LONDON CITY,MILAN (LINATE),180068,180068,0,164168,164168,0,9.6852
29/01/2018 17:06,2016,1,WESTERN EUROPE-EU,ITALY,1,LONDON CITY,PISA,440,440,0,0,0,0,0
29/01/2018 17:06,2016,1,WESTERN EUROPE-EU,ITALY,1,LONDON CITY,ROME (CIAMPINO),0,0,0,85,85,0,-100
29/01/2018 17:06,2016,1,WESTERN EUROPE-EU,ITALY,1,LONDON CITY,ROME (FIUMICINO),48482,48482,0,45779,45779,0,5.90445
29/01/2018 17:06,2016,1,WESTERN EUROPE-EU,ITALY,1,LONDON CITY,VENICE,16916,16916,0,15607,15607,0,8.38726
29/01/2018 17:06,2016,1,WESTERN EUROPE-EU,ITALY,1,LUTON,BOLOGNA,3,0,3,0,0,0,0
29/01/2018 17:06,2016,1,WESTERN EUROPE-EU,ITALY,1,LUTON,BRESCIA/MONTICHIARI,20,0,20,0,0,0,0
29/01/2018 17:06,2016,1,WESTERN EUROPE-EU,ITALY,1,LUTON,BRINDISI,8,0,8,0,0,0,0
29/01/2018 17:06,2016,1,WESTERN EUROPE-EU,ITALY,1,LUTON,CATANIA (FONTANAROSSA),46194,46190,4,41747,41711,36,10.65226
29/01/2018 17:06,2016,1,WESTERN EUROPE-EU,ITALY,1,LUTON,CUNEO,0,0,0,71,0,71,-100
29/01/2018 17:06,2016,1,WESTERN EUROPE-EU,ITALY,1,LUTON,FLORENCE,1931,1931,0,0,0,0,0
29/01/2018 17:06,2016,1,WESTERN EUROPE-EU,ITALY,1,LUTON,MILAN (LINATE),208,179,29,0,0,0,0
29/01/2018 17:06,2016,1,WESTERN EUROPE-EU,ITALY,1,LUTON,MILAN (MALPENSA),145297,145013,284,135219,134653,566,7.45309
29/01/2018 17:06,2016,1,WESTERN EUROPE-EU,ITALY,1,LUTON,NAPLES,83047,83007,40,81108,72508,8600,2.39064
29/01/2018 17:06,2016,1,WESTERN EUROPE-EU,ITALY,1,LUTON,OLBIA,13934,13827,107,12975,12805,170,7.39114
29/01/2018 17:06,2016,1,WESTERN EUROPE-EU,ITALY,1,LUTON,PARMA,0,0,0,49,0,49,-100
29/01/2018 17:06,2016,1,WESTERN EUROPE-EU,ITALY,1,LUTON,PISA,62422,62402,20,52240,52066,174,19.49081
29/01/2018 17:06,2016,1,WESTERN EUROPE-EU,ITALY,1,LUTON,RIMINI,90,0,90,353,0,353,-74.50425
29/01/2018 17:06,2016,1,WESTERN EUROPE-EU,ITALY,1,LUTON,ROME (CIAMPINO),1,0,1,10063,9995,68,-99.99006
29/01/2018 17:06,2016,1,WESTERN EUROPE-EU,ITALY,1,LUTON,ROME (FIUMICINO),114291,113295,996,100941,100837,104,13.22555
29/01/2018 17:06,2016,1,WESTERN EUROPE-EU,ITALY,1,LUTON,TURIN,39425,38899,526,285,0,285,13733.33333
29/01/2018 17:06,2016,1,WESTERN EUROPE-EU,ITALY,1,LUTON,VENICE,69535,69530,5,58904,58904,0,18.04801
29/01/2018 17:06,2016,1,WESTERN EUROPE-EU,ITALY,1,LUTON,VERONA VILLAFRANCA,594,0,594,0,0,0,0
29/01/2018 17:06,2016,1,WESTERN EUROPE-EU,ITALY,1,SOUTHEND,FLORENCE,580,580,0,0,0,0,0
29/01/2018 17:06,2016,1,WESTERN EUROPE-EU,ITALY,1,SOUTHEND,PISA,151,151,0,0,0,0,0
29/01/2018 17:06,2016,1,WESTERN EUROPE-EU,ITALY,1,SOUTHEND,ROME (CIAMPINO),0,0,0,188,0,188,-100
29/01/2018 17:06,2016,1,WESTERN EUROPE-EU,ITALY,1,SOUTHEND,VENICE,40212,40212,0,54318,54318,0,-25.96929
29/01/2018 17:06,2016,1,WESTERN EUROPE-EU,ITALY,1,STANSTED,ALGHERO (FERTILIA),50553,50553,0,82963,82963,0,-39.06561
29/01/2018 17:06,2016,1,WESTERN EUROPE-EU,ITALY,1,STANSTED,ANCONA,110166,110166,0,124623,124623,0,-11.60059
29/01/2018 17:06,2016,1,WESTERN EUROPE-EU,ITALY,1,STANSTED,BARI (PALESE),126657,126657,0,122615,122615,0,3.2965
29/01/2018 17:06,2016,1,WESTERN EUROPE-EU,ITALY,1,STANSTED,BERGAMO,489080,489080,0,495005,495005,0,-1.19696
29/01/2018 17:06,2016,1,WESTERN EUROPE-EU,ITALY,1,STANSTED,BOLOGNA,215932,215932,0,180909,180642,267,19.35946
29/01/2018 17:06,2016,1,WESTERN EUROPE-EU,ITALY,1,STANSTED,BRINDISI,79836,79836,0,76145,76145,0,4.84733
29/01/2018 17:06,2016,1,WESTERN EUROPE-EU,ITALY,1,STANSTED,CAGLIARI (ELMAS),83790,83545,245,79302,79302,0,5.65938
29/01/2018 17:06,2016,1,WESTERN EUROPE-EU,ITALY,1,STANSTED,COMISO,29980,29980,0,34368,34368,0,-12.76769
29/01/2018 17:06,2016,1,WESTERN EUROPE-EU,ITALY,1,STANSTED,FLORENCE,295,137,158,0,0,0,0
29/01/2018 17:06,2016,1,WESTERN EUROPE-EU,ITALY,1,STANSTED,GENOA,86296,86296,0,84317,84317,0,2.34709
29/01/2018 17:06,2016,1,WESTERN EUROPE-EU,ITALY,1,STANSTED,LAMETIA-TERME,54362,54362,0,54676,54676,0,-0.57429
29/01/2018 17:06,2016,1,WESTERN EUROPE-EU,ITALY,1,STANSTED,MILAN (LINATE),92,92,0,0,0,0,0
29/01/2018 17:06,2016,1,WESTERN EUROPE-EU,ITALY,1,STANSTED,MILAN (MALPENSA),235099,235099,0,16829,16829,0,1296.98734
29/01/2018 17:06,2016,1,WESTERN EUROPE-EU,ITALY,1,STANSTED,NAPLES,165812,165592,220,163142,162852,290,1.63661
29/01/2018 17:06,2016,1,WESTERN EUROPE-EU,ITALY,1,STANSTED,OLBIA,0,0,0,3013,2308,705,-100
29/01/2018 17:06,2016,1,WESTERN EUROPE-EU,ITALY,1,STANSTED,PALERMO,111872,111872,0,107412,107412,0,4.15224
29/01/2018 17:06,2016,1,WESTERN EUROPE-EU,ITALY,1,STANSTED,PARMA,40793,40793,0,50491,50491,0,-19.20738
29/01/2018 17:06,2016,1,WESTERN EUROPE-EU,ITALY,1,STANSTED,PERUGIA,96087,96087,0,92396,92396,0,3.99476
29/01/2018 17:06,2016,1,WESTERN EUROPE-EU,ITALY,1,STANSTED,PESCARA,84479,84479,0,101336,101336,0,-16.63476
29/01/2018 17:06,2016,1,WESTERN EUROPE-EU,ITALY,1,STANSTED,PISA,339408,339408,0,333111,332962,149,1.89036
29/01/2018 17:06,2016,1,WESTERN EUROPE-EU,ITALY,1,STANSTED,ROME (CIAMPINO),601009,601009,0,515514,515514,0,16.58442
29/01/2018 17:06,2016,1,WESTERN EUROPE-EU,ITALY,1,STANSTED,ROME (FIUMICINO),26551,24916,1635,1234,0,1234,2051.62075
29/01/2018 17:06,2016,1,WESTERN EUROPE-EU,ITALY,1,STANSTED,TREVISO,338451,338451,0,266219,266219,0,27.13255
29/01/2018 17:06,2016,1,WESTERN EUROPE-EU,ITALY,1,STANSTED,TRIESTE (RONCHI DEI LEGIONARI),95496,95496,0,106900,106900,0,-10.66791
29/01/2018 17:06,2016,1,WESTERN EUROPE-EU,ITALY,1,STANSTED,TURIN,128605,123487,5118,132979,127621,5358,-3.28924
29/01/2018 17:06,2016,1,WESTERN EUROPE-EU,ITALY,1,STANSTED,VENICE,679,476,203,0,0,0,0
29/01/2018 17:06,2016,1,WESTERN EUROPE-EU,ITALY,1,STANSTED,VERONA VILLAFRANCA,72426,72426,0,7376,7376,0,881.91432
29/01/2018 17:06,2016,1,WESTERN EUROPE-EU,ITALY,2,ABERDEEN,NAPLES,597,0,597,360,0,360,65.83333
29/01/2018 17:06,2016,1,WESTERN EUROPE-EU,ITALY,2,ABERDEEN,VERONA VILLAFRANCA,355,0,355,348,0,348,2.01149
29/01/2018 17:06,2016,1,WESTERN EUROPE-EU,ITALY,2,BELFAST CITY (GEORGE BEST),VERONA VILLAFRANCA,3593,272,3321,9530,0,9530,-62.29801
29/01/2018 17:06,2016,1,WESTERN EUROPE-EU,ITALY,2,BELFAST INTERNATIONAL,BERGAMO,9645,9645,0,0,0,0,0
29/01/2018 17:06,2016,1,WESTERN EUROPE-EU,ITALY,2,BELFAST INTERNATIONAL,GENOA,128,0,128,0,0,0,0
29/01/2018 17:06,2016,1,WESTERN EUROPE-EU,ITALY,2,BELFAST INTERNATIONAL,MILAN (MALPENSA),2,0,2,0,0,0,0
29/01/2018 17:06,2016,1,WESTERN EUROPE-EU,ITALY,2,BELFAST INTERNATIONAL,PARMA,170,0,170,0,0,0,0
29/01/2018 17:06,2016,1,WESTERN EUROPE-EU,ITALY,2,BELFAST INTERNATIONAL,PISA,5556,5556,0,4666,4666,0,19.07415
29/01/2018 17:06,2016,1,WESTERN EUROPE-EU,ITALY,2,BELFAST INTERNATIONAL,ROME (FIUMICINO),0,0,0,14981,14938,43,-100
29/01/2018 17:06,2016,1,WESTERN EUROPE-EU,ITALY,2,BELFAST INTERNATIONAL,TREVISO,214,0,214,80,0,80,167.5
29/01/2018 17:06,2016,1,WESTERN EUROPE-EU,ITALY,2,BELFAST INTERNATIONAL,VENICE,126,0,126,252,0,252,-50
29/01/2018 17:06,2016,1,WESTERN EUROPE-EU,ITALY,2,BELFAST INTERNATIONAL,VERONA VILLAFRANCA,6260,0,6260,4768,4768,0,31.29195
29/01/2018 17:06,2016,1,WESTERN EUROPE-EU,ITALY,2,BIRMINGHAM,BERGAMO,405,405,0,179,0,179,126.25698
29/01/2018 17:06,2016,1,WESTERN EUROPE-EU,ITALY,2,BIRMINGHAM,BOLOGNA,480,0,480,214,0,214,124.29907
29/01/2018 17:06,2016,1,WESTERN EUROPE-EU,ITALY,2,BIRMINGHAM,CAGLIARI (ELMAS),0,0,0,1155,0,1155,-100
29/01/2018 17:06,2016,1,WESTERN EUROPE-EU,ITALY,2,BIRMINGHAM,CATANIA (FONTANAROSSA),6639,0,6639,6608,0,6608,0.46913
29/01/2018 17:06,2016,1,WESTERN EUROPE-EU,ITALY,2,BIRMINGHAM,FLORENCE,73,73,0,5792,5792,0,-98.73964
29/01/2018 17:06,2016,1,WESTERN EUROPE-EU,ITALY,2,BIRMINGHAM,GENOA,5853,0,5853,6219,0,6219,-5.88519
29/01/2018 17:06,2016,1,WESTERN EUROPE-EU,ITALY,2,BIRMINGHAM,MILAN (LINATE),125,125,0,0,0,0,0
29/01/2018 17:06,2016,1,WESTERN EUROPE-EU,ITALY,2,BIRMINGHAM,MILAN (MALPENSA),104052,104052,0,85953,85953,0,21.05686
29/01/2018 17:06,2016,1,WESTERN EUROPE-EU,ITALY,2,BIRMINGHAM,NAPLES,22251,0,22251,21346,0,21346,4.23967
29/01/2018 17:06,2016,1,WESTERN EUROPE-EU,ITALY,2,BIRMINGHAM,PISA,345,345,0,0,0,0,0
29/01/2018 17:06,2016,1,WESTERN EUROPE-EU,ITALY,2,BIRMINGHAM,RIMINI,0,0,0,150,0,150,-100
29/01/2018 17:06,2016,1,WESTERN EUROPE-EU,ITALY,2,BIRMINGHAM,ROME (CIAMPINO),64,0,64,0,0,0,0
29/01/2018 17:06,2016,1,WESTERN EUROPE-EU,ITALY,2,BIRMINGHAM,ROME (FIUMICINO),82953,82070,883,67075,65501,1574,23.67201
29/01/2018 17:06,2016,1,WESTERN EUROPE-EU,ITALY,2,BIRMINGHAM,TREVISO,0,0,0,117,0,117,-100
29/01/2018 17:06,2016,1,WESTERN EUROPE-EU,ITALY,2,BIRMINGHAM,TURIN,12951,4782,8169,13229,4558,8671,-2.10144
29/01/2018 17:06,2016,1,WESTERN EUROPE-EU,ITALY,2,BIRMINGHAM,VENICE,54106,48256,5850,48875,42618,6257,10.70281
29/01/2018 17:06,2016,1,WESTERN EUROPE-EU,ITALY,2,BIRMINGHAM,VERONA VILLAFRANCA,48275,27206,21069,14274,0,14274,238.20233
29/01/2018 17:06,2016,1,WESTERN EUROPE-EU,ITALY,2,BOURNEMOUTH,BERGAMO,296,0,296,0,0,0,0
29/01/2018 17:06,2016,1,WESTERN EUROPE-EU,ITALY,2,BOURNEMOUTH,GENOA,626,0,626,931,0,931,-32.76047
29/01/2018 17:06,2016,1,WESTERN EUROPE-EU,ITALY,2,BOURNEMOUTH,MILAN (MALPENSA),727,0,727,63,0,63,1053.96825
29/01/2018 17:06,2016,1,WESTERN EUROPE-EU,ITALY,2,BOURNEMOUTH,NAPLES,709,0,709,495,0,495,43.23232
29/01/2018 17:06,2016,1,WESTERN EUROPE-EU,ITALY,2,BOURNEMOUTH,ROME (CIAMPINO),0,0,0,288,0,288,-100
29/01/2018 17:06,2016,1,WESTERN EUROPE-EU,ITALY,2,BOURNEMOUTH,ROME (FIUMICINO),421,0,421,0,0,0,0
29/01/2018 17:06,2016,1,WESTERN EUROPE-EU,ITALY,2,BOURNEMOUTH,TURIN,2786,0,2786,3522,0,3522,-20.89722
29/01/2018 17:06,2016,1,WESTERN EUROPE-EU,ITALY,2,BOURNEMOUTH,VENICE,1351,0,1351,0,0,0,0
29/01/2018 17:06,2016,1,WESTERN EUROPE-EU,ITALY,2,BOURNEMOUTH,VERONA VILLAFRANCA,708,0,708,159,0,159,345.28302
29/01/2018 17:06,2016,1,WESTERN EUROPE-EU,ITALY,2,BRISTOL,BERGAMO,40479,40479,0,33052,33052,0,22.47065
29/01/2018 17:06,2016,1,WESTERN EUROPE-EU,ITALY,2,BRISTOL,BOLOGNA,19847,19847,0,19682,19682,0,0.83833
29/01/2018 17:06,2016,1,WESTERN EUROPE-EU,ITALY,2,BRISTOL,CATANIA (FONTANAROSSA),11079,11079,0,12211,12211,0,-9.27033
29/01/2018 17:06,2016,1,WESTERN EUROPE-EU,ITALY,2,BRISTOL,MILAN (MALPENSA),6211,6205,6,7698,7698,0,-19.31671
29/01/2018 17:06,2016,1,WESTERN EUROPE-EU,ITALY,2,BRISTOL,NAPLES,35349,14513,20836,34924,13819,21105,1.21693
29/01/2018 17:06,2016,1,WESTERN EUROPE-EU,ITALY,2,BRISTOL,OLBIA,9182,9182,0,11504,11504,0,-20.18428
29/01/2018 17:06,2016,1,WESTERN EUROPE-EU,ITALY,2,BRISTOL,PISA,43704,43704,0,43186,42702,484,1.19946
29/01/2018 17:06,2016,1,WESTERN EUROPE-EU,ITALY,2,BRISTOL,ROME (CIAMPINO),0,0,0,17970,17886,84,-100
29/01/2018 17:06,2016,1,WESTERN EUROPE-EU,ITALY,2,BRISTOL,ROME (FIUMICINO),108715,107710,1005,88193,88193,0,23.26942
29/01/2018 17:06,2016,1,WESTERN EUROPE-EU,ITALY,2,BRISTOL,TREVISO,24506,24506,0,22974,22974,0,6.66841
29/01/2018 17:06,2016,1,WESTERN EUROPE-EU,ITALY,2,BRISTOL,TURIN,6368,491,5877,4514,0,4514,41.07222
29/01/2018 17:06,2016,1,WESTERN EUROPE-EU,ITALY,2,BRISTOL,VENICE,56196,56196,0,0,0,0,0
29/01/2018 17:06,2016,1,WESTERN EUROPE-EU,ITALY,2,BRISTOL,VERONA VILLAFRANCA,9593,0,9593,8376,0,8376,14.52961
29/01/2018 17:06,2016,1,WESTERN EUROPE-EU,ITALY,2,CAMBRIDGE,ANCONA,0,0,0,71,0,71,-100
29/01/2018 17:06,2016,1,WESTERN EUROPE-EU,ITALY,2,CAMBRIDGE,VERONA VILLAFRANCA,0,0,0,842,0,842,-100
29/01/2018 17:06,2016,1,WESTERN EUROPE-EU,ITALY,2,CARDIFF WALES,BRESCIA/MONTICHIARI,0,0,0,79,0,79,-100
29/01/2018 17:06,2016,1,WESTERN EUROPE-EU,ITALY,2,CARDIFF WALES,GENOA,676,0,676,310,0,310,118.06452
29/01/2018 17:06,2016,1,WESTERN EUROPE-EU,ITALY,2,CARDIFF WALES,MILAN (MALPENSA),25603,25603,0,7502,7502,0,241.28232
29/01/2018 17:06,2016,1,WESTERN EUROPE-EU,ITALY,2,CARDIFF WALES,NAPLES,0,0,0,644,0,644,-100
29/01/2018 17:06,2016,1,WESTERN EUROPE-EU,ITALY,2,CARDIFF WALES,OLBIA,163,0,163,0,0,0,0
29/01/2018 17:06,2016,1,WESTERN EUROPE-EU,ITALY,2,CARDIFF WALES,PARMA,375,0,375,313,0,313,19.80831
29/01/2018 17:06,2016,1,WESTERN EUROPE-EU,ITALY,2,CARDIFF WALES,ROME (FIUMICINO),0,0,0,3196,0,3196,-100
29/01/2018 17:06,2016,1,WESTERN EUROPE-EU,ITALY,2,CARDIFF WALES,TREVISO,0,0,0,205,0,205,-100
29/01/2018 17:06,2016,1,WESTERN EUROPE-EU,ITALY,2,CARDIFF WALES,VENICE,783,0,783,1107,0,1107,-29.26829
29/01/2018 17:06,2016,1,WESTERN EUROPE-EU,ITALY,2,CARDIFF WALES,VERONA VILLAFRANCA,3771,3771,0,360,0,360,947.5
29/01/2018 17:06,2016,1,WESTERN EUROPE-EU,ITALY,2,DONCASTER SHEFFIELD,TURIN,3081,0,3081,3266,0,3266,-5.66442
29/01/2018 17:06,2016,1,WESTERN EUROPE-EU,ITALY,2,DONCASTER SHEFFIELD,VERONA VILLAFRANCA,0,0,0,348,0,348,-100
29/01/2018 17:06,2016,1,WESTERN EUROPE-EU,ITALY,2,DURHAM TEES VALLEY,NAPLES,886,0,886,320,0,320,176.875
29/01/2018 17:06,2016,1,WESTERN EUROPE-EU,ITALY,2,DURHAM TEES VALLEY,TRIESTE (RONCHI DEI LEGIONARI),80,0,80,0,0,0,0
29/01/2018 17:06,2016,1,WESTERN EUROPE-EU,ITALY,2,DURHAM TEES VALLEY,TURIN,0,0,0,72,0,72,-100
29/01/2018 17:06,2016,1,WESTERN EUROPE-EU,ITALY,2,DURHAM TEES VALLEY,VENICE,17,0,17,0,0,0,0
29/01/2018 17:06,2016,1,WESTERN EUROPE-EU,ITALY,2,DURHAM TEES VALLEY,VERONA VILLAFRANCA,709,0,709,704,0,704,0.71023
29/01/2018 17:06,2016,1,WESTERN EUROPE-EU,ITALY,2,EAST MIDLANDS INTERNATIONAL,BERGAMO,52664,52664,0,52079,52079,0,1.12329
29/01/2018 17:06,2016,1,WESTERN EUROPE-EU,ITALY,2,EAST MIDLANDS INTERNATIONAL,FLORENCE,76,76,0,0,0,0,0
29/01/2018 17:06,2016,1,WESTERN EUROPE-EU,ITALY,2,EAST MIDLANDS INTERNATIONAL,GENOA,682,0,682,550,0,550,24
29/01/2018 17:06,2016,1,WESTERN EUROPE-EU,ITALY,2,EAST MIDLANDS INTERNATIONAL,MILAN (MALPENSA),0,0,0,590,0,590,-100
29/01/2018 17:06,2016,1,WESTERN EUROPE-EU,ITALY,2,EAST MIDLANDS INTERNATIONAL,NAPLES,19989,0,19989,16937,0,16937,18.01972
29/01/2018 17:06,2016,1,WESTERN EUROPE-EU,ITALY,2,EAST MIDLANDS INTERNATIONAL,PISA,31060,31060,0,26087,26087,0,19.06313
29/01/2018 17:06,2016,1,WESTERN EUROPE-EU,ITALY,2,EAST MIDLANDS INTERNATIONAL,ROME (CIAMPINO),39852,39852,0,32282,32282,0,23.4496
29/01/2018 17:06,2016,1,WESTERN EUROPE-EU,ITALY,2,EAST MIDLANDS INTERNATIONAL,ROME (FIUMICINO),1875,1875,0,0,0,0,0
29/01/2018 17:06,2016,1,WESTERN EUROPE-EU,ITALY,2,EAST MIDLANDS INTERNATIONAL,TREVISO,57150,57150,0,55556,55556,0,2.86918
29/01/2018 17:06,2016,1,WESTERN EUROPE-EU,ITALY,2,EAST MIDLANDS INTERNATIONAL,VENICE,830,151,679,706,0,706,17.56374
29/01/2018 17:06,2016,1,WESTERN EUROPE-EU,ITALY,2,EAST MIDLANDS INTERNATIONAL,VERONA VILLAFRANCA,4862,4862,0,0,0,0,0
29/01/2018 17:06,2016,1,WESTERN EUROPE-EU,ITALY,2,EDINBURGH,BOLOGNA,28573,28573,0,21285,21285,0,34.24008
29/01/2018 17:06,2016,1,WESTERN EUROPE-EU,ITALY,2,EDINBURGH,GENOA,395,0,395,547,0,547,-27.78793
29/01/2018 17:06,2016,1,WESTERN EUROPE-EU,ITALY,2,EDINBURGH,MILAN (MALPENSA),157598,156281,1317,113892,113611,281,38.37495
29/01/2018 17:06,2016,1,WESTERN EUROPE-EU,ITALY,2,EDINBURGH,NAPLES,18155,17887,268,20951,20951,0,-13.34543
29/01/2018 17:06,2016,1,WESTERN EUROPE-EU,ITALY,2,EDINBURGH,PARMA,144,0,144,0,0,0,0
29/01/2018 17:06,2016,1,WESTERN EUROPE-EU,ITALY,2,EDINBURGH,PISA,34439,34439,0,34290,34290,0,0.43453
29/01/2018 17:06,2016,1,WESTERN EUROPE-EU,ITALY,2,EDINBURGH,ROME (CIAMPINO),71409,71409,0,68014,68014,0,4.99162
29/01/2018 17:06,2016,1,WESTERN EUROPE-EU,ITALY,2,EDINBURGH,ROME (FIUMICINO),34247,32108,2139,1566,0,1566,2086.90932
29/01/2018 17:06,2016,1,WESTERN EUROPE-EU,ITALY,2,EDINBURGH,TURIN,220,220,0,0,0,0,0
29/01/2018 17:06,2016,1,WESTERN EUROPE-EU,ITALY,2,EDINBURGH,VENICE,84797,84404,393,30606,29556,1050,177.06005
29/01/2018 17:06,2016,1,WESTERN EUROPE-EU,ITALY,2,EDINBURGH,VERONA VILLAFRANCA,9908,9908,0,9983,9983,0,-0.75128
29/01/2018 17:06,2016,1,WESTERN EUROPE-EU,ITALY,2,EXETER,NAPLES,896,0,896,356,0,356,151.68539
29/01/2018 17:06,2016,1,WESTERN EUROPE-EU,ITALY,2,EXETER,VERONA VILLAFRANCA,1061,0,1061,712,0,712,49.01685
29/01/2018 17:06,2016,1,WESTERN EUROPE-EU,ITALY,2,GLASGOW,BERGAMO,0,0,0,1074,0,1074,-100
29/01/2018 17:06,2016,1,WESTERN EUROPE-EU,ITALY,2,GLASGOW,BOLOGNA,0,0,0,88,0,88,-100
29/01/2018 17:06,2016,1,WESTERN EUROPE-EU,ITALY,2,GLASGOW,GENOA,4418,0,4418,1409,0,1409,213.55571
29/01/2018 17:06,2016,1,WESTERN EUROPE-EU,ITALY,2,GLASGOW,MILAN (MALPENSA),36313,36313,0,4733,1889,2844,667.23009
29/01/2018 17:06,2016,1,WESTERN EUROPE-EU,ITALY,2,GLASGOW,NAPLES,12970,0,12970,12601,0,12601,2.92834
29/01/2018 17:06,2016,1,WESTERN EUROPE-EU,ITALY,2,GLASGOW,PARMA,0,0,0,91,0,91,-100
29/01/2018 17:06,2016,1,WESTERN EUROPE-EU,ITALY,2,GLASGOW,ROME (FIUMICINO),22447,22111,336,19313,19313,0,16.22741
29/01/2018 17:06,2016,1,WESTERN EUROPE-EU,ITALY,2,GLASGOW,TURIN,6331,0,6331,6204,0,6204,2.04707
29/01/2018 17:06,2016,1,WESTERN EUROPE-EU,ITALY,2,GLASGOW,VENICE,4251,0,4251,3622,0,3622,17.3661
29/01/2018 17:06,2016,1,WESTERN EUROPE-EU,ITALY,2,GLASGOW,VERONA VILLAFRANCA,13257,0,13257,13535,0,13535,-2.05393
29/01/2018 17:06,2016,1,WESTERN EUROPE-EU,ITALY,2,HUMBERSIDE,NAPLES,1181,0,1181,711,0,711,66.10408
29/01/2018 17:06,2016,1,WESTERN EUROPE-EU,ITALY,2,HUMBERSIDE,PISA,70,0,70,0,0,0,0
29/01/2018 17:06,2016,1,WESTERN EUROPE-EU,ITALY,2,HUMBERSIDE,ROME (FIUMICINO),76,0,76,88,0,88,-13.63636
29/01/2018 17:06,2016,1,WESTERN EUROPE-EU,ITALY,2,HUMBERSIDE,TURIN,0,0,0,8,0,8,-100
29/01/2018 17:06,2016,1,WESTERN EUROPE-EU,ITALY,2,HUMBERSIDE,VENICE,310,0,310,330,0,330,-6.06061
29/01/2018 17:06,2016,1,WESTERN EUROPE-EU,ITALY,2,HUMBERSIDE,VERONA VILLAFRANCA,716,0,716,352,0,352,103.40909
29/01/2018 17:06,2016,1,WESTERN EUROPE-EU,ITALY,2,INVERNESS,VERONA VILLAFRANCA,0,0,0,357,0,357,-100
29/01/2018 17:06,2016,1,WESTERN EUROPE-EU,ITALY,2,ISLE OF MAN,NAPLES,0,0,0,342,0,342,-100
29/01/2018 17:06,2016,1,WESTERN EUROPE-EU,ITALY,2,JERSEY,ANCONA,74,0,74,0,0,0,0
29/01/2018 17:06,2016,1,WESTERN EUROPE-EU,ITALY,2,JERSEY,BRINDISI,74,0,74,0,0,0,0
29/01/2018 17:06,2016,1,WESTERN EUROPE-EU,ITALY,2,JERSEY,NAPLES,0,0,0,334,0,334,-100
29/01/2018 17:06,2016,1,WESTERN EUROPE-EU,ITALY,2,JERSEY,VERONA VILLAFRANCA,358,0,358,357,0,357,0.28011
29/01/2018 17:06,2016,1,WESTERN EUROPE-EU,ITALY,2,LEEDS BRADFORD,BERGAMO,260,174,86,0,0,0,0
29/01/2018 17:06,2016,1,WESTERN EUROPE-EU,ITALY,2,LEEDS BRADFORD,NAPLES,15680,15471,209,15688,15688,0,-0.05099
29/01/2018 17:06,2016,1,WESTERN EUROPE-EU,ITALY,2,LEEDS BRADFORD,PISA,28550,28550,0,13517,13517,0,111.21551
29/01/2018 17:06,2016,1,WESTERN EUROPE-EU,ITALY,2,LEEDS BRADFORD,ROME (FIUMICINO),21386,21078,308,29027,28478,549,-26.32377
29/01/2018 17:06,2016,1,WESTERN EUROPE-EU,ITALY,2,LEEDS BRADFORD,TREVISO,21723,21723,0,22666,22666,0,-4.16042
29/01/2018 17:06,2016,1,WESTERN EUROPE-EU,ITALY,2,LEEDS BRADFORD,VENICE,16868,16868,0,16629,16629,0,1.43725
29/01/2018 17:06,2016,1,WESTERN EUROPE-EU,ITALY,2,LEEDS BRADFORD,VERONA VILLAFRANCA,4468,4468,0,5383,5383,0,-16.99796
29/01/2018 17:06,2016,1,WESTERN EUROPE-EU,ITALY,2,LIVERPOOL (JOHN LENNON),NAPLES,26567,26567,0,32662,32662,0,-18.66083
29/01/2018 17:06,2016,1,WESTERN EUROPE-EU,ITALY,2,LIVERPOOL (JOHN LENNON),PISA,33710,33710,0,21828,21828,0,54.43467
29/01/2018 17:06,2016,1,WESTERN EUROPE-EU,ITALY,2,LIVERPOOL (JOHN LENNON),VERONA VILLAFRANCA,0,0,0,314,0,314,-100
29/01/2018 17:06,2016,1,WESTERN EUROPE-EU,ITALY,2,LYDD,NAPLES,11,0,11,0,0,0,0
29/01/2018 17:06,2016,1,WESTERN EUROPE-EU,ITALY,2,MANCHESTER,ALGHERO (FERTILIA),9055,0,9055,7702,0,7702,17.56687
29/01/2018 17:06,2016,1,WESTERN EUROPE-EU,ITALY,2,MANCHESTER,BERGAMO,154169,153892,277,147172,146882,290,4.7543
29/01/2018 17:06,2016,1,WESTERN EUROPE-EU,ITALY,2,MANCHESTER,BOLOGNA,34635,34635,0,32826,32826,0,5.51088
29/01/2018 17:06,2016,1,WESTERN EUROPE-EU,ITALY,2,MANCHESTER,BRINDISI,20855,20855,0,0,0,0,0
29/01/2018 17:06,2016,1,WESTERN EUROPE-EU,ITALY,2,MANCHESTER,CAGLIARI (ELMAS),643,0,643,0,0,0,0
29/01/2018 17:06,2016,1,WESTERN EUROPE-EU,ITALY,2,MANCHESTER,CATANIA (FONTANAROSSA),42890,33224,9666,38581,27477,11104,11.16871
29/01/2018 17:06,2016,1,WESTERN EUROPE-EU,ITALY,2,MANCHESTER,GENOA,17478,0,17478,18853,0,18853,-7.29327
29/01/2018 17:06,2016,1,WESTERN EUROPE-EU,ITALY,2,MANCHESTER,MILAN (MALPENSA),135251,134914,337,62763,62763,0,115.4948
29/01/2018 17:06,2016,1,WESTERN EUROPE-EU,ITALY,2,MANCHESTER,NAPLES,87451,56508,30943,80052,28822,51230,9.24274
29/01/2018 17:06,2016,1,WESTERN EUROPE-EU,ITALY,2,MANCHESTER,OLBIA,10303,9799,504,0,0,0,0
29/01/2018 17:06,2016,1,WESTERN EUROPE-EU,ITALY,2,MANCHESTER,PISA,68555,68555,0,55839,55691,148,22.77261
29/01/2018 17:06,2016,1,WESTERN EUROPE-EU,ITALY,2,MANCHESTER,ROME (CIAMPINO),152418,152418,0,124938,124938,0,21.99491
29/01/2018 17:06,2016,1,WESTERN EUROPE-EU,ITALY,2,MANCHESTER,ROME (FIUMICINO),110086,106421,3665,86162,83163,2999,27.7663
29/01/2018 17:06,2016,1,WESTERN EUROPE-EU,ITALY,2,MANCHESTER,TURIN,22814,11236,11578,24125,4620,19505,-5.4342
29/01/2018 17:06,2016,1,WESTERN EUROPE-EU,ITALY,2,MANCHESTER,VENICE,173167,147386,25781,176656,150464,26192,-1.97502
29/01/2018 17:06,2016,1,WESTERN EUROPE-EU,ITALY,2,MANCHESTER,VERONA VILLAFRANCA,54310,26425,27885,60161,30875,29286,-9.72557
29/01/2018 17:06,2016,1,WESTERN EUROPE-EU,ITALY,2,NEWCASTLE,GENOA,674,130,544,548,0,548,22.9927
29/01/2018 17:06,2016,1,WESTERN EUROPE-EU,ITALY,2,NEWCASTLE,MILAN (MALPENSA),0,0,0,6,0,6,-100
29/01/2018 17:06,2016,1,WESTERN EUROPE-EU,ITALY,2,NEWCASTLE,NAPLES,18405,18405,0,9537,0,9537,92.98522
29/01/2018 17:06,2016,1,WESTERN EUROPE-EU,ITALY,2,NEWCASTLE,PISA,10159,10159,0,9581,9581,0,6.03277
29/01/2018 17:06,2016,1,WESTERN EUROPE-EU,ITALY,2,NEWCASTLE,ROME (FIUMICINO),17744,17744,0,16832,16832,0,5.41825
29/01/2018 17:06,2016,1,WESTERN EUROPE-EU,ITALY,2,NEWCASTLE,TURIN,3252,326,2926,3313,0,3313,-1.84123
29/01/2018 17:06,2016,1,WESTERN EUROPE-EU,ITALY,2,NEWCASTLE,VENICE,656,132,524,790,0,790,-16.96203
29/01/2018 17:06,2016,1,WESTERN EUROPE-EU,ITALY,2,NEWCASTLE,VERONA VILLAFRANCA,14255,14255,0,11952,0,11952,19.26874
29/01/2018 17:06,2016,1,WESTERN EUROPE-EU,ITALY,2,NEWQUAY,VERONA VILLAFRANCA,712,0,712,350,0,350,103.42857
29/01/2018 17:06,2016,1,WESTERN EUROPE-EU,ITALY,2,NORWICH,NAPLES,0,0,0,708,0,708,-100
29/01/2018 17:06,2016,1,WESTERN EUROPE-EU,ITALY,2,NORWICH,VERONA VILLAFRANCA,0,0,0,354,0,354,-100
29/01/2018 17:06,2016,1,WESTERN EUROPE-EU,ITALY,2,PRESTWICK,PISA,21556,21556,0,12004,12004,0,79.57348
29/01/2018 17:06,2016,1,WESTERN EUROPE-EU,ITALY,2,PRESTWICK,ROME (CIAMPINO),20935,20935,0,22135,22135,0,-5.42128
29/01/2018 17:06,2016,1,WESTERN EUROPE-EU,ITALY,2,PRESTWICK,ROME (FIUMICINO),1593,1593,0,0,0,0,0
29/01/2018 17:06,2016,1,WESTERN EUROPE-EU,ITALY,2,SOUTHAMPTON,MILAN (MALPENSA),149,0,149,3982,3982,0,-96.25816
29/01/2018 17:06,2016,1,WESTERN EUROPE-EU,ITALY,2,SOUTHAMPTON,TRIESTE (RONCHI DEI LEGIONARI),0,0,0,149,0,149,-100
29/01/2018 17:06,2016,1,WESTERN EUROPE-EU,ITALY,2,SOUTHAMPTON,VENICE,88,0,88,0,0,0,0
29/01/2018 17:06,2016,1,WESTERN EUROPE-EU,ITALY,2,SOUTHAMPTON,VERONA VILLAFRANCA,7378,7378,0,6491,6491,0,13.66507
29/01/2018 17:06,2016,1,WESTERN EUROPE-EU,LUXEMBOURG,1,GATWICK,LUXEMBOURG,70105,70105,0,61460,61460,0,14.06606
29/01/2018 17:06,2016,1,WESTERN EUROPE-EU,LUXEMBOURG,1,HEATHROW,LUXEMBOURG,144292,144292,0,145659,145659,0,-0.93849
29/01/2018 17:06,2016,1,WESTERN EUROPE-EU,LUXEMBOURG,1,LONDON CITY,LUXEMBOURG,183097,183097,0,186941,186913,28,-2.05626
29/01/2018 17:06,2016,1,WESTERN EUROPE-EU,LUXEMBOURG,1,LUTON,LUXEMBOURG,729,723,6,0,0,0,0
29/01/2018 17:06,2016,1,WESTERN EUROPE-EU,LUXEMBOURG,1,SOUTHEND,LUXEMBOURG,107,107,0,0,0,0,0
29/01/2018 17:06,2016,1,WESTERN EUROPE-EU,LUXEMBOURG,1,STANSTED,LUXEMBOURG,18018,18018,0,1134,1134,0,1488.88889
29/01/2018 17:06,2016,1,WESTERN EUROPE-EU,LUXEMBOURG,2,ABERDEEN,LUXEMBOURG,174,0,174,0,0,0,0
29/01/2018 17:06,2016,1,WESTERN EUROPE-EU,LUXEMBOURG,2,BELFAST INTERNATIONAL,LUXEMBOURG,90,0,90,0,0,0,0
29/01/2018 17:06,2016,1,WESTERN EUROPE-EU,LUXEMBOURG,2,BIRMINGHAM,LUXEMBOURG,6627,6627,0,0,0,0,0
29/01/2018 17:06,2016,1,WESTERN EUROPE-EU,LUXEMBOURG,2,EDINBURGH,LUXEMBOURG,295,0,295,0,0,0,0
29/01/2018 17:06,2016,1,WESTERN EUROPE-EU,LUXEMBOURG,2,JERSEY,LUXEMBOURG,82,82,0,229,0,229,-64.19214
29/01/2018 17:06,2016,1,WESTERN EUROPE-EU,LUXEMBOURG,2,MANCHESTER,LUXEMBOURG,11310,11310,0,0,0,0,0
29/01/2018 17:06,2016,1,WESTERN EUROPE-EU,LUXEMBOURG,2,PRESTWICK,LUXEMBOURG,11,11,0,1,1,0,1000
29/01/2018 17:06,2016,1,WESTERN EUROPE-EU,LUXEMBOURG,2,SOUTHAMPTON,LUXEMBOURG,86,0,86,0,0,0,0
29/01/2018 17:06,2016,1,WESTERN EUROPE-EU,MALTA,1,GATWICK,MALTA,346896,328346,18550,341116,317514,23602,1.69444
29/01/2018 17:06,2016,1,WESTERN EUROPE-EU,MALTA,1,HEATHROW,MALTA,189847,189847,0,189409,189409,0,0.23125
29/01/2018 17:06,2016,1,WESTERN EUROPE-EU,MALTA,1,LUTON,MALTA,121639,121307,332,116114,116100,14,4.75825
29/01/2018 17:06,2016,1,WESTERN EUROPE-EU,MALTA,1,STANSTED,MALTA,83447,83446,1,68195,67906,289,22.36528
29/01/2018 17:06,2016,1,WESTERN EUROPE-EU,MALTA,2,ABERDEEN,MALTA,45,0,45,0,0,0,0
29/01/2018 17:06,2016,1,WESTERN EUROPE-EU,MALTA,2,BELFAST INTERNATIONAL,MALTA,0,0,0,22963,22963,0,-100
29/01/2018 17:06,2016,1,WESTERN EUROPE-EU,MALTA,2,BIRMINGHAM,MALTA,59930,59631,299,50954,36923,14031,17.61589
29/01/2018 17:06,2016,1,WESTERN EUROPE-EU,MALTA,2,BOURNEMOUTH,MALTA,27861,27861,0,21561,21561,0,29.21942
29/01/2018 17:06,2016,1,WESTERN EUROPE-EU,MALTA,2,BRISTOL,MALTA,57726,52371,5355,57395,49563,7832,0.57671
29/01/2018 17:06,2016,1,WESTERN EUROPE-EU,MALTA,2,CARDIFF WALES,MALTA,6942,0,6942,7143,0,7143,-2.81394
29/01/2018 17:06,2016,1,WESTERN EUROPE-EU,MALTA,2,EAST MIDLANDS INTERNATIONAL,MALTA,43300,43300,0,37476,37476,0,15.54061
29/01/2018 17:06,2016,1,WESTERN EUROPE-EU,MALTA,2,EDINBURGH,MALTA,63195,62953,242,50108,50108,0,26.11759
29/01/2018 17:06,2016,1,WESTERN EUROPE-EU,MALTA,2,EXETER,MALTA,6525,0,6525,7011,0,7011,-6.93196
29/01/2018 17:06,2016,1,WESTERN EUROPE-EU,MALTA,2,GLASGOW,MALTA,7694,7441,253,13990,7404,6586,-45.00357
29/01/2018 17:06,2016,1,WESTERN EUROPE-EU,MALTA,2,ISLE OF MAN,MALTA,0,0,0,279,0,279,-100
29/01/2018 17:06,2016,1,WESTERN EUROPE-EU,MALTA,2,LEEDS BRADFORD,MALTA,43493,43203,290,43880,43880,0,-0.88195
29/01/2018 17:06,2016,1,WESTERN EUROPE-EU,MALTA,2,LIVERPOOL (JOHN LENNON),MALTA,38118,38118,0,37051,37051,0,2.87981
29/01/2018 17:06,2016,1,WESTERN EUROPE-EU,MALTA,2,MANCHESTER,MALTA,214049,202739,11310,166309,141239,25070,28.7056
29/01/2018 17:06,2016,1,WESTERN EUROPE-EU,MALTA,2,NEWCASTLE,MALTA,35239,35239,0,41936,36230,5706,-15.96957
29/01/2018 17:06,2016,1,WESTERN EUROPE-EU,MALTA,2,NORWICH,MALTA,0,0,0,5815,0,5815,-100
29/01/2018 17:06,2016,1,WESTERN EUROPE-EU,MALTA,2,PRESTWICK,MALTA,13879,13879,0,10697,10697,0,29.74666
29/01/2018 17:06,2016,1,WESTERN EUROPE-EU,NETHERLANDS,1,GATWICK,AMSTERDAM,1062388,1062018,370,977713,976835,878,8.66052
29/01/2018 17:06,2016,1,WESTERN EUROPE-EU,NETHERLANDS,1,GATWICK,GRONINGEN,3,0,3,0,0,0,0
29/01/2018 17:06,2016,1,WESTERN EUROPE-EU,NETHERLANDS,1,HEATHROW,AMSTERDAM,1616595,1616595,0,1587605,1587605,0,1.82602
29/01/2018 17:06,2016,1,WESTERN EUROPE-EU,NETHERLANDS,1,HEATHROW,EINDHOVEN,0,0,0,2,0,2,-100
29/01/2018 17:06,2016,1,WESTERN EUROPE-EU,NETHERLANDS,1,HEATHROW,ROTTERDAM,0,0,0,22285,22285,0,-100
29/01/2018 17:06,2016,1,WESTERN EUROPE-EU,NETHERLANDS,1,LONDON CITY,AMSTERDAM,517305,517305,0,488104,488104,0,5.98254
29/01/2018 17:06,2016,1,WESTERN EUROPE-EU,NETHERLANDS,1,LONDON CITY,ROTTERDAM,219857,219720,137,208725,208725,0,5.33333
29/01/2018 17:06,2016,1,WESTERN EUROPE-EU,NETHERLANDS,1,LUTON,AMSTERDAM,608188,607939,249,418006,417643,363,45.49743
29/01/2018 17:06,2016,1,WESTERN EUROPE-EU,NETHERLANDS,1,LUTON,MAASTRICHT,186,0,186,121,0,121,53.71901
29/01/2018 17:06,2016,1,WESTERN EUROPE-EU,NETHERLANDS,1,LUTON,ROTTERDAM,0,0,0,10,0,10,-100
29/01/2018 17:06,2016,1,WESTERN EUROPE-EU,NETHERLANDS,1,SOUTHEND,AMSTERDAM,206077,206077,0,214462,214462,0,-3.90978
29/01/2018 17:06,2016,1,WESTERN EUROPE-EU,NETHERLANDS,1,SOUTHEND,GRONINGEN,24524,24524,0,21505,21505,0,14.0386
29/01/2018 17:06,2016,1,WESTERN EUROPE-EU,NETHERLANDS,1,SOUTHEND,MAASTRICHT,0,0,0,205,205,0,-100
29/01/2018 17:06,2016,1,WESTERN EUROPE-EU,NETHERLANDS,1,SOUTHEND,ROTTERDAM,639,639,0,0,0,0,0
29/01/2018 17:06,2016,1,WESTERN EUROPE-EU,NETHERLANDS,1,STANSTED,AMSTERDAM,325248,324381,867,300571,299953,618,8.21004
29/01/2018 17:06,2016,1,WESTERN EUROPE-EU,NETHERLANDS,1,STANSTED,EINDHOVEN,277807,277807,0,242424,242424,0,14.5955
29/01/2018 17:06,2016,1,WESTERN EUROPE-EU,NETHERLANDS,1,STANSTED,ROTTERDAM,95,95,0,0,0,0,0
29/01/2018 17:06,2016,1,WESTERN EUROPE-EU,NETHERLANDS,2,ABERDEEN,AMSTERDAM,280993,280993,0,306004,305921,83,-8.17342
29/01/2018 17:06,2016,1,WESTERN EUROPE-EU,NETHERLANDS,2,ABERDEEN,MAASTRICHT,0,0,0,60,0,60,-100
29/01/2018 17:06,2016,1,WESTERN EUROPE-EU,NETHERLANDS,2,ABERDEEN,ROTTERDAM,0,0,0,357,0,357,-100
29/01/2018 17:06,2016,1,WESTERN EUROPE-EU,NETHERLANDS,2,BELFAST CITY (GEORGE BEST),AMSTERDAM,41042,41042,0,26084,26084,0,57.3455
29/01/2018 17:06,2016,1,WESTERN EUROPE-EU,NETHERLANDS,2,BELFAST CITY (GEORGE BEST),MAASTRICHT,0,0,0,64,0,64,-100
29/01/2018 17:06,2016,1,WESTERN EUROPE-EU,NETHERLANDS,2,BELFAST INTERNATIONAL,AMSTERDAM,121976,121976,0,101894,101833,61,19.70872
29/01/2018 17:06,2016,1,WESTERN EUROPE-EU,NETHERLANDS,2,BIGGIN HILL,ROTTERDAM,0,0,0,128,0,128,-100
29/01/2018 17:06,2016,1,WESTERN EUROPE-EU,NETHERLANDS,2,BIRMINGHAM,AMSTERDAM,631646,631557,89,563915,563915,0,12.01085
29/01/2018 17:06,2016,1,WESTERN EUROPE-EU,NETHERLANDS,2,BIRMINGHAM,MAASTRICHT,0,0,0,65,0,65,-100
29/01/2018 17:06,2016,1,WESTERN EUROPE-EU,NETHERLANDS,2,BIRMINGHAM,ROTTERDAM,9254,9254,0,278,0,278,3228.77698
29/01/2018 17:06,2016,1,WESTERN EUROPE-EU,NETHERLANDS,2,BOURNEMOUTH,AMSTERDAM,2963,2927,36,13081,12894,187,-77.34883
29/01/2018 17:06,2016,1,WESTERN EUROPE-EU,NETHERLANDS,2,BRISTOL,AMSTERDAM,408570,408570,0,384482,384482,0,6.26505
29/01/2018 17:06,2016,1,WESTERN EUROPE-EU,NETHERLANDS,2,CAMBRIDGE,AMSTERDAM,0,0,0,508,0,508,-100
29/01/2018 17:06,2016,1,WESTERN EUROPE-EU,NETHERLANDS,2,CAMBRIDGE,GRONINGEN,591,591,0,2591,2182,409,-77.19027
29/01/2018 17:06,2016,1,WESTERN EUROPE-EU,NETHERLANDS,2,CARDIFF WALES,AMSTERDAM,135032,135032,0,129186,129026,160,4.52526
29/01/2018 17:06,2016,1,WESTERN EUROPE-EU,NETHERLANDS,2,CITY OF DERRY (EGLINTON),AMSTERDAM,92,0,92,0,0,0,0
29/01/2018 17:06,2016,1,WESTERN EUROPE-EU,NETHERLANDS,2,DONCASTER SHEFFIELD,AMSTERDAM,45803,45803,0,0,0,0,0
29/01/2018 17:06,2016,1,WESTERN EUROPE-EU,NETHERLANDS,2,DONCASTER SHEFFIELD,ROTTERDAM,93,93,0,0,0,0,0
29/01/2018 17:06,2016,1,WESTERN EUROPE-EU,NETHERLANDS,2,DUNDEE,AMSTERDAM,15258,15258,0,0,0,0,0
29/01/2018 17:06,2016,1,WESTERN EUROPE-EU,NETHERLANDS,2,DURHAM TEES VALLEY,AMSTERDAM,103727,103727,0,105636,105636,0,-1.80715
29/01/2018 17:06,2016,1,WESTERN EUROPE-EU,NETHERLANDS,2,DURHAM TEES VALLEY,MAASTRICHT,0,0,0,454,0,454,-100
29/01/2018 17:06,2016,1,WESTERN EUROPE-EU,NETHERLANDS,2,EAST MIDLANDS INTERNATIONAL,AMSTERDAM,41991,41966,25,45275,45275,0,-7.25345
29/01/2018 17:06,2016,1,WESTERN EUROPE-EU,NETHERLANDS,2,EDINBURGH,AMSTERDAM,651034,650558,476,621195,621195,0,4.80348
29/01/2018 17:06,2016,1,WESTERN EUROPE-EU,NETHERLANDS,2,EDINBURGH,ROTTERDAM,0,0,0,162,0,162,-100
29/01/2018 17:06,2016,1,WESTERN EUROPE-EU,NETHERLANDS,2,EXETER,AMSTERDAM,44040,44040,0,43621,43621,0,0.96055
29/01/2018 17:06,2016,1,WESTERN EUROPE-EU,NETHERLANDS,2,EXETER,LEEUWARDEN,48,0,48,0,0,0,0
29/01/2018 17:06,2016,1,WESTERN EUROPE-EU,NETHERLANDS,2,GLASGOW,AMSTERDAM,436675,436674,1,425444,424424,1020,2.63983
29/01/2018 17:06,2016,1,WESTERN EUROPE-EU,NETHERLANDS,2,GLASGOW,MAASTRICHT,0,0,0,65,0,65,-100
29/01/2018 17:06,2016,1,WESTERN EUROPE-EU,NETHERLANDS,2,GUERNSEY,ROTTERDAM,1514,1514,0,863,0,863,75.43453
29/01/2018 17:06,2016,1,WESTERN EUROPE-EU,NETHERLANDS,2,HUMBERSIDE,AMSTERDAM,118292,118292,0,121893,121893,0,-2.95423
29/01/2018 17:06,2016,1,WESTERN EUROPE-EU,NETHERLANDS,2,INVERNESS,AMSTERDAM,41750,41743,7,33179,33179,0,25.8326
29/01/2018 17:06,2016,1,WESTERN EUROPE-EU,NETHERLANDS,2,JERSEY,AMSTERDAM,0,0,0,73,73,0,-100
29/01/2018 17:06,2016,1,WESTERN EUROPE-EU,NETHERLANDS,2,JERSEY,ROTTERDAM,1236,810,426,1546,1478,68,-20.05175
29/01/2018 17:06,2016,1,WESTERN EUROPE-EU,NETHERLANDS,2,LEEDS BRADFORD,AMSTERDAM,253757,253757,0,250568,250568,0,1.27271
29/01/2018 17:06,2016,1,WESTERN EUROPE-EU,NETHERLANDS,2,LEEDS BRADFORD,ROTTERDAM,96,0,96,0,0,0,0
29/01/2018 17:06,2016,1,WESTERN EUROPE-EU,NETHERLANDS,2,LIVERPOOL (JOHN LENNON),AMSTERDAM,257466,257466,0,227383,227383,0,13.2301
29/01/2018 17:06,2016,1,WESTERN EUROPE-EU,NETHERLANDS,2,MANCHESTER,AMSTERDAM,1013260,1012542,718,853427,852741,686,18.72837
29/01/2018 17:06,2016,1,WESTERN EUROPE-EU,NETHERLANDS,2,MANCHESTER,EINDHOVEN,70606,70606,0,64430,63673,757,9.5856
29/01/2018 17:06,2016,1,WESTERN EUROPE-EU,NETHERLANDS,2,MANCHESTER,ROTTERDAM,27433,26695,738,100,0,100,27333
29/01/2018 17:06,2016,1,WESTERN EUROPE-EU,NETHERLANDS,2,NEWCASTLE,AMSTERDAM,363690,363644,46,380012,379759,253,-4.29513
29/01/2018 17:06,2016,1,WESTERN EUROPE-EU,NETHERLANDS,2,NEWCASTLE,EINDHOVEN,0,0,0,163,0,163,-100
29/01/2018 17:06,2016,1,WESTERN EUROPE-EU,NETHERLANDS,2,NEWCASTLE,MAASTRICHT,55,0,55,0,0,0,0
29/01/2018 17:06,2016,1,WESTERN EUROPE-EU,NETHERLANDS,2,NORWICH,AMSTERDAM,143361,143361,0,142409,142224,185,0.6685
29/01/2018 17:06,2016,1,WESTERN EUROPE-EU,NETHERLANDS,2,PRESTWICK,AMSTERDAM,0,0,0,95,0,95,-100
29/01/2018 17:06,2016,1,WESTERN EUROPE-EU,NETHERLANDS,2,SHEFFIELD CITY,ROTTERDAM,0,0,0,48,0,48,-100
29/01/2018 17:06,2016,1,WESTERN EUROPE-EU,NETHERLANDS,2,SOUTHAMPTON,AMSTERDAM,188355,188267,88,127764,127684,80,47.42416
29/01/2018 17:06,2016,1,WESTERN EUROPE-EU,NETHERLANDS,2,SOUTHAMPTON,GRONINGEN,70,0,70,0,0,0,0
29/01/2018 17:06,2016,1,WESTERN EUROPE-EU,NETHERLANDS,2,SOUTHAMPTON,MAASTRICHT,0,0,0,37,0,37,-100
29/01/2018 17:06,2016,1,WESTERN EUROPE-EU,NETHERLANDS,2,SOUTHAMPTON,ROTTERDAM,52,52,0,0,0,0,0
29/01/2018 17:06,2016,1,WESTERN EUROPE-EU,PORTUGAL(EXCLUDING MADEIRA),1,GATWICK,AZORES PONTA DELGADA,6039,6039,0,5855,5855,0,3.14261
29/01/2018 17:06,2016,1,WESTERN EUROPE-EU,PORTUGAL(EXCLUDING MADEIRA),1,GATWICK,FARO,809645,769299,40346,750876,723458,27418,7.82673
29/01/2018 17:06,2016,1,WESTERN EUROPE-EU,PORTUGAL(EXCLUDING MADEIRA),1,GATWICK,LISBON,320686,320355,331,302884,302884,0,5.8775
29/01/2018 17:06,2016,1,WESTERN EUROPE-EU,PORTUGAL(EXCLUDING MADEIRA),1,GATWICK,OPORTO (PORTUGAL),281296,281296,0,239742,239634,108,17.3328
29/01/2018 17:06,2016,1,WESTERN EUROPE-EU,PORTUGAL(EXCLUDING MADEIRA),1,HEATHROW,AZORES SANTA MARIA,0,0,0,146,0,146,-100
29/01/2018 17:06,2016,1,WESTERN EUROPE-EU,PORTUGAL(EXCLUDING MADEIRA),1,HEATHROW,FARO,17052,17052,0,17019,17019,0,0.1939
29/01/2018 17:06,2016,1,WESTERN EUROPE-EU,PORTUGAL(EXCLUDING MADEIRA),1,HEATHROW,LISBON,795987,795987,0,768043,768043,0,3.63834
29/01/2018 17:06,2016,1,WESTERN EUROPE-EU,PORTUGAL(EXCLUDING MADEIRA),1,HEATHROW,OPORTO (PORTUGAL),0,0,0,14343,14343,0,-100
29/01/2018 17:06,2016,1,WESTERN EUROPE-EU,PORTUGAL(EXCLUDING MADEIRA),1,LONDON CITY,FARO,11676,11676,0,4815,4815,0,142.49221
29/01/2018 17:06,2016,1,WESTERN EUROPE-EU,PORTUGAL(EXCLUDING MADEIRA),1,LUTON,AZORES PONTA DELGADA,66,0,66,0,0,0,0
29/01/2018 17:06,2016,1,WESTERN EUROPE-EU,PORTUGAL(EXCLUDING MADEIRA),1,LUTON,FARO,255398,234559,20839,220089,199788,20301,16.04306
29/01/2018 17:06,2016,1,WESTERN EUROPE-EU,PORTUGAL(EXCLUDING MADEIRA),1,LUTON,LISBON,166032,166032,0,163959,163516,443,1.26434
29/01/2018 17:06,2016,1,WESTERN EUROPE-EU,PORTUGAL(EXCLUDING MADEIRA),1,LUTON,OPORTO (PORTUGAL),42252,42252,0,30405,29878,527,38.96399
29/01/2018 17:06,2016,1,WESTERN EUROPE-EU,PORTUGAL(EXCLUDING MADEIRA),1,SOUTHEND,FARO,97626,97626,0,93956,93956,0,3.90608
29/01/2018 17:06,2016,1,WESTERN EUROPE-EU,PORTUGAL(EXCLUDING MADEIRA),1,STANSTED,AZORES PONTA DELGADA,13979,13979,0,12275,12275,0,13.88187
29/01/2018 17:06,2016,1,WESTERN EUROPE-EU,PORTUGAL(EXCLUDING MADEIRA),1,STANSTED,FARO,263138,241015,22123,183016,171794,11222,43.77869
29/01/2018 17:06,2016,1,WESTERN EUROPE-EU,PORTUGAL(EXCLUDING MADEIRA),1,STANSTED,LISBON,379420,379420,0,369514,369133,381,2.68082
29/01/2018 17:06,2016,1,WESTERN EUROPE-EU,PORTUGAL(EXCLUDING MADEIRA),1,STANSTED,OPORTO (PORTUGAL),302333,302333,0,265238,265141,97,13.98555
29/01/2018 17:06,2016,1,WESTERN EUROPE-EU,PORTUGAL(EXCLUDING MADEIRA),2,ABERDEEN,FARO,5628,0,5628,6953,0,6953,-19.05652
29/01/2018 17:06,2016,1,WESTERN EUROPE-EU,PORTUGAL(EXCLUDING MADEIRA),2,BELFAST CITY (GEORGE BEST),FARO,67151,67151,0,59053,59053,0,13.71311
29/01/2018 17:06,2016,1,WESTERN EUROPE-EU,PORTUGAL(EXCLUDING MADEIRA),2,BELFAST INTERNATIONAL,FARO,124455,124455,0,113758,113758,0,9.40329
29/01/2018 17:06,2016,1,WESTERN EUROPE-EU,PORTUGAL(EXCLUDING MADEIRA),2,BELFAST INTERNATIONAL,LISBON,0,0,0,418,0,418,-100
29/01/2018 17:06,2016,1,WESTERN EUROPE-EU,PORTUGAL(EXCLUDING MADEIRA),2,BIRMINGHAM,FARO,208567,182347,26220,208693,180244,28449,-0.06038
29/01/2018 17:06,2016,1,WESTERN EUROPE-EU,PORTUGAL(EXCLUDING MADEIRA),2,BIRMINGHAM,LISBON,30045,29948,97,830,0,830,3519.87952
29/01/2018 17:06,2016,1,WESTERN EUROPE-EU,PORTUGAL(EXCLUDING MADEIRA),2,BIRMINGHAM,OPORTO (PORTUGAL),41,8,33,3984,3972,12,-98.97088
29/01/2018 17:06,2016,1,WESTERN EUROPE-EU,PORTUGAL(EXCLUDING MADEIRA),2,BOURNEMOUTH,FARO,54568,54568,0,33533,33533,0,62.72925
29/01/2018 17:06,2016,1,WESTERN EUROPE-EU,PORTUGAL(EXCLUDING MADEIRA),2,BOURNEMOUTH,OPORTO (PORTUGAL),139,139,0,0,0,0,0
29/01/2018 17:06,2016,1,WESTERN EUROPE-EU,PORTUGAL(EXCLUDING MADEIRA),2,BRISTOL,FARO,291226,280029,11197,272715,269113,3602,6.78767
29/01/2018 17:06,2016,1,WESTERN EUROPE-EU,PORTUGAL(EXCLUDING MADEIRA),2,BRISTOL,LISBON,65536,65536,0,62376,62376,0,5.06605
29/01/2018 17:06,2016,1,WESTERN EUROPE-EU,PORTUGAL(EXCLUDING MADEIRA),2,BRISTOL,OPORTO (PORTUGAL),44541,44541,0,30013,30013,0,48.40569
29/01/2018 17:06,2016,1,WESTERN EUROPE-EU,PORTUGAL(EXCLUDING MADEIRA),2,CARDIFF WALES,FARO,37614,28352,9262,22235,13215,9020,69.16573
29/01/2018 17:06,2016,1,WESTERN EUROPE-EU,PORTUGAL(EXCLUDING MADEIRA),2,CITY OF DERRY (EGLINTON),FARO,11662,11662,0,2902,2902,0,301.86079
29/01/2018 17:06,2016,1,WESTERN EUROPE-EU,PORTUGAL(EXCLUDING MADEIRA),2,DONCASTER SHEFFIELD,FARO,31830,12302,19528,17884,0,17884,77.98032
29/01/2018 17:06,2016,1,WESTERN EUROPE-EU,PORTUGAL(EXCLUDING MADEIRA),2,EAST MIDLANDS INTERNATIONAL,FARO,243715,234601,9114,235491,226282,9209,3.49228
29/01/2018 17:06,2016,1,WESTERN EUROPE-EU,PORTUGAL(EXCLUDING MADEIRA),2,EAST MIDLANDS INTERNATIONAL,OPORTO (PORTUGAL),1956,0,1956,0,0,0,0
29/01/2018 17:06,2016,1,WESTERN EUROPE-EU,PORTUGAL(EXCLUDING MADEIRA),2,EDINBURGH,FARO,115735,115735,0,99255,99255,0,16.6037
29/01/2018 17:06,2016,1,WESTERN EUROPE-EU,PORTUGAL(EXCLUDING MADEIRA),2,EDINBURGH,LISBON,47823,47823,0,47566,47342,224,0.5403
29/01/2018 17:06,2016,1,WESTERN EUROPE-EU,PORTUGAL(EXCLUDING MADEIRA),2,EXETER,FARO,20522,11359,9163,27678,18612,9066,-25.85447
29/01/2018 17:06,2016,1,WESTERN EUROPE-EU,PORTUGAL(EXCLUDING MADEIRA),2,EXETER,LISBON,0,0,0,10,0,10,-100
29/01/2018 17:06,2016,1,WESTERN EUROPE-EU,PORTUGAL(EXCLUDING MADEIRA),2,GLASGOW,FARO,110288,95762,14526,96754,85474,11280,13.98805
29/01/2018 17:06,2016,1,WESTERN EUROPE-EU,PORTUGAL(EXCLUDING MADEIRA),2,JERSEY,FARO,533,533,0,603,0,603,-11.60862
29/01/2018 17:06,2016,1,WESTERN EUROPE-EU,PORTUGAL(EXCLUDING MADEIRA),2,LEEDS BRADFORD,FARO,204802,204802,0,188599,188599,0,8.59124
29/01/2018 17:06,2016,1,WESTERN EUROPE-EU,PORTUGAL(EXCLUDING MADEIRA),2,LIVERPOOL (JOHN LENNON),FARO,176670,176670,0,169490,169490,0,4.23624
29/01/2018 17:06,2016,1,WESTERN EUROPE-EU,PORTUGAL(EXCLUDING MADEIRA),2,LIVERPOOL (JOHN LENNON),LISBON,51433,51433,0,48843,48843,0,5.3027
29/01/2018 17:06,2016,1,WESTERN EUROPE-EU,PORTUGAL(EXCLUDING MADEIRA),2,LIVERPOOL (JOHN LENNON),OPORTO (PORTUGAL),28976,28976,0,23337,23337,0,24.16335
29/01/2018 17:06,2016,1,WESTERN EUROPE-EU,PORTUGAL(EXCLUDING MADEIRA),2,MANCHESTER,FARO,512833,464572,48261,424396,377117,47279,20.83832
29/01/2018 17:06,2016,1,WESTERN EUROPE-EU,PORTUGAL(EXCLUDING MADEIRA),2,MANCHESTER,LISBON,198685,198428,257,187342,186364,978,6.0547
29/01/2018 17:06,2016,1,WESTERN EUROPE-EU,PORTUGAL(EXCLUDING MADEIRA),2,MANCHESTER,OPORTO (PORTUGAL),45892,45892,0,26330,26330,0,74.29548
29/01/2018 17:06,2016,1,WESTERN EUROPE-EU,PORTUGAL(EXCLUDING MADEIRA),2,NEWCASTLE,FARO,121000,121000,0,110283,100985,9298,9.71773
29/01/2018 17:06,2016,1,WESTERN EUROPE-EU,PORTUGAL(EXCLUDING MADEIRA),2,PRESTWICK,FARO,66515,66515,0,55961,55961,0,18.85956
29/01/2018 17:06,2016,1,WESTERN EUROPE-EU,PORTUGAL(EXCLUDING MADEIRA),2,SOUTHAMPTON,FARO,16002,16002,0,27192,27192,0,-41.15181
29/01/2018 17:06,2016,1,WESTERN EUROPE-EU,PORTUGAL(MADEIRA),1,GATWICK,FUNCHAL,301941,262604,39337,229234,207774,21460,31.71737
29/01/2018 17:06,2016,1,WESTERN EUROPE-EU,PORTUGAL(MADEIRA),1,GATWICK,PORTO SANTO,9749,47,9702,9241,0,9241,5.49724
29/01/2018 17:06,2016,1,WESTERN EUROPE-EU,PORTUGAL(MADEIRA),1,HEATHROW,FUNCHAL,0,0,0,9675,9675,0,-100
29/01/2018 17:06,2016,1,WESTERN EUROPE-EU,PORTUGAL(MADEIRA),1,LUTON,FUNCHAL,12515,139,12376,8931,0,8931,40.12988
29/01/2018 17:06,2016,1,WESTERN EUROPE-EU,PORTUGAL(MADEIRA),1,STANSTED,PORTO SANTO,348,348,0,0,0,0,0
29/01/2018 17:06,2016,1,WESTERN EUROPE-EU,PORTUGAL(MADEIRA),2,BIRMINGHAM,FUNCHAL,63065,41026,22039,50339,31251,19088,25.2806
29/01/2018 17:06,2016,1,WESTERN EUROPE-EU,PORTUGAL(MADEIRA),2,BIRMINGHAM,PORTO SANTO,7662,0,7662,6388,0,6388,19.94364
29/01/2018 17:06,2016,1,WESTERN EUROPE-EU,PORTUGAL(MADEIRA),2,BRISTOL,FUNCHAL,37214,37214,0,36106,36106,0,3.06874
29/01/2018 17:06,2016,1,WESTERN EUROPE-EU,PORTUGAL(MADEIRA),2,DONCASTER SHEFFIELD,FUNCHAL,166,166,0,0,0,0,0
29/01/2018 17:06,2016,1,WESTERN EUROPE-EU,PORTUGAL(MADEIRA),2,EAST MIDLANDS INTERNATIONAL,FUNCHAL,28743,13081,15662,28281,10321,17960,1.63361
29/01/2018 17:06,2016,1,WESTERN EUROPE-EU,PORTUGAL(MADEIRA),2,EDINBURGH,FUNCHAL,30659,30659,0,29576,29576,0,3.66175
29/01/2018 17:06,2016,1,WESTERN EUROPE-EU,PORTUGAL(MADEIRA),2,GLASGOW,FUNCHAL,25000,15637,9363,23816,14119,9697,4.97145
29/01/2018 17:06,2016,1,WESTERN EUROPE-EU,PORTUGAL(MADEIRA),2,JERSEY,FUNCHAL,11280,11280,0,10922,2082,8840,3.27779
29/01/2018 17:06,2016,1,WESTERN EUROPE-EU,PORTUGAL(MADEIRA),2,LEEDS BRADFORD,FUNCHAL,17436,17436,0,15405,15405,0,13.18403
29/01/2018 17:06,2016,1,WESTERN EUROPE-EU,PORTUGAL(MADEIRA),2,MANCHESTER,FUNCHAL,114354,78982,35372,71965,53036,18929,58.90224
29/01/2018 17:06,2016,1,WESTERN EUROPE-EU,PORTUGAL(MADEIRA),2,MANCHESTER,PORTO SANTO,9554,0,9554,8750,0,8750,9.18857
29/01/2018 17:06,2016,1,WESTERN EUROPE-EU,PORTUGAL(MADEIRA),2,NEWCASTLE,FUNCHAL,19579,19579,0,15433,6345,9088,26.86451
29/01/2018 17:06,2016,1,WESTERN EUROPE-EU,SLOVENIA,1,GATWICK,LJUBLJANA,10657,10657,0,7547,7547,0,41.20843
29/01/2018 17:06,2016,1,WESTERN EUROPE-EU,SLOVENIA,1,LUTON,LJUBLJANA,63108,62392,716,52729,52212,517,19.68367
29/01/2018 17:06,2016,1,WESTERN EUROPE-EU,SLOVENIA,1,LUTON,MARIBOR,0,0,0,100,0,100,-100
29/01/2018 17:06,2016,1,WESTERN EUROPE-EU,SLOVENIA,1,SOUTHEND,MARIBOR,0,0,0,7087,7087,0,-100
29/01/2018 17:06,2016,1,WESTERN EUROPE-EU,SLOVENIA,1,STANSTED,LJUBLJANA,106704,106616,88,89441,89441,0,19.30099
29/01/2018 17:06,2016,1,WESTERN EUROPE-EU,SLOVENIA,2,ABERDEEN,MARIBOR,329,0,329,0,0,0,0
29/01/2018 17:06,2016,1,WESTERN EUROPE-EU,SLOVENIA,2,BELFAST INTERNATIONAL,LJUBLJANA,113,0,113,0,0,0,0
29/01/2018 17:06,2016,1,WESTERN EUROPE-EU,SLOVENIA,2,GLASGOW,MARIBOR,59,0,59,0,0,0,0
29/01/2018 17:06,2016,1,WESTERN EUROPE-EU,SLOVENIA,2,MANCHESTER,LJUBLJANA,6751,6751,0,6783,6783,0,-0.47177
29/01/2018 17:06,2016,1,WESTERN EUROPE-EU,SLOVENIA,2,SOUTHAMPTON,LJUBLJANA,88,0,88,0,0,0,0
29/01/2018 17:06,2016,1,WESTERN EUROPE-EU,SPAIN,1,GATWICK,A CORUNA,460,460,0,173,173,0,165.89595
29/01/2018 17:06,2016,1,WESTERN EUROPE-EU,SPAIN,1,GATWICK,ALICANTE,824710,783008,41702,768804,736377,32427,7.27181
29/01/2018 17:06,2016,1,WESTERN EUROPE-EU,SPAIN,1,GATWICK,ALMERIA,138558,129611,8947,91544,83148,8396,51.35672
29/01/2018 17:06,2016,1,WESTERN EUROPE-EU,SPAIN,1,GATWICK,ASTURIAS,32516,32516,0,0,0,0,0
29/01/2018 17:06,2016,1,WESTERN EUROPE-EU,SPAIN,1,GATWICK,BARCELONA,1357124,1356606,518,1347990,1347598,392,0.6776
29/01/2018 17:06,2016,1,WESTERN EUROPE-EU,SPAIN,1,GATWICK,BILBAO,95601,95197,404,52925,52177,748,80.63486
29/01/2018 17:06,2016,1,WESTERN EUROPE-EU,SPAIN,1,GATWICK,BURGOS,0,0,0,328,0,328,-100
29/01/2018 17:06,2016,1,WESTERN EUROPE-EU,SPAIN,1,GATWICK,GIRONA,24628,0,24628,20767,0,20767,18.592
29/01/2018 17:06,2016,1,WESTERN EUROPE-EU,SPAIN,1,GATWICK,IBIZA,322802,253066,69736,298099,216852,81247,8.28684
29/01/2018 17:06,2016,1,WESTERN EUROPE-EU,SPAIN,1,GATWICK,JEREZ,9183,0,9183,9192,0,9192,-0.09791
29/01/2018 17:06,2016,1,WESTERN EUROPE-EU,SPAIN,1,GATWICK,LEON,291,0,291,0,0,0,0
29/01/2018 17:06,2016,1,WESTERN EUROPE-EU,SPAIN,1,GATWICK,LIEIDA,11525,0,11525,7055,0,7055,63.35932
29/01/2018 17:06,2016,1,WESTERN EUROPE-EU,SPAIN,1,GATWICK,MADRID,947394,947394,0,933793,933513,280,1.45653
29/01/2018 17:06,2016,1,WESTERN EUROPE-EU,SPAIN,1,GATWICK,MAHON,272783,196013,76770,243513,150196,93317,12.01989
29/01/2018 17:06,2016,1,WESTERN EUROPE-EU,SPAIN,1,GATWICK,MALAGA,1166991,1092744,74247,1061346,1016216,45130,9.95387
29/01/2018 17:06,2016,1,WESTERN EUROPE-EU,SPAIN,1,GATWICK,MURCIA SAN JAVIER,156289,156289,0,131892,131892,0,18.49771
29/01/2018 17:06,2016,1,WESTERN EUROPE-EU,SPAIN,1,GATWICK,PALMA DE MALLORCA,802509,643774,158735,711776,518647,193129,12.74741
29/01/2018 17:06,2016,1,WESTERN EUROPE-EU,SPAIN,1,GATWICK,PAMPLONA,0,0,0,140,0,140,-100
29/01/2018 17:06,2016,1,WESTERN EUROPE-EU,SPAIN,1,GATWICK,REUS,35891,6284,29607,37172,0,37172,-3.44614
29/01/2018 17:06,2016,1,WESTERN EUROPE-EU,SPAIN,1,GATWICK,SANTIAGO DE COMPOSTELA (SPAIN),50305,50305,0,37141,37141,0,35.44331
29/01/2018 17:06,2016,1,WESTERN EUROPE-EU,SPAIN,1,GATWICK,SEVILLE,231310,231310,0,188202,187967,235,22.90518
29/01/2018 17:06,2016,1,WESTERN EUROPE-EU,SPAIN,1,GATWICK,VALENCIA,339366,339306,60,239090,238956,134,41.94069
29/01/2018 17:06,2016,1,WESTERN EUROPE-EU,SPAIN,1,GATWICK,VALLADOLID,0,0,0,363,0,363,-100
29/01/2018 17:06,2016,1,WESTERN EUROPE-EU,SPAIN,1,GATWICK,ZARAGOZA,0,0,0,319,0,319,-100
29/01/2018 17:06,2016,1,WESTERN EUROPE-EU,SPAIN,1,HEATHROW,A CORUNA,105409,105409,0,106154,106154,0,-0.70181
29/01/2018 17:06,2016,1,WESTERN EUROPE-EU,SPAIN,1,HEATHROW,ASTURIAS,23593,23593,0,0,0,0,0
29/01/2018 17:06,2016,1,WESTERN EUROPE-EU,SPAIN,1,HEATHROW,BARCELONA,745963,745452,511,673519,673218,301,10.75604
29/01/2018 17:06,2016,1,WESTERN EUROPE-EU,SPAIN,1,HEATHROW,BILBAO,186350,186350,0,157657,157657,0,18.19964
29/01/2018 17:06,2016,1,WESTERN EUROPE-EU,SPAIN,1,HEATHROW,IBIZA,40775,40775,0,37479,37479,0,8.79426
29/01/2018 17:06,2016,1,WESTERN EUROPE-EU,SPAIN,1,HEATHROW,MADRID,1317122,1317122,0,1321558,1321558,0,-0.33566
29/01/2018 17:06,2016,1,WESTERN EUROPE-EU,SPAIN,1,HEATHROW,MAHON,23121,23121,0,0,0,0,0
29/01/2018 17:06,2016,1,WESTERN EUROPE-EU,SPAIN,1,HEATHROW,MALAGA,19951,19951,0,19514,19514,0,2.23942
29/01/2018 17:06,2016,1,WESTERN EUROPE-EU,SPAIN,1,HEATHROW,PALMA DE MALLORCA,122474,122474,0,123584,123584,0,-0.89817
29/01/2018 17:06,2016,1,WESTERN EUROPE-EU,SPAIN,1,HEATHROW,SANTIAGO DE COMPOSTELA (SPAIN),149,149,0,0,0,0,0
29/01/2018 17:06,2016,1,WESTERN EUROPE-EU,SPAIN,1,LONDON CITY,ALICANTE,6343,6343,0,0,0,0,0
29/01/2018 17:06,2016,1,WESTERN EUROPE-EU,SPAIN,1,LONDON CITY,GRANADA,18365,18365,0,19550,19550,0,-6.06138
29/01/2018 17:06,2016,1,WESTERN EUROPE-EU,SPAIN,1,LONDON CITY,IBIZA,88376,88376,0,75593,75593,0,16.9103
29/01/2018 17:06,2016,1,WESTERN EUROPE-EU,SPAIN,1,LONDON CITY,MADRID,70900,70818,82,83855,83855,0,-15.44929
29/01/2018 17:06,2016,1,WESTERN EUROPE-EU,SPAIN,1,LONDON CITY,MAHON,2553,2553,0,4899,4899,0,-47.88732
29/01/2018 17:06,2016,1,WESTERN EUROPE-EU,SPAIN,1,LONDON CITY,MALAGA,57772,57772,0,51879,51879,0,11.35912
29/01/2018 17:06,2016,1,WESTERN EUROPE-EU,SPAIN,1,LONDON CITY,PALMA DE MALLORCA,37562,37562,0,34479,34479,0,8.94167
29/01/2018 17:06,2016,1,WESTERN EUROPE-EU,SPAIN,1,LUTON,ALICANTE,236862,236862,0,212983,212886,97,11.21169
29/01/2018 17:06,2016,1,WESTERN EUROPE-EU,SPAIN,1,LUTON,ALMERIA,0,0,0,48,0,48,-100
29/01/2018 17:06,2016,1,WESTERN EUROPE-EU,SPAIN,1,LUTON,ASTURIAS,31,31,0,0,0,0,0
29/01/2018 17:06,2016,1,WESTERN EUROPE-EU,SPAIN,1,LUTON,BARCELONA,367189,366387,802,181503,181317,186,102.30465
29/01/2018 17:06,2016,1,WESTERN EUROPE-EU,SPAIN,1,LUTON,BILBAO,34,0,34,0,0,0,0
29/01/2018 17:06,2016,1,WESTERN EUROPE-EU,SPAIN,1,LUTON,CASTELLON COSTA AZAHAR,12,0,12,0,0,0,0
29/01/2018 17:06,2016,1,WESTERN EUROPE-EU,SPAIN,1,LUTON,GIRONA,54397,54397,0,45906,45886,20,18.49649
29/01/2018 17:06,2016,1,WESTERN EUROPE-EU,SPAIN,1,LUTON,GRANADA,181,0,181,0,0,0,0
29/01/2018 17:06,2016,1,WESTERN EUROPE-EU,SPAIN,1,LUTON,IBIZA,58239,39627,18612,54774,36188,18586,6.32599
29/01/2018 17:06,2016,1,WESTERN EUROPE-EU,SPAIN,1,LUTON,JEREZ,0,0,0,312,0,312,-100
29/01/2018 17:06,2016,1,WESTERN EUROPE-EU,SPAIN,1,LUTON,MADRID,132631,132353,278,139233,139231,2,-4.74169
29/01/2018 17:06,2016,1,WESTERN EUROPE-EU,SPAIN,1,LUTON,MAHON,89441,71355,18086,81683,61995,19688,9.49769
29/01/2018 17:06,2016,1,WESTERN EUROPE-EU,SPAIN,1,LUTON,MALAGA,304038,281615,22423,254198,245094,9104,19.60676
29/01/2018 17:06,2016,1,WESTERN EUROPE-EU,SPAIN,1,LUTON,MURCIA SAN JAVIER,88598,88598,0,74147,74147,0,19.48966
29/01/2018 17:06,2016,1,WESTERN EUROPE-EU,SPAIN,1,LUTON,PALMA DE MALLORCA,284387,226043,58344,246102,197080,49022,15.55656
29/01/2018 17:06,2016,1,WESTERN EUROPE-EU,SPAIN,1,LUTON,REUS,9177,0,9177,13159,0,13159,-30.26066
29/01/2018 17:06,2016,1,WESTERN EUROPE-EU,SPAIN,1,LUTON,SAN SEBASTIAN,719,719,0,0,0,0,0
29/01/2018 17:06,2016,1,WESTERN EUROPE-EU,SPAIN,1,LUTON,SEVILLE,0,0,0,47,0,47,-100
29/01/2018 17:06,2016,1,WESTERN EUROPE-EU,SPAIN,1,LUTON,VALENCIA,79,0,79,0,0,0,0
29/01/2018 17:06,2016,1,WESTERN EUROPE-EU,SPAIN,1,LUTON,VIGO,3227,3227,0,3232,2918,314,-0.1547
29/01/2018 17:06,2016,1,WESTERN EUROPE-EU,SPAIN,1,LUTON,VITORIA,0,0,0,55,0,55,-100
29/01/2018 17:06,2016,1,WESTERN EUROPE-EU,SPAIN,1,SOUTHEND,ALICANTE,100308,100308,0,98759,98759,0,1.56846
29/01/2018 17:06,2016,1,WESTERN EUROPE-EU,SPAIN,1,SOUTHEND,BARCELONA,43158,43158,0,59826,59826,0,-27.8608
29/01/2018 17:06,2016,1,WESTERN EUROPE-EU,SPAIN,1,SOUTHEND,IBIZA,20962,20962,0,19237,19237,0,8.96709
29/01/2018 17:06,2016,1,WESTERN EUROPE-EU,SPAIN,1,SOUTHEND,MADRID,53,53,0,0,0,0,0
29/01/2018 17:06,2016,1,WESTERN EUROPE-EU,SPAIN,1,SOUTHEND,MAHON,8493,8493,0,4762,4762,0,78.34943
29/01/2018 17:06,2016,1,WESTERN EUROPE-EU,SPAIN,1,SOUTHEND,MALAGA,81736,81736,0,81673,81673,0,0.07714
29/01/2018 17:06,2016,1,WESTERN EUROPE-EU,SPAIN,1,SOUTHEND,PALMA DE MALLORCA,52934,52934,0,45058,39722,5336,17.47969
29/01/2018 17:06,2016,1,WESTERN EUROPE-EU,SPAIN,1,STANSTED,ALICANTE,234052,234052,0,224251,224251,0,4.37055
29/01/2018 17:06,2016,1,WESTERN EUROPE-EU,SPAIN,1,STANSTED,ALMERIA,27450,27450,0,23441,23441,0,17.10251
29/01/2018 17:06,2016,1,WESTERN EUROPE-EU,SPAIN,1,STANSTED,ASTURIAS,80141,80141,0,84925,84925,0,-5.63321
29/01/2018 17:06,2016,1,WESTERN EUROPE-EU,SPAIN,1,STANSTED,BARCELONA,508076,506726,1350,490068,490068,0,3.67459
29/01/2018 17:06,2016,1,WESTERN EUROPE-EU,SPAIN,1,STANSTED,BILBAO,131520,131520,0,140191,140191,0,-6.18513
29/01/2018 17:06,2016,1,WESTERN EUROPE-EU,SPAIN,1,STANSTED,CASTELLON COSTA AZAHAR,14356,14356,0,0,0,0,0
29/01/2018 17:06,2016,1,WESTERN EUROPE-EU,SPAIN,1,STANSTED,CASTELLON DE LA PLANA AIRPORT,36310,36310,0,15196,15196,0,138.94446
29/01/2018 17:06,2016,1,WESTERN EUROPE-EU,SPAIN,1,STANSTED,GIRONA,59058,59058,0,56053,56053,0,5.361
29/01/2018 17:06,2016,1,WESTERN EUROPE-EU,SPAIN,1,STANSTED,GRANADA,0,0,0,339,0,339,-100
29/01/2018 17:06,2016,1,WESTERN EUROPE-EU,SPAIN,1,STANSTED,IBIZA,251136,227033,24103,201501,171659,29842,24.63263
29/01/2018 17:06,2016,1,WESTERN EUROPE-EU,SPAIN,1,STANSTED,JEREZ,53527,53527,0,46036,46036,0,16.27205
29/01/2018 17:06,2016,1,WESTERN EUROPE-EU,SPAIN,1,STANSTED,LEON,332,0,332,143,0,143,132.16783
29/01/2018 17:06,2016,1,WESTERN EUROPE-EU,SPAIN,1,STANSTED,MADRID,499574,499574,0,453641,453528,113,10.12541
29/01/2018 17:06,2016,1,WESTERN EUROPE-EU,SPAIN,1,STANSTED,MAHON,38631,19765,18866,34359,0,34359,12.43342
29/01/2018 17:06,2016,1,WESTERN EUROPE-EU,SPAIN,1,STANSTED,MALAGA,398718,398290,428,356908,356908,0,11.7145
29/01/2018 17:06,2016,1,WESTERN EUROPE-EU,SPAIN,1,STANSTED,MURCIA SAN JAVIER,137691,137691,0,133273,133273,0,3.315
29/01/2018 17:06,2016,1,WESTERN EUROPE-EU,SPAIN,1,STANSTED,PALMA DE MALLORCA,371741,340373,31368,320455,274141,46314,16.00412
29/01/2018 17:06,2016,1,WESTERN EUROPE-EU,SPAIN,1,STANSTED,REUS,52929,52575,354,56437,56031,406,-6.21578
29/01/2018 17:06,2016,1,WESTERN EUROPE-EU,SPAIN,1,STANSTED,SALAMANCA,165,0,165,0,0,0,0
29/01/2018 17:06,2016,1,WESTERN EUROPE-EU,SPAIN,1,STANSTED,SANTANDER,80455,80455,0,99533,99533,0,-19.16751
29/01/2018 17:06,2016,1,WESTERN EUROPE-EU,SPAIN,1,STANSTED,SANTIAGO DE COMPOSTELA (SPAIN),79422,79422,0,74871,74871,0,6.07845
29/01/2018 17:06,2016,1,WESTERN EUROPE-EU,SPAIN,1,STANSTED,SEVILLE,137278,137278,0,131032,131032,0,4.76677
29/01/2018 17:06,2016,1,WESTERN EUROPE-EU,SPAIN,1,STANSTED,VALENCIA,129668,129668,0,122515,122494,21,5.83847
29/01/2018 17:06,2016,1,WESTERN EUROPE-EU,SPAIN,1,STANSTED,VALLADOLID,1274,0,1274,0,0,0,0
29/01/2018 17:06,2016,1,WESTERN EUROPE-EU,SPAIN,1,STANSTED,ZARAGOZA,86109,86109,0,85576,85576,0,0.62284
29/01/2018 17:06,2016,1,WESTERN EUROPE-EU,SPAIN,2,ABERDEEN,IBIZA,5643,0,5643,5519,0,5519,2.24678
29/01/2018 17:06,2016,1,WESTERN EUROPE-EU,SPAIN,2,ABERDEEN,MALAGA,4204,0,4204,4246,0,4246,-0.98917
29/01/2018 17:06,2016,1,WESTERN EUROPE-EU,SPAIN,2,ABERDEEN,PALMA DE MALLORCA,28402,86,28316,28163,0,28163,0.84863
29/01/2018 17:06,2016,1,WESTERN EUROPE-EU,SPAIN,2,ABERDEEN,REUS,2666,0,2666,3025,0,3025,-11.86777
29/01/2018 17:06,2016,1,WESTERN EUROPE-EU,SPAIN,2,BELFAST CITY (GEORGE BEST),ALICANTE,28669,28669,0,0,0,0,0
29/01/2018 17:06,2016,1,WESTERN EUROPE-EU,SPAIN,2,BELFAST CITY (GEORGE BEST),BARCELONA,146,146,0,10456,10456,0,-98.60367
29/01/2018 17:06,2016,1,WESTERN EUROPE-EU,SPAIN,2,BELFAST CITY (GEORGE BEST),MALAGA,67618,67618,0,54456,54300,156,24.16997
29/01/2018 17:06,2016,1,WESTERN EUROPE-EU,SPAIN,2,BELFAST CITY (GEORGE BEST),PALMA DE MALLORCA,29135,29135,0,11480,11480,0,153.7892
29/01/2018 17:06,2016,1,WESTERN EUROPE-EU,SPAIN,2,BELFAST INTERNATIONAL,ALICANTE,153691,153691,0,114865,114865,0,33.80142
29/01/2018 17:06,2016,1,WESTERN EUROPE-EU,SPAIN,2,BELFAST INTERNATIONAL,ALMERIA,0,0,0,45,0,45,-100
29/01/2018 17:06,2016,1,WESTERN EUROPE-EU,SPAIN,2,BELFAST INTERNATIONAL,BADAJOZ,101,0,101,0,0,0,0
29/01/2018 17:06,2016,1,WESTERN EUROPE-EU,SPAIN,2,BELFAST INTERNATIONAL,BARCELONA,35491,35491,0,37924,37805,119,-6.41546
29/01/2018 17:06,2016,1,WESTERN EUROPE-EU,SPAIN,2,BELFAST INTERNATIONAL,BILBAO,60,0,60,0,0,0,0
29/01/2018 17:06,2016,1,WESTERN EUROPE-EU,SPAIN,2,BELFAST INTERNATIONAL,GIRONA,0,0,0,61,0,61,-100
29/01/2018 17:06,2016,1,WESTERN EUROPE-EU,SPAIN,2,BELFAST INTERNATIONAL,IBIZA,28425,21357,7068,30514,15282,15232,-6.84604
29/01/2018 17:06,2016,1,WESTERN EUROPE-EU,SPAIN,2,BELFAST INTERNATIONAL,LEON,157,0,157,0,0,0,0
29/01/2018 17:06,2016,1,WESTERN EUROPE-EU,SPAIN,2,BELFAST INTERNATIONAL,MADRID,0,0,0,170,0,170,-100
29/01/2018 17:06,2016,1,WESTERN EUROPE-EU,SPAIN,2,BELFAST INTERNATIONAL,MAHON,11485,4823,6662,11403,4825,6578,0.71911
29/01/2018 17:06,2016,1,WESTERN EUROPE-EU,SPAIN,2,BELFAST INTERNATIONAL,MALAGA,130342,122867,7475,117770,110258,7512,10.67504
29/01/2018 17:06,2016,1,WESTERN EUROPE-EU,SPAIN,2,BELFAST INTERNATIONAL,MURCIA SAN JAVIER,9990,9990,0,16204,16204,0,-38.34856
29/01/2018 17:06,2016,1,WESTERN EUROPE-EU,SPAIN,2,BELFAST INTERNATIONAL,PALMA DE MALLORCA,147410,108872,38538,137405,98040,39365,7.28139
29/01/2018 17:06,2016,1,WESTERN EUROPE-EU,SPAIN,2,BELFAST INTERNATIONAL,REUS,52480,16265,36215,36304,11077,25227,44.55707
29/01/2018 17:06,2016,1,WESTERN EUROPE-EU,SPAIN,2,BELFAST INTERNATIONAL,SALAMANCA,157,0,157,0,0,0,0
29/01/2018 17:06,2016,1,WESTERN EUROPE-EU,SPAIN,2,BELFAST INTERNATIONAL,SANTIAGO DE COMPOSTELA (SPAIN),118,118,0,0,0,0,0
29/01/2018 17:06,2016,1,WESTERN EUROPE-EU,SPAIN,2,BELFAST INTERNATIONAL,VALLADOLID,614,0,614,0,0,0,0
29/01/2018 17:06,2016,1,WESTERN EUROPE-EU,SPAIN,2,BIRMINGHAM,ALICANTE,365236,324798,40438,301301,269281,32020,21.21964
29/01/2018 17:06,2016,1,WESTERN EUROPE-EU,SPAIN,2,BIRMINGHAM,ALMERIA,17732,17732,0,7924,0,7924,123.77587
29/01/2018 17:06,2016,1,WESTERN EUROPE-EU,SPAIN,2,BIRMINGHAM,BARCELONA,308260,307174,1086,197491,197311,180,56.08813
29/01/2018 17:06,2016,1,WESTERN EUROPE-EU,SPAIN,2,BIRMINGHAM,BILBAO,196,0,196,0,0,0,0
29/01/2018 17:06,2016,1,WESTERN EUROPE-EU,SPAIN,2,BIRMINGHAM,GIRONA,15358,0,15358,6487,0,6487,136.75042
29/01/2018 17:06,2016,1,WESTERN EUROPE-EU,SPAIN,2,BIRMINGHAM,GRANADA,0,0,0,813,0,813,-100
29/01/2018 17:06,2016,1,WESTERN EUROPE-EU,SPAIN,2,BIRMINGHAM,IBIZA,96329,49959,46370,81163,38078,43085,18.68585
29/01/2018 17:06,2016,1,WESTERN EUROPE-EU,SPAIN,2,BIRMINGHAM,LIEIDA,2303,0,2303,2312,0,2312,-0.38927
29/01/2018 17:06,2016,1,WESTERN EUROPE-EU,SPAIN,2,BIRMINGHAM,MADRID,135905,135905,0,32791,32791,0,314.45824
29/01/2018 17:06,2016,1,WESTERN EUROPE-EU,SPAIN,2,BIRMINGHAM,MAHON,68117,48635,19482,79344,32819,46525,-14.14978
29/01/2018 17:06,2016,1,WESTERN EUROPE-EU,SPAIN,2,BIRMINGHAM,MALAGA,383593,351456,32137,295465,285965,9500,29.82688
29/01/2018 17:06,2016,1,WESTERN EUROPE-EU,SPAIN,2,BIRMINGHAM,MURCIA SAN JAVIER,51527,51527,0,43290,43290,0,19.02749
29/01/2018 17:06,2016,1,WESTERN EUROPE-EU,SPAIN,2,BIRMINGHAM,PALMA DE MALLORCA,356427,257072,99355,254763,144722,110041,39.90532
29/01/2018 17:06,2016,1,WESTERN EUROPE-EU,SPAIN,2,BIRMINGHAM,REUS,20244,0,20244,23860,0,23860,-15.15507
29/01/2018 17:06,2016,1,WESTERN EUROPE-EU,SPAIN,2,BIRMINGHAM,SEVILLE,0,0,0,233,0,233,-100
29/01/2018 17:06,2016,1,WESTERN EUROPE-EU,SPAIN,2,BIRMINGHAM,VALENCIA,0,0,0,158,0,158,-100
29/01/2018 17:06,2016,1,WESTERN EUROPE-EU,SPAIN,2,BIRMINGHAM,VITORIA,0,0,0,36,0,36,-100
29/01/2018 17:06,2016,1,WESTERN EUROPE-EU,SPAIN,2,BOURNEMOUTH,ALICANTE,64912,64819,93,59211,59211,0,9.62828
29/01/2018 17:06,2016,1,WESTERN EUROPE-EU,SPAIN,2,BOURNEMOUTH,BARCELONA,36,0,36,0,0,0,0
29/01/2018 17:06,2016,1,WESTERN EUROPE-EU,SPAIN,2,BOURNEMOUTH,GIRONA,43831,43831,0,41544,41544,0,5.50501
29/01/2018 17:06,2016,1,WESTERN EUROPE-EU,SPAIN,2,BOURNEMOUTH,IBIZA,8959,0,8959,8933,0,8933,0.29106
29/01/2018 17:06,2016,1,WESTERN EUROPE-EU,SPAIN,2,BOURNEMOUTH,MAHON,8325,0,8325,7848,0,7848,6.07798
29/01/2018 17:06,2016,1,WESTERN EUROPE-EU,SPAIN,2,BOURNEMOUTH,MALAGA,83746,83746,0,66422,66422,0,26.08172
29/01/2018 17:06,2016,1,WESTERN EUROPE-EU,SPAIN,2,BOURNEMOUTH,MURCIA SAN JAVIER,42558,42558,0,52066,52066,0,-18.26144
29/01/2018 17:06,2016,1,WESTERN EUROPE-EU,SPAIN,2,BOURNEMOUTH,PALMA DE MALLORCA,114694,74635,40059,102678,64143,38535,11.7026
29/01/2018 17:06,2016,1,WESTERN EUROPE-EU,SPAIN,2,BRISTOL,ALICANTE,313420,298799,14621,271540,257067,14473,15.42314
29/01/2018 17:06,2016,1,WESTERN EUROPE-EU,SPAIN,2,BRISTOL,BARCELONA,151618,151358,260,132045,132045,0,14.82298
29/01/2018 17:06,2016,1,WESTERN EUROPE-EU,SPAIN,2,BRISTOL,BILBAO,14450,14450,0,14421,14421,0,0.2011
29/01/2018 17:06,2016,1,WESTERN EUROPE-EU,SPAIN,2,BRISTOL,CASTELLON DE LA PLANA AIRPORT,19102,19102,0,4282,4282,0,346.09995
29/01/2018 17:06,2016,1,WESTERN EUROPE-EU,SPAIN,2,BRISTOL,GIRONA,59769,59769,0,59342,59342,0,0.71956
29/01/2018 17:06,2016,1,WESTERN EUROPE-EU,SPAIN,2,BRISTOL,IBIZA,97088,58421,38667,67363,32013,35350,44.1266
29/01/2018 17:06,2016,1,WESTERN EUROPE-EU,SPAIN,2,BRISTOL,LIEIDA,0,0,0,2140,0,2140,-100
29/01/2018 17:06,2016,1,WESTERN EUROPE-EU,SPAIN,2,BRISTOL,MADRID,102379,102379,0,81410,81082,328,25.75728
29/01/2018 17:06,2016,1,WESTERN EUROPE-EU,SPAIN,2,BRISTOL,MAHON,58076,39325,18751,56432,15972,40460,2.91324
29/01/2018 17:06,2016,1,WESTERN EUROPE-EU,SPAIN,2,BRISTOL,MALAGA,337450,309660,27790,299986,281559,18427,12.48858
29/01/2018 17:06,2016,1,WESTERN EUROPE-EU,SPAIN,2,BRISTOL,MURCIA SAN JAVIER,72771,72771,0,67877,67877,0,7.2101
29/01/2018 17:06,2016,1,WESTERN EUROPE-EU,SPAIN,2,BRISTOL,PALMA DE MALLORCA,340262,300453,39809,288943,221004,67939,17.76094
29/01/2018 17:06,2016,1,WESTERN EUROPE-EU,SPAIN,2,BRISTOL,REUS,22966,12291,10675,11320,0,11320,102.87986
29/01/2018 17:06,2016,1,WESTERN EUROPE-EU,SPAIN,2,BRISTOL,SALAMANCA,0,0,0,159,0,159,-100
29/01/2018 17:06,2016,1,WESTERN EUROPE-EU,SPAIN,2,BRISTOL,VALENCIA,0,0,0,17194,17194,0,-100
29/01/2018 17:06,2016,1,WESTERN EUROPE-EU,SPAIN,2,BRISTOL,VALLADOLID,0,0,0,503,0,503,-100
29/01/2018 17:06,2016,1,WESTERN EUROPE-EU,SPAIN,2,CARDIFF WALES,A CORUNA,0,0,0,43,0,43,-100
29/01/2018 17:06,2016,1,WESTERN EUROPE-EU,SPAIN,2,CARDIFF WALES,ALICANTE,93424,55061,38363,78110,40773,37337,19.60568
29/01/2018 17:06,2016,1,WESTERN EUROPE-EU,SPAIN,2,CARDIFF WALES,BARCELONA,30690,30636,54,19813,19813,0,54.8983
29/01/2018 17:06,2016,1,WESTERN EUROPE-EU,SPAIN,2,CARDIFF WALES,IBIZA,34974,0,34974,31385,0,31385,11.4354
29/01/2018 17:06,2016,1,WESTERN EUROPE-EU,SPAIN,2,CARDIFF WALES,MAHON,21080,0,21080,15039,0,15039,40.16889
29/01/2018 17:06,2016,1,WESTERN EUROPE-EU,SPAIN,2,CARDIFF WALES,MALAGA,82596,52121,30475,67920,40116,27804,21.60777
29/01/2018 17:06,2016,1,WESTERN EUROPE-EU,SPAIN,2,CARDIFF WALES,PALMA DE MALLORCA,109021,29973,79048,78579,15730,62849,38.74063
29/01/2018 17:06,2016,1,WESTERN EUROPE-EU,SPAIN,2,CARDIFF WALES,REUS,16389,0,16389,21125,0,21125,-22.41893
29/01/2018 17:06,2016,1,WESTERN EUROPE-EU,SPAIN,2,CITY OF DERRY (EGLINTON),ALICANTE,0,0,0,4152,4152,0,-100
29/01/2018 17:06,2016,1,WESTERN EUROPE-EU,SPAIN,2,DONCASTER SHEFFIELD,ALICANTE,79512,22977,56535,38311,0,38311,107.54353
29/01/2018 17:06,2016,1,WESTERN EUROPE-EU,SPAIN,2,DONCASTER SHEFFIELD,BARCELONA,133,0,133,0,0,0,0
29/01/2018 17:06,2016,1,WESTERN EUROPE-EU,SPAIN,2,DONCASTER SHEFFIELD,IBIZA,16552,0,16552,19533,0,19533,-15.26135
29/01/2018 17:06,2016,1,WESTERN EUROPE-EU,SPAIN,2,DONCASTER SHEFFIELD,MAHON,17276,0,17276,15845,0,15845,9.03124
29/01/2018 17:06,2016,1,WESTERN EUROPE-EU,SPAIN,2,DONCASTER SHEFFIELD,MALAGA,57148,21068,36080,38495,0,38495,48.45564
29/01/2018 17:06,2016,1,WESTERN EUROPE-EU,SPAIN,2,DONCASTER SHEFFIELD,PALMA DE MALLORCA,65330,0,65330,56609,0,56609,15.40568
29/01/2018 17:06,2016,1,WESTERN EUROPE-EU,SPAIN,2,DONCASTER SHEFFIELD,REUS,9513,0,9513,9478,0,9478,0.36928
29/01/2018 17:06,2016,1,WESTERN EUROPE-EU,SPAIN,2,DURHAM TEES VALLEY,ALBACETE,0,0,0,199,0,199,-100
29/01/2018 17:06,2016,1,WESTERN EUROPE-EU,SPAIN,2,DURHAM TEES VALLEY,MALAGA,147,0,147,35,0,35,320
29/01/2018 17:06,2016,1,WESTERN EUROPE-EU,SPAIN,2,EAST MIDLANDS INTERNATIONAL,ALICANTE,391061,359588,31473,379415,347983,31432,3.06946
29/01/2018 17:06,2016,1,WESTERN EUROPE-EU,SPAIN,2,EAST MIDLANDS INTERNATIONAL,BARCELONA,88714,88332,382,80915,80850,65,9.63851
29/01/2018 17:06,2016,1,WESTERN EUROPE-EU,SPAIN,2,EAST MIDLANDS INTERNATIONAL,BILBAO,150,150,0,0,0,0,0
29/01/2018 17:06,2016,1,WESTERN EUROPE-EU,SPAIN,2,EAST MIDLANDS INTERNATIONAL,IBIZA,116890,85845,31045,101118,67847,33271,15.59762
29/01/2018 17:06,2016,1,WESTERN EUROPE-EU,SPAIN,2,EAST MIDLANDS INTERNATIONAL,MADRID,304,304,0,0,0,0,0
29/01/2018 17:06,2016,1,WESTERN EUROPE-EU,SPAIN,2,EAST MIDLANDS INTERNATIONAL,MAHON,75996,59605,16391,79100,42355,36745,-3.92415
29/01/2018 17:06,2016,1,WESTERN EUROPE-EU,SPAIN,2,EAST MIDLANDS INTERNATIONAL,MALAGA,308964,276091,32873,275056,256157,18899,12.32767
29/01/2018 17:06,2016,1,WESTERN EUROPE-EU,SPAIN,2,EAST MIDLANDS INTERNATIONAL,MURCIA SAN JAVIER,87386,87386,0,92507,92507,0,-5.5358
29/01/2018 17:06,2016,1,WESTERN EUROPE-EU,SPAIN,2,EAST MIDLANDS INTERNATIONAL,PALMA DE MALLORCA,340103,273990,66113,326998,225694,101304,4.00767
29/01/2018 17:06,2016,1,WESTERN EUROPE-EU,SPAIN,2,EAST MIDLANDS INTERNATIONAL,REUS,17092,16807,285,10699,10699,0,59.75325
29/01/2018 17:06,2016,1,WESTERN EUROPE-EU,SPAIN,2,EAST MIDLANDS INTERNATIONAL,VALENCIA,34223,34223,0,32586,32586,0,5.02363
29/01/2018 17:06,2016,1,WESTERN EUROPE-EU,SPAIN,2,EDINBURGH,ALICANTE,206991,206991,0,150000,150000,0,37.994
29/01/2018 17:06,2016,1,WESTERN EUROPE-EU,SPAIN,2,EDINBURGH,BARCELONA,181033,177517,3516,121895,119313,2582,48.51553
29/01/2018 17:06,2016,1,WESTERN EUROPE-EU,SPAIN,2,EDINBURGH,BILBAO,324,0,324,0,0,0,0
29/01/2018 17:06,2016,1,WESTERN EUROPE-EU,SPAIN,2,EDINBURGH,IBIZA,29744,20955,8789,25248,13272,11976,17.80735
29/01/2018 17:06,2016,1,WESTERN EUROPE-EU,SPAIN,2,EDINBURGH,MADRID,185545,183149,2396,162499,157591,4908,14.18224
29/01/2018 17:06,2016,1,WESTERN EUROPE-EU,SPAIN,2,EDINBURGH,MAHON,13884,9136,4748,10838,5874,4964,28.10482
29/01/2018 17:06,2016,1,WESTERN EUROPE-EU,SPAIN,2,EDINBURGH,MALAGA,183032,183032,0,148992,148992,0,22.84686
29/01/2018 17:06,2016,1,WESTERN EUROPE-EU,SPAIN,2,EDINBURGH,MURCIA SAN JAVIER,0,0,0,17072,17072,0,-100
29/01/2018 17:06,2016,1,WESTERN EUROPE-EU,SPAIN,2,EDINBURGH,PALMA DE MALLORCA,183518,145028,38490,157056,111791,45265,16.84877
29/01/2018 17:06,2016,1,WESTERN EUROPE-EU,SPAIN,2,EDINBURGH,PAMPLONA,0,0,0,551,0,551,-100
29/01/2018 17:06,2016,1,WESTERN EUROPE-EU,SPAIN,2,EDINBURGH,REUS,14774,14774,0,7819,7819,0,88.94999
29/01/2018 17:06,2016,1,WESTERN EUROPE-EU,SPAIN,2,EDINBURGH,SANTANDER,36278,36278,0,30013,30013,0,20.87429
29/01/2018 17:06,2016,1,WESTERN EUROPE-EU,SPAIN,2,EXETER,ALICANTE,27620,27620,0,22147,22147,0,24.71215
29/01/2018 17:06,2016,1,WESTERN EUROPE-EU,SPAIN,2,EXETER,IBIZA,8835,0,8835,8805,0,8805,0.34072
29/01/2018 17:06,2016,1,WESTERN EUROPE-EU,SPAIN,2,EXETER,MAHON,16942,0,16942,16273,0,16273,4.1111
29/01/2018 17:06,2016,1,WESTERN EUROPE-EU,SPAIN,2,EXETER,MALAGA,27335,27335,0,22478,22339,139,21.60779
29/01/2018 17:06,2016,1,WESTERN EUROPE-EU,SPAIN,2,EXETER,PALMA DE MALLORCA,52319,10032,42287,49179,11484,37695,6.38484
29/01/2018 17:06,2016,1,WESTERN EUROPE-EU,SPAIN,2,EXETER,VITORIA,0,0,0,10,0,10,-100
29/01/2018 17:06,2016,1,WESTERN EUROPE-EU,SPAIN,2,GLASGOW,ALICANTE,233184,198738,34446,190522,160332,30190,22.39216
29/01/2018 17:06,2016,1,WESTERN EUROPE-EU,SPAIN,2,GLASGOW,ALMERIA,6063,3366,2697,0,0,0,0
29/01/2018 17:06,2016,1,WESTERN EUROPE-EU,SPAIN,2,GLASGOW,BARCELONA,40724,36828,3896,35961,32525,3436,13.2449
29/01/2018 17:06,2016,1,WESTERN EUROPE-EU,SPAIN,2,GLASGOW,BILBAO,0,0,0,101,0,101,-100
29/01/2018 17:06,2016,1,WESTERN EUROPE-EU,SPAIN,2,GLASGOW,GIRONA,20831,11804,9027,0,0,0,0
29/01/2018 17:06,2016,1,WESTERN EUROPE-EU,SPAIN,2,GLASGOW,GRANADA,0,0,0,90,0,90,-100
29/01/2018 17:06,2016,1,WESTERN EUROPE-EU,SPAIN,2,GLASGOW,IBIZA,79567,48560,31007,81065,34813,46252,-1.8479
29/01/2018 17:06,2016,1,WESTERN EUROPE-EU,SPAIN,2,GLASGOW,MADRID,126,0,126,704,0,704,-82.10227
29/01/2018 17:06,2016,1,WESTERN EUROPE-EU,SPAIN,2,GLASGOW,MAHON,32835,20521,12314,33425,12234,21191,-1.76515
29/01/2018 17:06,2016,1,WESTERN EUROPE-EU,SPAIN,2,GLASGOW,MALAGA,187604,156887,30717,165154,141958,23196,13.59337
29/01/2018 17:06,2016,1,WESTERN EUROPE-EU,SPAIN,2,GLASGOW,MURCIA SAN JAVIER,0,0,0,11130,11130,0,-100
29/01/2018 17:06,2016,1,WESTERN EUROPE-EU,SPAIN,2,GLASGOW,PALMA DE MALLORCA,225687,134627,91060,214190,91138,123052,5.36766
29/01/2018 17:06,2016,1,WESTERN EUROPE-EU,SPAIN,2,GLASGOW,REUS,76642,31930,44712,52416,13232,39184,46.21871
29/01/2018 17:06,2016,1,WESTERN EUROPE-EU,SPAIN,2,GLASGOW,SANTANDER,0,0,0,67,0,67,-100
29/01/2018 17:06,2016,1,WESTERN EUROPE-EU,SPAIN,2,GLASGOW,VALENCIA,80,0,80,840,0,840,-90.47619
29/01/2018 17:06,2016,1,WESTERN EUROPE-EU,SPAIN,2,GUERNSEY,BARCELONA,628,628,0,0,0,0,0
29/01/2018 17:06,2016,1,WESTERN EUROPE-EU,SPAIN,2,HUMBERSIDE,ALICANTE,1130,0,1130,1384,0,1384,-18.3526
29/01/2018 17:06,2016,1,WESTERN EUROPE-EU,SPAIN,2,HUMBERSIDE,BARCELONA,84,0,84,335,0,335,-74.92537
29/01/2018 17:06,2016,1,WESTERN EUROPE-EU,SPAIN,2,HUMBERSIDE,MADRID,62,0,62,0,0,0,0
29/01/2018 17:06,2016,1,WESTERN EUROPE-EU,SPAIN,2,HUMBERSIDE,PALMA DE MALLORCA,7933,0,7933,8262,0,8262,-3.98209
29/01/2018 17:06,2016,1,WESTERN EUROPE-EU,SPAIN,2,ISLE OF MAN,ALICANTE,0,0,0,225,0,225,-100
29/01/2018 17:06,2016,1,WESTERN EUROPE-EU,SPAIN,2,ISLE OF MAN,MAHON,0,0,0,803,803,0,-100
29/01/2018 17:06,2016,1,WESTERN EUROPE-EU,SPAIN,2,ISLE OF MAN,PALMA DE MALLORCA,0,0,0,2283,0,2283,-100
29/01/2018 17:06,2016,1,WESTERN EUROPE-EU,SPAIN,2,JERSEY,BARCELONA,248,124,124,171,0,171,45.02924
29/01/2018 17:06,2016,1,WESTERN EUROPE-EU,SPAIN,2,JERSEY,MALAGA,763,763,0,699,699,0,9.15594
29/01/2018 17:06,2016,1,WESTERN EUROPE-EU,SPAIN,2,JERSEY,PALMA DE MALLORCA,4240,112,4128,3695,981,2714,14.74966
29/01/2018 17:06,2016,1,WESTERN EUROPE-EU,SPAIN,2,LEEDS BRADFORD,ALICANTE,311650,311650,0,272104,272104,0,14.53341
29/01/2018 17:06,2016,1,WESTERN EUROPE-EU,SPAIN,2,LEEDS BRADFORD,BARCELONA,90035,90035,0,76461,76461,0,17.75284
29/01/2018 17:06,2016,1,WESTERN EUROPE-EU,SPAIN,2,LEEDS BRADFORD,IBIZA,80076,71108,8968,75580,66482,9098,5.94866
29/01/2018 17:06,2016,1,WESTERN EUROPE-EU,SPAIN,2,LEEDS BRADFORD,MAHON,50374,41153,9221,38468,38468,0,30.9504
29/01/2018 17:06,2016,1,WESTERN EUROPE-EU,SPAIN,2,LEEDS BRADFORD,MALAGA,276999,276999,0,231108,231108,0,19.85695
29/01/2018 17:06,2016,1,WESTERN EUROPE-EU,SPAIN,2,LEEDS BRADFORD,MURCIA SAN JAVIER,49738,49738,0,58466,58466,0,-14.92833
29/01/2018 17:06,2016,1,WESTERN EUROPE-EU,SPAIN,2,LEEDS BRADFORD,PALMA DE MALLORCA,256359,208992,47367,226386,194405,31981,13.23978
29/01/2018 17:06,2016,1,WESTERN EUROPE-EU,SPAIN,2,LEEDS BRADFORD,REUS,14814,14814,0,12188,12188,0,21.54578
29/01/2018 17:06,2016,1,WESTERN EUROPE-EU,SPAIN,2,LIVERPOOL (JOHN LENNON),ALICANTE,215339,215339,0,214309,214309,0,0.48061
29/01/2018 17:06,2016,1,WESTERN EUROPE-EU,SPAIN,2,LIVERPOOL (JOHN LENNON),BARCELONA,261596,261531,65,232096,232096,0,12.71026
29/01/2018 17:06,2016,1,WESTERN EUROPE-EU,SPAIN,2,LIVERPOOL (JOHN LENNON),BILBAO,179,179,0,0,0,0,0
29/01/2018 17:06,2016,1,WESTERN EUROPE-EU,SPAIN,2,LIVERPOOL (JOHN LENNON),CASTELLÓN COSTA AZAHAR,2939,0,2939,0,0,0,0
29/01/2018 17:06,2016,1,WESTERN EUROPE-EU,SPAIN,2,LIVERPOOL (JOHN LENNON),CASTELLON DE LA PLANA AIRPORT,0,0,0,44,0,44,-100
29/01/2018 17:06,2016,1,WESTERN EUROPE-EU,SPAIN,2,LIVERPOOL (JOHN LENNON),IBIZA,29982,29982,0,25785,25785,0,16.27691
29/01/2018 17:06,2016,1,WESTERN EUROPE-EU,SPAIN,2,LIVERPOOL (JOHN LENNON),LEON,0,0,0,159,0,159,-100
29/01/2018 17:06,2016,1,WESTERN EUROPE-EU,SPAIN,2,LIVERPOOL (JOHN LENNON),MADRID,92643,92643,0,95772,95716,56,-3.26713
29/01/2018 17:06,2016,1,WESTERN EUROPE-EU,SPAIN,2,LIVERPOOL (JOHN LENNON),MAHON,10011,10011,0,9939,9939,0,0.72442
29/01/2018 17:06,2016,1,WESTERN EUROPE-EU,SPAIN,2,LIVERPOOL (JOHN LENNON),MALAGA,227098,227098,0,194064,194064,0,17.02222
29/01/2018 17:06,2016,1,WESTERN EUROPE-EU,SPAIN,2,LIVERPOOL (JOHN LENNON),PALMA DE MALLORCA,196507,187545,8962,181544,181544,0,8.24208
29/01/2018 17:06,2016,1,WESTERN EUROPE-EU,SPAIN,2,LIVERPOOL (JOHN LENNON),REUS,12118,12118,0,0,0,0,0
29/01/2018 17:06,2016,1,WESTERN EUROPE-EU,SPAIN,2,LIVERPOOL (JOHN LENNON),SALAMANCA,0,0,0,158,0,158,-100
29/01/2018 17:06,2016,1,WESTERN EUROPE-EU,SPAIN,2,LIVERPOOL (JOHN LENNON),VALENCIA,417,0,417,0,0,0,0
29/01/2018 17:06,2016,1,WESTERN EUROPE-EU,SPAIN,2,LIVERPOOL (JOHN LENNON),VALLADOLID,0,0,0,665,0,665,-100
29/01/2018 17:06,2016,1,WESTERN EUROPE-EU,SPAIN,2,MANCHESTER,ALICANTE,807153,727903,79250,630636,563145,67491,27.99031
29/01/2018 17:06,2016,1,WESTERN EUROPE-EU,SPAIN,2,MANCHESTER,ALMERIA,89533,70685,18848,49464,22659,26805,81.00639
29/01/2018 17:06,2016,1,WESTERN EUROPE-EU,SPAIN,2,MANCHESTER,BARCELONA,446252,443527,2725,284365,281536,2829,56.9293
29/01/2018 17:06,2016,1,WESTERN EUROPE-EU,SPAIN,2,MANCHESTER,BILBAO,47998,47998,0,40349,40206,143,18.9571
29/01/2018 17:06,2016,1,WESTERN EUROPE-EU,SPAIN,2,MANCHESTER,GIRONA,64627,48159,16468,50905,34005,16900,26.95609
29/01/2018 17:06,2016,1,WESTERN EUROPE-EU,SPAIN,2,MANCHESTER,GRANADA,0,0,0,464,0,464,-100
29/01/2018 17:06,2016,1,WESTERN EUROPE-EU,SPAIN,2,MANCHESTER,IBIZA,291455,217227,74228,242801,150860,91941,20.03863
29/01/2018 17:06,2016,1,WESTERN EUROPE-EU,SPAIN,2,MANCHESTER,LIEIDA,6394,0,6394,6387,0,6387,0.1096
29/01/2018 17:06,2016,1,WESTERN EUROPE-EU,SPAIN,2,MANCHESTER,MADRID,167495,162362,5133,109243,109208,35,53.32333
29/01/2018 17:06,2016,1,WESTERN EUROPE-EU,SPAIN,2,MANCHESTER,MAHON,184068,104347,79721,159046,54554,104492,15.73256
29/01/2018 17:06,2016,1,WESTERN EUROPE-EU,SPAIN,2,MANCHESTER,MALAGA,694440,606268,88172,556720,487384,69336,24.73775
29/01/2018 17:06,2016,1,WESTERN EUROPE-EU,SPAIN,2,MANCHESTER,MURCIA SAN JAVIER,111167,111167,0,108246,108113,133,2.69848
29/01/2018 17:06,2016,1,WESTERN EUROPE-EU,SPAIN,2,MANCHESTER,PALMA DE MALLORCA,757792,585383,172409,666403,433952,232451,13.71377
29/01/2018 17:06,2016,1,WESTERN EUROPE-EU,SPAIN,2,MANCHESTER,REUS,87210,49745,37465,68807,18971,49836,26.74583
29/01/2018 17:06,2016,1,WESTERN EUROPE-EU,SPAIN,2,MANCHESTER,SEVILLE,0,0,0,1882,0,1882,-100
29/01/2018 17:06,2016,1,WESTERN EUROPE-EU,SPAIN,2,MANCHESTER,VALENCIA,40912,40912,0,22525,22525,0,81.6293
29/01/2018 17:06,2016,1,WESTERN EUROPE-EU,SPAIN,2,NEWCASTLE,ALICANTE,340357,335392,4965,234633,196228,38405,45.05931
29/01/2018 17:06,2016,1,WESTERN EUROPE-EU,SPAIN,2,NEWCASTLE,BARCELONA,98753,98647,106,66279,66132,147,48.99591
29/01/2018 17:06,2016,1,WESTERN EUROPE-EU,SPAIN,2,NEWCASTLE,GIRONA,10067,10067,0,0,0,0,0
29/01/2018 17:06,2016,1,WESTERN EUROPE-EU,SPAIN,2,NEWCASTLE,IBIZA,79462,79462,0,75704,36767,38937,4.96407
29/01/2018 17:06,2016,1,WESTERN EUROPE-EU,SPAIN,2,NEWCASTLE,MADRID,95,0,95,0,0,0,0
29/01/2018 17:06,2016,1,WESTERN EUROPE-EU,SPAIN,2,NEWCASTLE,MAHON,42546,42546,0,39537,17183,22354,7.61059
29/01/2018 17:06,2016,1,WESTERN EUROPE-EU,SPAIN,2,NEWCASTLE,MALAGA,238845,234109,4736,169855,150603,19252,40.617
29/01/2018 17:06,2016,1,WESTERN EUROPE-EU,SPAIN,2,NEWCASTLE,MURCIA SAN JAVIER,19355,19355,0,28799,28799,0,-32.79281
29/01/2018 17:06,2016,1,WESTERN EUROPE-EU,SPAIN,2,NEWCASTLE,PALMA DE MALLORCA,257176,256329,847,227063,137074,89989,13.26196
29/01/2018 17:06,2016,1,WESTERN EUROPE-EU,SPAIN,2,NEWCASTLE,REUS,60539,60539,0,40588,10239,30349,49.15492
29/01/2018 17:06,2016,1,WESTERN EUROPE-EU,SPAIN,2,NEWQUAY,ALICANTE,20725,20725,0,0,0,0,0
29/01/2018 17:06,2016,1,WESTERN EUROPE-EU,SPAIN,2,NEWQUAY,MALAGA,82,82,0,0,0,0,0
29/01/2018 17:06,2016,1,WESTERN EUROPE-EU,SPAIN,2,NORWICH,ALICANTE,13486,13486,0,0,0,0,0
29/01/2018 17:06,2016,1,WESTERN EUROPE-EU,SPAIN,2,NORWICH,IBIZA,0,0,0,5348,0,5348,-100
29/01/2018 17:06,2016,1,WESTERN EUROPE-EU,SPAIN,2,NORWICH,MAHON,0,0,0,7402,0,7402,-100
29/01/2018 17:06,2016,1,WESTERN EUROPE-EU,SPAIN,2,NORWICH,MALAGA,12502,12502,0,0,0,0,0
29/01/2018 17:06,2016,1,WESTERN EUROPE-EU,SPAIN,2,NORWICH,PALMA DE MALLORCA,0,0,0,29789,0,29789,-100
29/01/2018 17:06,2016,1,WESTERN EUROPE-EU,SPAIN,2,OXFORD (KIDLINGTON),MALAGA,0,0,0,35,0,35,-100
29/01/2018 17:06,2016,1,WESTERN EUROPE-EU,SPAIN,2,PRESTWICK,ALICANTE,82121,82121,0,75859,75859,0,8.25479
29/01/2018 17:06,2016,1,WESTERN EUROPE-EU,SPAIN,2,PRESTWICK,BARCELONA,86956,86261,695,76770,76770,0,13.2682
29/01/2018 17:06,2016,1,WESTERN EUROPE-EU,SPAIN,2,PRESTWICK,GIRONA,0,0,0,7703,7703,0,-100
29/01/2018 17:06,2016,1,WESTERN EUROPE-EU,SPAIN,2,PRESTWICK,IBIZA,21639,21639,0,22727,22727,0,-4.78726
29/01/2018 17:06,2016,1,WESTERN EUROPE-EU,SPAIN,2,PRESTWICK,MADRID,64,0,64,0,0,0,0
29/01/2018 17:06,2016,1,WESTERN EUROPE-EU,SPAIN,2,PRESTWICK,MALAGA,84619,84619,0,72088,72088,0,17.38292
29/01/2018 17:06,2016,1,WESTERN EUROPE-EU,SPAIN,2,PRESTWICK,MURCIA SAN JAVIER,24485,24485,0,24222,24222,0,1.08579
29/01/2018 17:06,2016,1,WESTERN EUROPE-EU,SPAIN,2,PRESTWICK,PALMA DE MALLORCA,60114,60114,0,53941,53941,0,11.44399
29/01/2018 17:06,2016,1,WESTERN EUROPE-EU,SPAIN,2,PRESTWICK,REUS,11669,11669,0,0,0,0,0
29/01/2018 17:06,2016,1,WESTERN EUROPE-EU,SPAIN,2,SOUTHAMPTON,ALICANTE,32858,32858,0,41001,41001,0,-19.86049
29/01/2018 17:06,2016,1,WESTERN EUROPE-EU,SPAIN,2,SOUTHAMPTON,BARCELONA,45,0,45,0,0,0,0
29/01/2018 17:06,2016,1,WESTERN EUROPE-EU,SPAIN,2,SOUTHAMPTON,BILBAO,72,0,72,0,0,0,0
29/01/2018 17:06,2016,1,WESTERN EUROPE-EU,SPAIN,2,SOUTHAMPTON,LIEIDA,0,0,0,2030,0,2030,-100
29/01/2018 17:06,2016,1,WESTERN EUROPE-EU,SPAIN,2,SOUTHAMPTON,MALAGA,23342,23342,0,42410,42410,0,-44.96109
29/01/2018 17:06,2016,1,WESTERN EUROPE-EU,SPAIN,2,SOUTHAMPTON,PALMA DE MALLORCA,41533,41357,176,23905,22582,1323,73.7419
29/01/2018 17:06,2016,1,WESTERN EUROPE-EU,SPAIN(CANARY ISLANDS),1,GATWICK,ARRECIFE,474869,382549,92320,426854,349201,77653,11.24858
29/01/2018 17:06,2016,1,WESTERN EUROPE-EU,SPAIN(CANARY ISLANDS),1,GATWICK,FUERTEVENTURA,278088,210528,67560,240279,193584,46695,15.73546
29/01/2018 17:06,2016,1,WESTERN EUROPE-EU,SPAIN(CANARY ISLANDS),1,GATWICK,LAS PALMAS,323829,227903,95926,283871,202696,81175,14.07611
29/01/2018 17:06,2016,1,WESTERN EUROPE-EU,SPAIN(CANARY ISLANDS),1,GATWICK,SANTA CRUZ DE LA PALMA,32821,6317,26504,29768,3669,26099,10.25598
29/01/2018 17:06,2016,1,WESTERN EUROPE-EU,SPAIN(CANARY ISLANDS),1,GATWICK,TENERIFE (NORTE LOS RODEOS),121,121,0,0,0,0,0
29/01/2018 17:06,2016,1,WESTERN EUROPE-EU,SPAIN(CANARY ISLANDS),1,GATWICK,TENERIFE (SURREINA SOFIA),862014,676278,185736,749650,601412,148238,14.98886
29/01/2018 17:06,2016,1,WESTERN EUROPE-EU,SPAIN(CANARY ISLANDS),1,HEATHROW,LAS PALMAS,57631,57631,0,51376,51376,0,12.17495
29/01/2018 17:06,2016,1,WESTERN EUROPE-EU,SPAIN(CANARY ISLANDS),1,HEATHROW,TENERIFE (NORTE LOS RODEOS),30969,30969,0,25300,25300,0,22.40711
29/01/2018 17:06,2016,1,WESTERN EUROPE-EU,SPAIN(CANARY ISLANDS),1,LUTON,ARRECIFE,113762,82060,31702,104372,71544,32828,8.99667
29/01/2018 17:06,2016,1,WESTERN EUROPE-EU,SPAIN(CANARY ISLANDS),1,LUTON,FUERTEVENTURA,39961,27785,12176,31383,21800,9583,27.33327
29/01/2018 17:06,2016,1,WESTERN EUROPE-EU,SPAIN(CANARY ISLANDS),1,LUTON,LAS PALMAS,61829,33490,28339,40078,22113,17965,54.27167
29/01/2018 17:06,2016,1,WESTERN EUROPE-EU,SPAIN(CANARY ISLANDS),1,LUTON,TENERIFE (SURREINA SOFIA),146670,108420,38250,121783,84523,37260,20.43553
29/01/2018 17:06,2016,1,WESTERN EUROPE-EU,SPAIN(CANARY ISLANDS),1,SOUTHEND,ARRECIFE,16022,16022,0,4195,4195,0,281.93087
29/01/2018 17:06,2016,1,WESTERN EUROPE-EU,SPAIN(CANARY ISLANDS),1,SOUTHEND,LAS PALMAS,3549,3549,0,0,0,0,0
29/01/2018 17:06,2016,1,WESTERN EUROPE-EU,SPAIN(CANARY ISLANDS),1,SOUTHEND,TENERIFE (SURREINA SOFIA),15132,15132,0,14226,14226,0,6.36862
29/01/2018 17:06,2016,1,WESTERN EUROPE-EU,SPAIN(CANARY ISLANDS),1,STANSTED,ARRECIFE,149690,132720,16970,144851,126181,18670,3.34067
29/01/2018 17:06,2016,1,WESTERN EUROPE-EU,SPAIN(CANARY ISLANDS),1,STANSTED,FUERTEVENTURA,118476,100016,18460,102399,83926,18473,15.70035
29/01/2018 17:06,2016,1,WESTERN EUROPE-EU,SPAIN(CANARY ISLANDS),1,STANSTED,LAS PALMAS,117664,99056,18608,103779,84877,18902,13.37939
29/01/2018 17:06,2016,1,WESTERN EUROPE-EU,SPAIN(CANARY ISLANDS),1,STANSTED,SANTA CRUZ DE LA PALMA,186,0,186,0,0,0,0
29/01/2018 17:06,2016,1,WESTERN EUROPE-EU,SPAIN(CANARY ISLANDS),1,STANSTED,TENERIFE (SURREINA SOFIA),234667,205676,28991,221820,191550,30270,5.79163
29/01/2018 17:06,2016,1,WESTERN EUROPE-EU,SPAIN(CANARY ISLANDS),2,ABERDEEN,LAS PALMAS,7846,0,7846,0,0,0,0
29/01/2018 17:06,2016,1,WESTERN EUROPE-EU,SPAIN(CANARY ISLANDS),2,ABERDEEN,TENERIFE (SURREINA SOFIA),23616,439,23177,26040,802,25238,-9.30876
29/01/2018 17:06,2016,1,WESTERN EUROPE-EU,SPAIN(CANARY ISLANDS),2,BELFAST INTERNATIONAL,ARRECIFE,108757,64906,43851,75784,58721,17063,43.50918
29/01/2018 17:06,2016,1,WESTERN EUROPE-EU,SPAIN(CANARY ISLANDS),2,BELFAST INTERNATIONAL,FUERTEVENTURA,7109,7109,0,0,0,0,0
29/01/2018 17:06,2016,1,WESTERN EUROPE-EU,SPAIN(CANARY ISLANDS),2,BELFAST INTERNATIONAL,LAS PALMAS,18496,12827,5669,20690,11588,9102,-10.60416
29/01/2018 17:06,2016,1,WESTERN EUROPE-EU,SPAIN(CANARY ISLANDS),2,BELFAST INTERNATIONAL,TENERIFE (SURREINA SOFIA),90509,34014,56495,75224,54554,20670,20.31931
29/01/2018 17:06,2016,1,WESTERN EUROPE-EU,SPAIN(CANARY ISLANDS),2,BIRMINGHAM,ARRECIFE,234566,171241,63325,218000,163391,54609,7.59908
29/01/2018 17:06,2016,1,WESTERN EUROPE-EU,SPAIN(CANARY ISLANDS),2,BIRMINGHAM,FUERTEVENTURA,156085,114100,41985,124333,101140,23193,25.53787
29/01/2018 17:06,2016,1,WESTERN EUROPE-EU,SPAIN(CANARY ISLANDS),2,BIRMINGHAM,LAS PALMAS,166937,123283,43654,118970,85346,33624,40.31857
29/01/2018 17:06,2016,1,WESTERN EUROPE-EU,SPAIN(CANARY ISLANDS),2,BIRMINGHAM,TENERIFE (SURREINA SOFIA),394405,318743,75662,277661,220731,56930,42.04552
29/01/2018 17:06,2016,1,WESTERN EUROPE-EU,SPAIN(CANARY ISLANDS),2,BOURNEMOUTH,ARRECIFE,23191,169,23022,18936,0,18936,22.47043
29/01/2018 17:06,2016,1,WESTERN EUROPE-EU,SPAIN(CANARY ISLANDS),2,BOURNEMOUTH,LAS PALMAS,35446,17735,17711,19246,10756,8490,84.17333
29/01/2018 17:06,2016,1,WESTERN EUROPE-EU,SPAIN(CANARY ISLANDS),2,BOURNEMOUTH,TENERIFE (SURREINA SOFIA),47295,17871,29424,47190,17995,29195,0.2225
29/01/2018 17:06,2016,1,WESTERN EUROPE-EU,SPAIN(CANARY ISLANDS),2,BRISTOL,ARRECIFE,158138,110472,47666,135872,104919,30953,16.38748
29/01/2018 17:06,2016,1,WESTERN EUROPE-EU,SPAIN(CANARY ISLANDS),2,BRISTOL,FUERTEVENTURA,74891,45213,29678,71307,45243,26064,5.02615
29/01/2018 17:06,2016,1,WESTERN EUROPE-EU,SPAIN(CANARY ISLANDS),2,BRISTOL,LAS PALMAS,85382,52815,32567,68908,43855,25053,23.90724
29/01/2018 17:06,2016,1,WESTERN EUROPE-EU,SPAIN(CANARY ISLANDS),2,BRISTOL,TENERIFE (SURREINA SOFIA),199655,147463,52192,172766,128670,44096,15.56383
29/01/2018 17:06,2016,1,WESTERN EUROPE-EU,SPAIN(CANARY ISLANDS),2,CARDIFF WALES,ARRECIFE,44412,0,44412,39601,7033,32568,12.14868
29/01/2018 17:06,2016,1,WESTERN EUROPE-EU,SPAIN(CANARY ISLANDS),2,CARDIFF WALES,FUERTEVENTURA,1483,0,1483,1814,0,1814,-18.24697
29/01/2018 17:06,2016,1,WESTERN EUROPE-EU,SPAIN(CANARY ISLANDS),2,CARDIFF WALES,LAS PALMAS,19070,0,19070,18356,0,18356,3.88974
29/01/2018 17:06,2016,1,WESTERN EUROPE-EU,SPAIN(CANARY ISLANDS),2,CARDIFF WALES,TENERIFE (SURREINA SOFIA),78587,19606,58981,60728,25665,35063,29.40818
29/01/2018 17:06,2016,1,WESTERN EUROPE-EU,SPAIN(CANARY ISLANDS),2,DONCASTER SHEFFIELD,ARRECIFE,37136,0,37136,19287,0,19287,92.5442
29/01/2018 17:06,2016,1,WESTERN EUROPE-EU,SPAIN(CANARY ISLANDS),2,DONCASTER SHEFFIELD,LAS PALMAS,19543,0,19543,18616,0,18616,4.97959
29/01/2018 17:06,2016,1,WESTERN EUROPE-EU,SPAIN(CANARY ISLANDS),2,DONCASTER SHEFFIELD,TENERIFE (SURREINA SOFIA),49845,0,49845,42770,0,42770,16.54197
29/01/2018 17:06,2016,1,WESTERN EUROPE-EU,SPAIN(CANARY ISLANDS),2,EAST MIDLANDS INTERNATIONAL,ARRECIFE,195955,171390,24565,195087,167207,27880,0.44493
29/01/2018 17:06,2016,1,WESTERN EUROPE-EU,SPAIN(CANARY ISLANDS),2,EAST MIDLANDS INTERNATIONAL,FUERTEVENTURA,113589,82701,30888,96213,77803,18410,18.05993
29/01/2018 17:06,2016,1,WESTERN EUROPE-EU,SPAIN(CANARY ISLANDS),2,EAST MIDLANDS INTERNATIONAL,LAS PALMAS,104686,80170,24516,77146,64255,12891,35.69855
29/01/2018 17:06,2016,1,WESTERN EUROPE-EU,SPAIN(CANARY ISLANDS),2,EAST MIDLANDS INTERNATIONAL,TENERIFE (SURREINA SOFIA),303076,246687,56389,285649,238092,47557,6.10084
29/01/2018 17:06,2016,1,WESTERN EUROPE-EU,SPAIN(CANARY ISLANDS),2,EDINBURGH,ARRECIFE,82672,64051,18621,60713,40197,20516,36.16853
29/01/2018 17:06,2016,1,WESTERN EUROPE-EU,SPAIN(CANARY ISLANDS),2,EDINBURGH,FUERTEVENTURA,20526,20526,0,19736,19736,0,4.00284
29/01/2018 17:06,2016,1,WESTERN EUROPE-EU,SPAIN(CANARY ISLANDS),2,EDINBURGH,LAS PALMAS,60679,44094,16585,25353,22568,2785,139.33657
29/01/2018 17:06,2016,1,WESTERN EUROPE-EU,SPAIN(CANARY ISLANDS),2,EDINBURGH,TENERIFE (NORTE LOS RODEOS),176,176,0,0,0,0,0
29/01/2018 17:06,2016,1,WESTERN EUROPE-EU,SPAIN(CANARY ISLANDS),2,EDINBURGH,TENERIFE (SURREINA SOFIA),216647,186642,30005,140272,110017,30255,54.44779
29/01/2018 17:06,2016,1,WESTERN EUROPE-EU,SPAIN(CANARY ISLANDS),2,EXETER,ARRECIFE,27092,0,27092,21799,0,21799,24.28093
29/01/2018 17:06,2016,1,WESTERN EUROPE-EU,SPAIN(CANARY ISLANDS),2,EXETER,LAS PALMAS,18182,0,18182,18386,0,18386,-1.10954
29/01/2018 17:06,2016,1,WESTERN EUROPE-EU,SPAIN(CANARY ISLANDS),2,EXETER,TENERIFE (SURREINA SOFIA),37957,0,37957,35162,0,35162,7.94892
29/01/2018 17:06,2016,1,WESTERN EUROPE-EU,SPAIN(CANARY ISLANDS),2,GLASGOW,ARRECIFE,136197,86953,49244,119395,96437,22958,14.07262
29/01/2018 17:06,2016,1,WESTERN EUROPE-EU,SPAIN(CANARY ISLANDS),2,GLASGOW,FUERTEVENTURA,74518,46289,28229,64566,52078,12488,15.41369
29/01/2018 17:06,2016,1,WESTERN EUROPE-EU,SPAIN(CANARY ISLANDS),2,GLASGOW,LAS PALMAS,77014,43035,33979,70146,47918,22228,9.79101
29/01/2018 17:06,2016,1,WESTERN EUROPE-EU,SPAIN(CANARY ISLANDS),2,GLASGOW,TENERIFE (SURREINA SOFIA),277518,149613,127905,243759,185467,58292,13.84933
29/01/2018 17:06,2016,1,WESTERN EUROPE-EU,SPAIN(CANARY ISLANDS),2,HUMBERSIDE,TENERIFE (SURREINA SOFIA),2413,0,2413,0,0,0,0
29/01/2018 17:06,2016,1,WESTERN EUROPE-EU,SPAIN(CANARY ISLANDS),2,JERSEY,TENERIFE (SURREINA SOFIA),2432,1708,724,1293,866,427,88.08971
29/01/2018 17:06,2016,1,WESTERN EUROPE-EU,SPAIN(CANARY ISLANDS),2,LEEDS BRADFORD,ARRECIFE,113188,113188,0,114115,114115,0,-0.81234
29/01/2018 17:06,2016,1,WESTERN EUROPE-EU,SPAIN(CANARY ISLANDS),2,LEEDS BRADFORD,FUERTEVENTURA,60564,60564,0,56287,56287,0,7.59856
29/01/2018 17:06,2016,1,WESTERN EUROPE-EU,SPAIN(CANARY ISLANDS),2,LEEDS BRADFORD,LAS PALMAS,41920,41920,0,29074,29074,0,44.18381
29/01/2018 17:06,2016,1,WESTERN EUROPE-EU,SPAIN(CANARY ISLANDS),2,LEEDS BRADFORD,TENERIFE (SURREINA SOFIA),180525,161368,19157,168484,149953,18531,7.14667
29/01/2018 17:06,2016,1,WESTERN EUROPE-EU,SPAIN(CANARY ISLANDS),2,LIVERPOOL (JOHN LENNON),ARRECIFE,75477,75477,0,71390,71390,0,5.72489
29/01/2018 17:06,2016,1,WESTERN EUROPE-EU,SPAIN(CANARY ISLANDS),2,LIVERPOOL (JOHN LENNON),FUERTEVENTURA,56736,56736,0,56388,56388,0,0.61715
29/01/2018 17:06,2016,1,WESTERN EUROPE-EU,SPAIN(CANARY ISLANDS),2,LIVERPOOL (JOHN LENNON),LAS PALMAS,13952,13952,0,10609,10609,0,31.51098
29/01/2018 17:06,2016,1,WESTERN EUROPE-EU,SPAIN(CANARY ISLANDS),2,LIVERPOOL (JOHN LENNON),TENERIFE (SURREINA SOFIA),32915,32797,118,32303,32303,0,1.89456
29/01/2018 17:06,2016,1,WESTERN EUROPE-EU,SPAIN(CANARY ISLANDS),2,MANCHESTER,ARRECIFE,452108,351869,100239,397680,311830,85850,13.68638
29/01/2018 17:06,2016,1,WESTERN EUROPE-EU,SPAIN(CANARY ISLANDS),2,MANCHESTER,FUERTEVENTURA,255329,195998,59331,207321,159441,47880,23.15636
29/01/2018 17:06,2016,1,WESTERN EUROPE-EU,SPAIN(CANARY ISLANDS),2,MANCHESTER,LAS PALMAS,295009,209510,85499,206013,136912,69101,43.19922
29/01/2018 17:06,2016,1,WESTERN EUROPE-EU,SPAIN(CANARY ISLANDS),2,MANCHESTER,SANTA CRUZ DE LA PALMA,21165,0,21165,18741,0,18741,12.93421
29/01/2018 17:06,2016,1,WESTERN EUROPE-EU,SPAIN(CANARY ISLANDS),2,MANCHESTER,TENERIFE (NORTE LOS RODEOS),364,364,0,0,0,0,0
29/01/2018 17:06,2016,1,WESTERN EUROPE-EU,SPAIN(CANARY ISLANDS),2,MANCHESTER,TENERIFE (SURREINA SOFIA),862411,672555,189856,725492,583071,142421,18.87257
29/01/2018 17:06,2016,1,WESTERN EUROPE-EU,SPAIN(CANARY ISLANDS),2,NEWCASTLE,ARRECIFE,113133,102698,10435,95399,66833,28566,18.58929
29/01/2018 17:06,2016,1,WESTERN EUROPE-EU,SPAIN(CANARY ISLANDS),2,NEWCASTLE,FUERTEVENTURA,44708,39226,5482,38554,31582,6972,15.96203
29/01/2018 17:06,2016,1,WESTERN EUROPE-EU,SPAIN(CANARY ISLANDS),2,NEWCASTLE,LAS PALMAS,62178,53047,9131,37801,16524,21277,64.48771
29/01/2018 17:06,2016,1,WESTERN EUROPE-EU,SPAIN(CANARY ISLANDS),2,NEWCASTLE,TENERIFE (SURREINA SOFIA),215583,184923,30660,174716,116403,58313,23.39053
29/01/2018 17:06,2016,1,WESTERN EUROPE-EU,SPAIN(CANARY ISLANDS),2,NORWICH,LAS PALMAS,0,0,0,4241,0,4241,-100
29/01/2018 17:06,2016,1,WESTERN EUROPE-EU,SPAIN(CANARY ISLANDS),2,NORWICH,TENERIFE (SURREINA SOFIA),8848,149,8699,19159,0,19159,-53.81805
29/01/2018 17:06,2016,1,WESTERN EUROPE-EU,SPAIN(CANARY ISLANDS),2,PRESTWICK,ARRECIFE,38136,38136,0,37069,37069,0,2.87842
29/01/2018 17:06,2016,1,WESTERN EUROPE-EU,SPAIN(CANARY ISLANDS),2,PRESTWICK,FUERTEVENTURA,18339,18339,0,19136,19136,0,-4.16492
29/01/2018 17:06,2016,1,WESTERN EUROPE-EU,SPAIN(CANARY ISLANDS),2,PRESTWICK,LAS PALMAS,29402,29402,0,30607,30607,0,-3.93701
29/01/2018 17:06,2016,1,WESTERN EUROPE-EU,SPAIN(CANARY ISLANDS),2,PRESTWICK,TENERIFE (SURREINA SOFIA),81725,81513,212,81077,81065,12,0.79924
29/01/2018 17:06,2016,1,WESTERN EUROPE-EU,SPAIN(CANARY ISLANDS),2,SOUTHAMPTON,TENERIFE (SURREINA SOFIA),0,0,0,310,0,310,-100
29/01/2018 17:06,2016,1,WESTERN EUROPE-EU,SWEDEN,1,GATWICK,GOTEBORG (LANDVETTER),170411,170014,397,87020,87020,0,95.82969
29/01/2018 17:06,2016,1,WESTERN EUROPE-EU,SWEDEN,1,GATWICK,KIRUNA,1109,0,1109,820,0,820,35.2439
29/01/2018 17:06,2016,1,WESTERN EUROPE-EU,SWEDEN,1,GATWICK,MALMO,0,0,0,76,76,0,-100
29/01/2018 17:06,2016,1,WESTERN EUROPE-EU,SWEDEN,1,GATWICK,OSTERSUND / FROSON,837,837,0,0,0,0,0
29/01/2018 17:06,2016,1,WESTERN EUROPE-EU,SWEDEN,1,GATWICK,PAJALA YLLAS,376,0,376,335,0,335,12.23881
29/01/2018 17:06,2016,1,WESTERN EUROPE-EU,SWEDEN,1,GATWICK,STOCKHOLM (ARLANDA),492461,492092,369,478195,478185,10,2.9833
29/01/2018 17:06,2016,1,WESTERN EUROPE-EU,SWEDEN,1,HEATHROW,GOTEBORG (LANDVETTER),256588,256588,0,289269,289269,0,-11.29779
29/01/2018 17:06,2016,1,WESTERN EUROPE-EU,SWEDEN,1,HEATHROW,KIRUNA,3332,178,3154,2856,0,2856,16.66667
29/01/2018 17:06,2016,1,WESTERN EUROPE-EU,SWEDEN,1,HEATHROW,STOCKHOLM (ARLANDA),1012568,1012568,0,1002530,1002530,0,1.00127
29/01/2018 17:06,2016,1,WESTERN EUROPE-EU,SWEDEN,1,LUTON,NORRKOPING,19,0,19,0,0,0,0
29/01/2018 17:06,2016,1,WESTERN EUROPE-EU,SWEDEN,1,LUTON,STOCKHOLM (ARLANDA),54,0,54,18,0,18,200
29/01/2018 17:06,2016,1,WESTERN EUROPE-EU,SWEDEN,1,LUTON,STOCKHOLM (BROMMA),0,0,0,16,0,16,-100
29/01/2018 17:06,2016,1,WESTERN EUROPE-EU,SWEDEN,1,STANSTED,GOTEBORG (LANDVETTER),271384,271384,0,242260,242260,0,12.02179
29/01/2018 17:06,2016,1,WESTERN EUROPE-EU,SWEDEN,1,STANSTED,PAJALA YLLAS,0,0,0,327,0,327,-100
29/01/2018 17:06,2016,1,WESTERN EUROPE-EU,SWEDEN,1,STANSTED,SKELLEFTEA,0,0,0,21519,21519,0,-100
29/01/2018 17:06,2016,1,WESTERN EUROPE-EU,SWEDEN,1,STANSTED,STOCKHOLM (ARLANDA),711,0,711,0,0,0,0
29/01/2018 17:06,2016,1,WESTERN EUROPE-EU,SWEDEN,1,STANSTED,STOCKHOLM (SKAVSTA),236868,236868,0,237479,237479,0,-0.25729
29/01/2018 17:06,2016,1,WESTERN EUROPE-EU,SWEDEN,1,STANSTED,VASTERAS,69417,69417,0,70256,70256,0,-1.1942
29/01/2018 17:06,2016,1,WESTERN EUROPE-EU,SWEDEN,2,ABERDEEN,GOTEBORG (LANDVETTER),0,0,0,78,0,78,-100
29/01/2018 17:06,2016,1,WESTERN EUROPE-EU,SWEDEN,2,BELFAST INTERNATIONAL,STOCKHOLM (ARLANDA),0,0,0,175,0,175,-100
29/01/2018 17:06,2016,1,WESTERN EUROPE-EU,SWEDEN,2,BIRMINGHAM,ARVIDSJAUR,538,0,538,0,0,0,0
29/01/2018 17:06,2016,1,WESTERN EUROPE-EU,SWEDEN,2,BIRMINGHAM,GOTEBORG (LANDVETTER),207,51,156,3105,2791,314,-93.33333
29/01/2018 17:06,2016,1,WESTERN EUROPE-EU,SWEDEN,2,BIRMINGHAM,KIRUNA,228,0,228,376,0,376,-39.3617
29/01/2018 17:06,2016,1,WESTERN EUROPE-EU,SWEDEN,2,BIRMINGHAM,MALMO,0,0,0,43,0,43,-100
29/01/2018 17:06,2016,1,WESTERN EUROPE-EU,SWEDEN,2,BIRMINGHAM,PAJALA YLLAS,374,0,374,333,0,333,12.31231
29/01/2018 17:06,2016,1,WESTERN EUROPE-EU,SWEDEN,2,BIRMINGHAM,STOCKHOLM (ARLANDA),0,0,0,72,0,72,-100
29/01/2018 17:06,2016,1,WESTERN EUROPE-EU,SWEDEN,2,BIRMINGHAM,STOCKHOLM (BROMMA),0,0,0,24,0,24,-100
29/01/2018 17:06,2016,1,WESTERN EUROPE-EU,SWEDEN,2,BIRMINGHAM,VAXJO,42,0,42,0,0,0,0
29/01/2018 17:06,2016,1,WESTERN EUROPE-EU,SWEDEN,2,BOURNEMOUTH,KIRUNA,343,0,343,215,0,215,59.53488
29/01/2018 17:06,2016,1,WESTERN EUROPE-EU,SWEDEN,2,BOURNEMOUTH,PAJALA YLLAS,374,0,374,336,0,336,11.30952
29/01/2018 17:06,2016,1,WESTERN EUROPE-EU,SWEDEN,2,BRISTOL,KIRUNA,215,0,215,101,0,101,112.87129
29/01/2018 17:06,2016,1,WESTERN EUROPE-EU,SWEDEN,2,BRISTOL,STOCKHOLM (ARLANDA),0,0,0,3141,3141,0,-100
29/01/2018 17:06,2016,1,WESTERN EUROPE-EU,SWEDEN,2,CAMBRIDGE,GOTEBORG (LANDVETTER),2,2,0,0,0,0,0
29/01/2018 17:06,2016,1,WESTERN EUROPE-EU,SWEDEN,2,CARDIFF WALES,PAJALA YLLAS,370,0,370,336,0,336,10.11905
29/01/2018 17:06,2016,1,WESTERN EUROPE-EU,SWEDEN,2,CARDIFF WALES,STOCKHOLM (ARLANDA),73,0,73,0,0,0,0
29/01/2018 17:06,2016,1,WESTERN EUROPE-EU,SWEDEN,2,DONCASTER SHEFFIELD,KIRUNA,155,0,155,270,0,270,-42.59259
29/01/2018 17:06,2016,1,WESTERN EUROPE-EU,SWEDEN,2,DURHAM TEES VALLEY,PAJALA YLLAS,378,0,378,332,0,332,13.85542
29/01/2018 17:06,2016,1,WESTERN EUROPE-EU,SWEDEN,2,EAST MIDLANDS INTERNATIONAL,KIRUNA,168,0,168,152,0,152,10.52632
29/01/2018 17:06,2016,1,WESTERN EUROPE-EU,SWEDEN,2,EAST MIDLANDS INTERNATIONAL,PAJALA YLLAS,378,0,378,0,0,0,0
29/01/2018 17:06,2016,1,WESTERN EUROPE-EU,SWEDEN,2,EAST MIDLANDS INTERNATIONAL,STOCKHOLM (ARLANDA),114,0,114,0,0,0,0
29/01/2018 17:06,2016,1,WESTERN EUROPE-EU,SWEDEN,2,EDINBURGH,GOTEBORG (LANDVETTER),21398,21398,0,20787,20633,154,2.93934
29/01/2018 17:06,2016,1,WESTERN EUROPE-EU,SWEDEN,2,EDINBURGH,STOCKHOLM (ARLANDA),86395,86395,0,83605,83390,215,3.33712
29/01/2018 17:06,2016,1,WESTERN EUROPE-EU,SWEDEN,2,EXETER,KIRUNA,138,0,138,150,0,150,-8
29/01/2018 17:06,2016,1,WESTERN EUROPE-EU,SWEDEN,2,EXETER,MALMO,0,0,0,154,0,154,-100
29/01/2018 17:06,2016,1,WESTERN EUROPE-EU,SWEDEN,2,EXETER,PAJALA YLLAS,188,0,188,336,0,336,-44.04762
29/01/2018 17:06,2016,1,WESTERN EUROPE-EU,SWEDEN,2,EXETER,STOCKHOLM (ARLANDA),0,0,0,11,0,11,-100
29/01/2018 17:06,2016,1,WESTERN EUROPE-EU,SWEDEN,2,GLASGOW,GOTEBORG (LANDVETTER),0,0,0,273,0,273,-100
29/01/2018 17:06,2016,1,WESTERN EUROPE-EU,SWEDEN,2,GLASGOW,MALMO,0,0,0,914,0,914,-100
29/01/2018 17:06,2016,1,WESTERN EUROPE-EU,SWEDEN,2,GLASGOW,VAXJO,0,0,0,63,0,63,-100
29/01/2018 17:06,2016,1,WESTERN EUROPE-EU,SWEDEN,2,HUMBERSIDE,KIRUNA,233,0,233,164,0,164,42.07317
29/01/2018 17:06,2016,1,WESTERN EUROPE-EU,SWEDEN,2,HUMBERSIDE,PAJALA YLLAS,378,0,378,168,0,168,125
29/01/2018 17:06,2016,1,WESTERN EUROPE-EU,SWEDEN,2,JERSEY,VISBY,0,0,0,268,0,268,-100
29/01/2018 17:06,2016,1,WESTERN EUROPE-EU,SWEDEN,2,LEEDS BRADFORD,KIRUNA,437,0,437,226,0,226,93.36283
29/01/2018 17:06,2016,1,WESTERN EUROPE-EU,SWEDEN,2,LIVERPOOL (JOHN LENNON),GOTEBORG (LANDVETTER),79,0,79,0,0,0,0
29/01/2018 17:06,2016,1,WESTERN EUROPE-EU,SWEDEN,2,LIVERPOOL (JOHN LENNON),PAJALA YLLAS,375,0,375,317,0,317,18.29653
29/01/2018 17:06,2016,1,WESTERN EUROPE-EU,SWEDEN,2,LIVERPOOL (JOHN LENNON),STOCKHOLM (ARLANDA),71,0,71,0,0,0,0
29/01/2018 17:06,2016,1,WESTERN EUROPE-EU,SWEDEN,2,MANCHESTER,GOTEBORG (LANDVETTER),4519,4399,120,2504,2480,24,80.47125
29/01/2018 17:06,2016,1,WESTERN EUROPE-EU,SWEDEN,2,MANCHESTER,KIRUNA,427,0,427,247,0,247,72.87449
29/01/2018 17:06,2016,1,WESTERN EUROPE-EU,SWEDEN,2,MANCHESTER,STOCKHOLM (ARLANDA),145293,145293,0,119770,119770,0,21.31001
29/01/2018 17:06,2016,1,WESTERN EUROPE-EU,SWEDEN,2,NEWCASTLE,GOTEBORG CITY,0,0,0,8,0,8,-100
29/01/2018 17:06,2016,1,WESTERN EUROPE-EU,SWEDEN,2,NEWCASTLE,KIRUNA,310,0,310,213,0,213,45.53991
29/01/2018 17:06,2016,1,WESTERN EUROPE-EU,SWEDEN,2,NEWCASTLE,STOCKHOLM (ARLANDA),14,0,14,0,0,0,0
29/01/2018 17:06,2016,1,WESTERN EUROPE-EU,SWEDEN,2,NORWICH,PAJALA YLLAS,0,0,0,332,0,332,-100
29/01/2018 17:06,2016,1,WESTERN EUROPE-EU,SWEDEN,2,SOUTHAMPTON,STOCKHOLM (ARLANDA),224,0,224,0,0,0,0
29/01/2018 17:06,2016,2,WESTERN EUROPE-OTHER,BOSNIA-HERZEGOVINA,1,LUTON,TUZLA,3005,3005,0,0,0,0,0
29/01/2018 17:06,2016,2,WESTERN EUROPE-OTHER,BOSNIA-HERZEGOVINA,2,CARDIFF WALES,SARAJEVO,0,0,0,158,0,158,-100
29/01/2018 17:06,2016,2,WESTERN EUROPE-OTHER,BOSNIA-HERZEGOVINA,2,GLASGOW,MOSTAR,230,0,230,0,0,0,0
29/01/2018 17:06,2016,2,WESTERN EUROPE-OTHER,FAROE ISLANDS,1,GATWICK,VAGAR,146,146,0,243,0,243,-39.9177
29/01/2018 17:06,2016,2,WESTERN EUROPE-OTHER,FAROE ISLANDS,1,SOUTHEND,VAGAR,138,0,138,0,0,0,0
29/01/2018 17:06,2016,2,WESTERN EUROPE-OTHER,FAROE ISLANDS,1,STANSTED,VAGAR,0,0,0,532,0,532,-100
29/01/2018 17:06,2016,2,WESTERN EUROPE-OTHER,FAROE ISLANDS,2,ABERDEEN,VAGAR,0,0,0,288,0,288,-100
29/01/2018 17:06,2016,2,WESTERN EUROPE-OTHER,FAROE ISLANDS,2,BELFAST CITY (GEORGE BEST),VAGAR,0,0,0,78,0,78,-100
29/01/2018 17:06,2016,2,WESTERN EUROPE-OTHER,FAROE ISLANDS,2,BELFAST INTERNATIONAL,VAGAR,0,0,0,70,0,70,-100
29/01/2018 17:06,2016,2,WESTERN EUROPE-OTHER,FAROE ISLANDS,2,EDINBURGH,VAGAR,10985,10823,162,8285,8285,0,32.58902
29/01/2018 17:06,2016,2,WESTERN EUROPE-OTHER,FAROE ISLANDS,2,JERSEY,VAGAR,0,0,0,497,0,497,-100
29/01/2018 17:06,2016,2,WESTERN EUROPE-OTHER,ICELAND,1,GATWICK,EGILSSTADIR,314,0,314,0,0,0,0
29/01/2018 17:06,2016,2,WESTERN EUROPE-OTHER,ICELAND,1,GATWICK,KEFLAVIK,404161,392991,11170,312650,312440,210,29.26947
29/01/2018 17:06,2016,2,WESTERN EUROPE-OTHER,ICELAND,1,HEATHROW,KEFLAVIK,305932,305932,0,240313,240313,0,27.30564
29/01/2018 17:06,2016,2,WESTERN EUROPE-OTHER,ICELAND,1,LUTON,KEFLAVIK,112908,112908,0,100530,100507,23,12.31274
29/01/2018 17:06,2016,2,WESTERN EUROPE-OTHER,ICELAND,1,LUTON,REYKJAVIK,3,0,3,0,0,0,0
29/01/2018 17:06,2016,2,WESTERN EUROPE-OTHER,ICELAND,1,STANSTED,KEFLAVIK,22975,22871,104,4968,4968,0,362.45974
29/01/2018 17:06,2016,2,WESTERN EUROPE-OTHER,ICELAND,2,ABERDEEN,KEFLAVIK,13350,13350,0,28,0,28,47578.57143
29/01/2018 17:06,2016,2,WESTERN EUROPE-OTHER,ICELAND,2,BELFAST INTERNATIONAL,KEFLAVIK,27664,27664,0,26133,26133,0,5.85849
29/01/2018 17:06,2016,2,WESTERN EUROPE-OTHER,ICELAND,2,BIRMINGHAM,KEFLAVIK,43126,42832,294,29486,29486,0,46.25924
29/01/2018 17:06,2016,2,WESTERN EUROPE-OTHER,ICELAND,2,BRISTOL,KEFLAVIK,49324,49324,0,37435,37435,0,31.75905
29/01/2018 17:06,2016,2,WESTERN EUROPE-OTHER,ICELAND,2,EAST MIDLANDS INTERNATIONAL,KEFLAVIK,0,0,0,181,0,181,-100
29/01/2018 17:06,2016,2,WESTERN EUROPE-OTHER,ICELAND,2,EDINBURGH,AKUREYRI,396,198,198,0,0,0,0
29/01/2018 17:06,2016,2,WESTERN EUROPE-OTHER,ICELAND,2,EDINBURGH,KEFLAVIK,66842,66842,0,37681,37681,0,77.38914
29/01/2018 17:06,2016,2,WESTERN EUROPE-OTHER,ICELAND,2,GLASGOW,KEFLAVIK,91457,91452,5,74772,74592,180,22.3145
29/01/2018 17:06,2016,2,WESTERN EUROPE-OTHER,ICELAND,2,HUMBERSIDE,KEFLAVIK,322,0,322,0,0,0,0
29/01/2018 17:06,2016,2,WESTERN EUROPE-OTHER,ICELAND,2,INVERNESS,KEFLAVIK,155,155,0,0,0,0,0
29/01/2018 17:06,2016,2,WESTERN EUROPE-OTHER,ICELAND,2,LIVERPOOL (JOHN LENNON),KEFLAVIK,445,155,290,0,0,0,0
29/01/2018 17:06,2016,2,WESTERN EUROPE-OTHER,ICELAND,2,MANCHESTER,KEFLAVIK,153277,142675,10602,110212,110212,0,39.07469
29/01/2018 17:06,2016,2,WESTERN EUROPE-OTHER,ICELAND,2,NEWCASTLE,KEFLAVIK,106,0,106,0,0,0,0
29/01/2018 17:06,2016,2,WESTERN EUROPE-OTHER,ICELAND,2,PRESTWICK,REYKJAVIK,0,0,0,103,0,103,-100
29/01/2018 17:06,2016,2,WESTERN EUROPE-OTHER,KOSOVO,1,GATWICK,PRISTINA,14954,14952,2,14114,14114,0,5.95154
29/01/2018 17:06,2016,2,WESTERN EUROPE-OTHER,KOSOVO,1,LUTON,PRISTINA,6645,6645,0,0,0,0,0
29/01/2018 17:06,2016,2,WESTERN EUROPE-OTHER,MACEDONIA,1,LUTON,OHRID,21557,21557,0,7639,7639,0,182.19662
29/01/2018 17:06,2016,2,WESTERN EUROPE-OTHER,MACEDONIA,1,LUTON,SKOPJE,70670,70670,0,71251,71251,0,-0.81543
29/01/2018 17:06,2016,2,WESTERN EUROPE-OTHER,MACEDONIA,2,ABERDEEN,SKOPJE,0,0,0,198,0,198,-100
29/01/2018 17:06,2016,2,WESTERN EUROPE-OTHER,MACEDONIA,2,BELFAST INTERNATIONAL,OHRID,0,0,0,136,0,136,-100
29/01/2018 17:06,2016,2,WESTERN EUROPE-OTHER,MACEDONIA,2,EDINBURGH,SKOPJE,66,0,66,0,0,0,0
29/01/2018 17:06,2016,2,WESTERN EUROPE-OTHER,NORWAY,1,GATWICK,ALESUND,17417,17417,0,23307,23307,0,-25.27138
29/01/2018 17:06,2016,2,WESTERN EUROPE-OTHER,NORWAY,1,GATWICK,BERGEN,185917,185706,211,180386,179130,1256,3.0662
29/01/2018 17:06,2016,2,WESTERN EUROPE-OTHER,NORWAY,1,GATWICK,BODO,573,0,573,559,0,559,2.50447
29/01/2018 17:06,2016,2,WESTERN EUROPE-OTHER,NORWAY,1,GATWICK,EVENES,619,0,619,0,0,0,0
29/01/2018 17:06,2016,2,WESTERN EUROPE-OTHER,NORWAY,1,GATWICK,FAGERNES/LEIRIN,3223,0,3223,3106,0,3106,3.7669
29/01/2018 17:06,2016,2,WESTERN EUROPE-OTHER,NORWAY,1,GATWICK,HAUGESUND,2388,0,2388,0,0,0,0
29/01/2018 17:06,2016,2,WESTERN EUROPE-OTHER,NORWAY,1,GATWICK,OSLO (GARDERMOEN),352497,352346,151,364405,364405,0,-3.26779
29/01/2018 17:06,2016,2,WESTERN EUROPE-OTHER,NORWAY,1,GATWICK,SANDEFJORD(TORP),0,0,0,32751,32751,0,-100
29/01/2018 17:06,2016,2,WESTERN EUROPE-OTHER,NORWAY,1,GATWICK,STAVANGER,73385,73385,0,71005,71005,0,3.35188
29/01/2018 17:06,2016,2,WESTERN EUROPE-OTHER,NORWAY,1,GATWICK,TROMSOE,18696,16547,2149,16445,14091,2354,13.68805
29/01/2018 17:06,2016,2,WESTERN EUROPE-OTHER,NORWAY,1,GATWICK,TRONDHEIM (VAERNES),70697,69619,1078,68749,68749,0,2.8335
29/01/2018 17:06,2016,2,WESTERN EUROPE-OTHER,NORWAY,1,HEATHROW,BERGEN,120331,120331,0,126022,126022,0,-4.51588
29/01/2018 17:06,2016,2,WESTERN EUROPE-OTHER,NORWAY,1,HEATHROW,OSLO (GARDERMOEN),702842,702842,0,686856,686856,0,2.32742
29/01/2018 17:06,2016,2,WESTERN EUROPE-OTHER,NORWAY,1,HEATHROW,STAVANGER,191309,191309,0,198555,198555,0,-3.64937
29/01/2018 17:06,2016,2,WESTERN EUROPE-OTHER,NORWAY,1,HEATHROW,TROMSOE,32,0,32,0,0,0,0
29/01/2018 17:06,2016,2,WESTERN EUROPE-OTHER,NORWAY,1,LUTON,BERGEN,0,0,0,37,0,37,-100
29/01/2018 17:06,2016,2,WESTERN EUROPE-OTHER,NORWAY,1,LUTON,EVENES,14,0,14,0,0,0,0
29/01/2018 17:06,2016,2,WESTERN EUROPE-OTHER,NORWAY,1,LUTON,OSLO (GARDERMOEN),18,0,18,58,0,58,-68.96552
29/01/2018 17:06,2016,2,WESTERN EUROPE-OTHER,NORWAY,1,LUTON,STAVANGER,1,0,1,0,0,0,0
29/01/2018 17:06,2016,2,WESTERN EUROPE-OTHER,NORWAY,1,LUTON,TRONDHEIM (VAERNES),20,0,20,0,0,0,0
29/01/2018 17:06,2016,2,WESTERN EUROPE-OTHER,NORWAY,1,STANSTED,HAUGESUND,596,596,0,23916,23916,0,-97.50794
29/01/2018 17:06,2016,2,WESTERN EUROPE-OTHER,NORWAY,1,STANSTED,OSLO (GARDERMOEN),53726,53629,97,0,0,0,0
29/01/2018 17:06,2016,2,WESTERN EUROPE-OTHER,NORWAY,1,STANSTED,RYGGE,221923,221923,0,286983,286983,0,-22.67033
29/01/2018 17:06,2016,2,WESTERN EUROPE-OTHER,NORWAY,1,STANSTED,SANDEFJORD(TORP),64190,64190,0,77594,77594,0,-17.27453
29/01/2018 17:06,2016,2,WESTERN EUROPE-OTHER,NORWAY,1,STANSTED,TROMSOE,0,0,0,282,0,282,-100
29/01/2018 17:06,2016,2,WESTERN EUROPE-OTHER,NORWAY,1,STANSTED,TRONDHEIM (VAERNES),2130,0,2130,0,0,0,0
29/01/2018 17:06,2016,2,WESTERN EUROPE-OTHER,NORWAY,2,ABERDEEN,BERGEN,32652,32619,33,43964,43964,0,-25.73014
29/01/2018 17:06,2016,2,WESTERN EUROPE-OTHER,NORWAY,2,ABERDEEN,HAUGESUND,2016,549,1467,0,0,0,0
29/01/2018 17:06,2016,2,WESTERN EUROPE-OTHER,NORWAY,2,ABERDEEN,KRISTIANSAND (KJEVIK),40,0,40,0,0,0,0
29/01/2018 17:06,2016,2,WESTERN EUROPE-OTHER,NORWAY,2,ABERDEEN,OSLO (GARDERMOEN),33655,33655,0,36075,36063,12,-6.70825
29/01/2018 17:06,2016,2,WESTERN EUROPE-OTHER,NORWAY,2,ABERDEEN,STAVANGER,97640,97571,69,116837,116711,126,-16.43058
29/01/2018 17:06,2016,2,WESTERN EUROPE-OTHER,NORWAY,2,BELFAST INTERNATIONAL,OSLO (GARDERMOEN),0,0,0,110,110,0,-100
29/01/2018 17:06,2016,2,WESTERN EUROPE-OTHER,NORWAY,2,BIRMINGHAM,OSLO (GARDERMOEN),0,0,0,4989,4989,0,-100
29/01/2018 17:06,2016,2,WESTERN EUROPE-OTHER,NORWAY,2,BIRMINGHAM,SANDEFJORD(TORP),5,5,0,0,0,0,0
29/01/2018 17:06,2016,2,WESTERN EUROPE-OTHER,NORWAY,2,BIRMINGHAM,TROMSOE,0,0,0,112,0,112,-100
29/01/2018 17:06,2016,2,WESTERN EUROPE-OTHER,NORWAY,2,BOURNEMOUTH,BERGEN,0,0,0,225,0,225,-100
29/01/2018 17:06,2016,2,WESTERN EUROPE-OTHER,NORWAY,2,BOURNEMOUTH,KIRKENES,342,0,342,0,0,0,0
29/01/2018 17:06,2016,2,WESTERN EUROPE-OTHER,NORWAY,2,BOURNEMOUTH,TROMSOE,287,0,287,381,0,381,-24.67192
29/01/2018 17:06,2016,2,WESTERN EUROPE-OTHER,NORWAY,2,BRISTOL,BERGEN,184,0,184,264,0,264,-30.30303
29/01/2018 17:06,2016,2,WESTERN EUROPE-OTHER,NORWAY,2,BRISTOL,TROMSOE,584,0,584,324,0,324,80.24691
29/01/2018 17:06,2016,2,WESTERN EUROPE-OTHER,NORWAY,2,CARDIFF WALES,TROMSOE,0,0,0,138,0,138,-100
29/01/2018 17:06,2016,2,WESTERN EUROPE-OTHER,NORWAY,2,DUNDEE,OSLO (GARDERMOEN),0,0,0,30,0,30,-100
29/01/2018 17:06,2016,2,WESTERN EUROPE-OTHER,NORWAY,2,EAST MIDLANDS INTERNATIONAL,BERGEN,0,0,0,169,0,169,-100
29/01/2018 17:06,2016,2,WESTERN EUROPE-OTHER,NORWAY,2,EAST MIDLANDS INTERNATIONAL,OSLO (GARDERMOEN),74,74,0,0,0,0,0
29/01/2018 17:06,2016,2,WESTERN EUROPE-OTHER,NORWAY,2,EAST MIDLANDS INTERNATIONAL,TROMSOE,293,0,293,344,0,344,-14.82558
29/01/2018 17:06,2016,2,WESTERN EUROPE-OTHER,NORWAY,2,EDINBURGH,EVENES,254,0,254,0,0,0,0
29/01/2018 17:06,2016,2,WESTERN EUROPE-OTHER,NORWAY,2,EDINBURGH,OSLO (GARDERMOEN),85895,85564,331,81774,81415,359,5.0395
29/01/2018 17:06,2016,2,WESTERN EUROPE-OTHER,NORWAY,2,EDINBURGH,RYGGE,35677,35677,0,40009,40009,0,-10.82756
29/01/2018 17:06,2016,2,WESTERN EUROPE-OTHER,NORWAY,2,EDINBURGH,STAVANGER,43,43,0,31,31,0,38.70968
29/01/2018 17:06,2016,2,WESTERN EUROPE-OTHER,NORWAY,2,GLASGOW,BERGEN,148,0,148,252,0,252,-41.26984
29/01/2018 17:06,2016,2,WESTERN EUROPE-OTHER,NORWAY,2,GLASGOW,MOLDE,0,0,0,1181,0,1181,-100
29/01/2018 17:06,2016,2,WESTERN EUROPE-OTHER,NORWAY,2,GLASGOW,STAVANGER,32,32,0,0,0,0,0
29/01/2018 17:06,2016,2,WESTERN EUROPE-OTHER,NORWAY,2,GLASGOW,TROMSOE,0,0,0,194,0,194,-100
29/01/2018 17:06,2016,2,WESTERN EUROPE-OTHER,NORWAY,2,HUMBERSIDE,TROMSOE,32,0,32,0,0,0,0
29/01/2018 17:06,2016,2,WESTERN EUROPE-OTHER,NORWAY,2,JERSEY,TROMSOE,0,0,0,144,0,144,-100
29/01/2018 17:06,2016,2,WESTERN EUROPE-OTHER,NORWAY,2,JERSEY,TRONDHEIM (VAERNES),0,0,0,162,0,162,-100
29/01/2018 17:06,2016,2,WESTERN EUROPE-OTHER,NORWAY,2,KIRKWALL,BERGEN,0,0,0,196,0,196,-100
29/01/2018 17:06,2016,2,WESTERN EUROPE-OTHER,NORWAY,2,LEEDS BRADFORD,OSLO (GARDERMOEN),0,0,0,37,0,37,-100
29/01/2018 17:06,2016,2,WESTERN EUROPE-OTHER,NORWAY,2,LEEDS BRADFORD,STAVANGER,0,0,0,143,0,143,-100
29/01/2018 17:06,2016,2,WESTERN EUROPE-OTHER,NORWAY,2,LIVERPOOL (JOHN LENNON),EVENES,302,0,302,0,0,0,0
29/01/2018 17:06,2016,2,WESTERN EUROPE-OTHER,NORWAY,2,LIVERPOOL (JOHN LENNON),OSLO (GARDERMOEN),0,0,0,296,0,296,-100
29/01/2018 17:06,2016,2,WESTERN EUROPE-OTHER,NORWAY,2,LIVERPOOL (JOHN LENNON),SANDEFJORD(TORP),26536,26536,0,33495,33495,0,-20.77624
29/01/2018 17:06,2016,2,WESTERN EUROPE-OTHER,NORWAY,2,LIVERPOOL (JOHN LENNON),STAVANGER,467,0,467,1012,0,1012,-53.85375
29/01/2018 17:06,2016,2,WESTERN EUROPE-OTHER,NORWAY,2,MANCHESTER,BERGEN,9863,9344,519,11162,9908,1254,-11.6377
29/01/2018 17:06,2016,2,WESTERN EUROPE-OTHER,NORWAY,2,MANCHESTER,OSLO (GARDERMOEN),103628,103526,102,96855,96855,0,6.99293
29/01/2018 17:06,2016,2,WESTERN EUROPE-OTHER,NORWAY,2,MANCHESTER,RYGGE,53785,53785,0,64321,64321,0,-16.38034
29/01/2018 17:06,2016,2,WESTERN EUROPE-OTHER,NORWAY,2,MANCHESTER,SANDEFJORD(TORP),11026,11026,0,0,0,0,0
29/01/2018 17:06,2016,2,WESTERN EUROPE-OTHER,NORWAY,2,MANCHESTER,STAVANGER,19842,19842,0,24747,24747,0,-19.82058
29/01/2018 17:06,2016,2,WESTERN EUROPE-OTHER,NORWAY,2,MANCHESTER,TROMSOE,320,0,320,1216,0,1216,-73.68421
29/01/2018 17:06,2016,2,WESTERN EUROPE-OTHER,NORWAY,2,NEWCASTLE,BERGEN,427,0,427,571,0,571,-25.21891
29/01/2018 17:06,2016,2,WESTERN EUROPE-OTHER,NORWAY,2,NEWCASTLE,SANDEFJORD(TORP),0,0,0,152,0,152,-100
29/01/2018 17:06,2016,2,WESTERN EUROPE-OTHER,NORWAY,2,NEWCASTLE,STAVANGER,6587,6587,0,13906,13906,0,-52.63196
29/01/2018 17:06,2016,2,WESTERN EUROPE-OTHER,NORWAY,2,NEWCASTLE,TROMSOE,280,0,280,388,0,388,-27.83505
29/01/2018 17:06,2016,2,WESTERN EUROPE-OTHER,NORWAY,2,PRESTWICK,BERGEN,0,0,0,145,0,145,-100
29/01/2018 17:06,2016,2,WESTERN EUROPE-OTHER,NORWAY,2,SOUTHAMPTON,OSLO (GARDERMOEN),0,0,0,40,0,40,-100
29/01/2018 17:06,2016,2,WESTERN EUROPE-OTHER,NORWAY,2,STORNOWAY,OSLO (GARDERMOEN),0,0,0,2,0,2,-100
29/01/2018 17:06,2016,2,WESTERN EUROPE-OTHER,NORWAY,2,SUMBURGH,BERGEN,1009,1009,0,958,958,0,5.32359
29/01/2018 17:06,2016,2,WESTERN EUROPE-OTHER,NORWAY,2,SUMBURGH,HAUGESUND,24,24,0,20,20,0,20
29/01/2018 17:06,2016,2,WESTERN EUROPE-OTHER,NORWAY,2,WICK JOHN O GROATS,ALESUND,0,0,0,54,0,54,-100
29/01/2018 17:06,2016,2,WESTERN EUROPE-OTHER,REPUBLIC OF MONTENEGRO,1,GATWICK,TIVAT,25443,25443,0,13739,13739,0,85.18815
29/01/2018 17:06,2016,2,WESTERN EUROPE-OTHER,REPUBLIC OF MONTENEGRO,1,LUTON,TIVAT,70,0,70,0,0,0,0
29/01/2018 17:06,2016,2,WESTERN EUROPE-OTHER,REPUBLIC OF MONTENEGRO,1,STANSTED,PODGORICA,36724,36724,0,36223,36223,0,1.3831
29/01/2018 17:06,2016,2,WESTERN EUROPE-OTHER,REPUBLIC OF MONTENEGRO,1,STANSTED,TIVAT,1174,1174,0,0,0,0,0
29/01/2018 17:06,2016,2,WESTERN EUROPE-OTHER,REPUBLIC OF MONTENEGRO,2,BIRMINGHAM,TIVAT,66,0,66,0,0,0,0
29/01/2018 17:06,2016,2,WESTERN EUROPE-OTHER,REPUBLIC OF MONTENEGRO,2,MANCHESTER,TIVAT,17253,17253,0,0,0,0,0
29/01/2018 17:06,2016,2,WESTERN EUROPE-OTHER,REPUBLIC OF SERBIA,1,GATWICK,BELGRADE,176,176,0,0,0,0,0
29/01/2018 17:06,2016,2,WESTERN EUROPE-OTHER,REPUBLIC OF SERBIA,1,HEATHROW,BELGRADE,88509,88509,0,84536,84536,0,4.69977
29/01/2018 17:06,2016,2,WESTERN EUROPE-OTHER,REPUBLIC OF SERBIA,1,LUTON,BELGRADE,46385,46363,22,43294,43272,22,7.13956
29/01/2018 17:06,2016,2,WESTERN EUROPE-OTHER,SWITZERLAND,1,GATWICK,BALE MULHOUSE,269177,269177,0,270273,270273,0,-0.40552
29/01/2018 17:06,2016,2,WESTERN EUROPE-OTHER,SWITZERLAND,1,GATWICK,GENEVA,844937,818822,26115,844939,792722,52217,-0.00024
29/01/2018 17:06,2016,2,WESTERN EUROPE-OTHER,SWITZERLAND,1,GATWICK,ZURICH,154723,154316,407,176164,175870,294,-12.17105
29/01/2018 17:06,2016,2,WESTERN EUROPE-OTHER,SWITZERLAND,1,HEATHROW,BALE MULHOUSE,254206,254206,0,246933,246933,0,2.94533
29/01/2018 17:06,2016,2,WESTERN EUROPE-OTHER,SWITZERLAND,1,HEATHROW,GENEVA,1053728,1048606,5122,1021882,1018666,3216,3.11641
29/01/2018 17:06,2016,2,WESTERN EUROPE-OTHER,SWITZERLAND,1,HEATHROW,ZURICH,1102296,1101677,619,1075098,1074736,362,2.52982
29/01/2018 17:06,2016,2,WESTERN EUROPE-OTHER,SWITZERLAND,1,LONDON CITY,BALE MULHOUSE,18082,18082,0,37028,37028,0,-51.16668
29/01/2018 17:06,2016,2,WESTERN EUROPE-OTHER,SWITZERLAND,1,LONDON CITY,BERNE,11580,11580,0,5097,5097,0,127.19247
29/01/2018 17:06,2016,2,WESTERN EUROPE-OTHER,SWITZERLAND,1,LONDON CITY,GENEVA,219607,219607,0,176451,176451,0,24.45778
29/01/2018 17:06,2016,2,WESTERN EUROPE-OTHER,SWITZERLAND,1,LONDON CITY,ZURICH,385933,385933,0,397363,397363,0,-2.87646
29/01/2018 17:06,2016,2,WESTERN EUROPE-OTHER,SWITZERLAND,1,LUTON,ALTENRHEIN,22,0,22,0,0,0,0
29/01/2018 17:06,2016,2,WESTERN EUROPE-OTHER,SWITZERLAND,1,LUTON,BALE MULHOUSE,78190,77966,224,82807,82803,4,-5.57562
29/01/2018 17:06,2016,2,WESTERN EUROPE-OTHER,SWITZERLAND,1,LUTON,BERNE,11,0,11,99,0,99,-88.88889
29/01/2018 17:06,2016,2,WESTERN EUROPE-OTHER,SWITZERLAND,1,LUTON,GENEVA,268760,268697,63,264969,264946,23,1.43073
29/01/2018 17:06,2016,2,WESTERN EUROPE-OTHER,SWITZERLAND,1,LUTON,ZURICH,135211,135177,34,94030,93630,400,43.7956
29/01/2018 17:06,2016,2,WESTERN EUROPE-OTHER,SWITZERLAND,1,SOUTHEND,BALE MULHOUSE,124,124,0,0,0,0,0
29/01/2018 17:06,2016,2,WESTERN EUROPE-OTHER,SWITZERLAND,1,SOUTHEND,BERNE,0,0,0,8837,8757,80,-100
29/01/2018 17:06,2016,2,WESTERN EUROPE-OTHER,SWITZERLAND,1,SOUTHEND,GENEVA,28761,28761,0,26714,26714,0,7.66265
29/01/2018 17:06,2016,2,WESTERN EUROPE-OTHER,SWITZERLAND,1,SOUTHEND,ZURICH,58,58,0,0,0,0,0
29/01/2018 17:06,2016,2,WESTERN EUROPE-OTHER,SWITZERLAND,1,STANSTED,BALE MULHOUSE,109746,109088,658,101105,101105,0,8.54656
29/01/2018 17:06,2016,2,WESTERN EUROPE-OTHER,SWITZERLAND,1,STANSTED,GENEVA,61255,60446,809,59540,59540,0,2.88042
29/01/2018 17:06,2016,2,WESTERN EUROPE-OTHER,SWITZERLAND,1,STANSTED,ZURICH,185,185,0,422,422,0,-56.16114
29/01/2018 17:06,2016,2,WESTERN EUROPE-OTHER,SWITZERLAND,2,ABERDEEN,GENEVA,5114,4856,258,4377,4377,0,16.83802
29/01/2018 17:06,2016,2,WESTERN EUROPE-OTHER,SWITZERLAND,2,ABERDEEN,ZURICH,0,0,0,28,0,28,-100
29/01/2018 17:06,2016,2,WESTERN EUROPE-OTHER,SWITZERLAND,2,BELFAST INTERNATIONAL,GENEVA,23277,23277,0,25552,25418,134,-8.90341
29/01/2018 17:06,2016,2,WESTERN EUROPE-OTHER,SWITZERLAND,2,BIRMINGHAM,BERNE,44,0,44,0,0,0,0
29/01/2018 17:06,2016,2,WESTERN EUROPE-OTHER,SWITZERLAND,2,BIRMINGHAM,GENEVA,63878,59140,4738,62665,53103,9562,1.93569
29/01/2018 17:06,2016,2,WESTERN EUROPE-OTHER,SWITZERLAND,2,BIRMINGHAM,ZURICH,92345,92310,35,98991,98991,0,-6.71374
29/01/2018 17:06,2016,2,WESTERN EUROPE-OTHER,SWITZERLAND,2,BOURNEMOUTH,GENEVA,28384,28384,0,24701,24476,225,14.91033
29/01/2018 17:06,2016,2,WESTERN EUROPE-OTHER,SWITZERLAND,2,BOURNEMOUTH,ZURICH,0,0,0,46,0,46,-100
29/01/2018 17:06,2016,2,WESTERN EUROPE-OTHER,SWITZERLAND,2,BRISTOL,BALE MULHOUSE,48027,48027,0,5858,5858,0,719.85319
29/01/2018 17:06,2016,2,WESTERN EUROPE-OTHER,SWITZERLAND,2,BRISTOL,GENEVA,221909,210390,11519,206136,194214,11922,7.65174
29/01/2018 17:06,2016,2,WESTERN EUROPE-OTHER,SWITZERLAND,2,CARDIFF WALES,GENEVA,3441,3441,0,2086,2086,0,64.95686
29/01/2018 17:06,2016,2,WESTERN EUROPE-OTHER,SWITZERLAND,2,EAST MIDLANDS INTERNATIONAL,BERNE,43,0,43,28,0,28,53.57143
29/01/2018 17:06,2016,2,WESTERN EUROPE-OTHER,SWITZERLAND,2,EAST MIDLANDS INTERNATIONAL,GENEVA,5993,5993,0,4739,4739,0,26.46128
29/01/2018 17:06,2016,2,WESTERN EUROPE-OTHER,SWITZERLAND,2,EDINBURGH,BALE MULHOUSE,92061,92061,0,84779,84779,0,8.58939
29/01/2018 17:06,2016,2,WESTERN EUROPE-OTHER,SWITZERLAND,2,EDINBURGH,GENEVA,154823,144965,9858,162353,151972,10381,-4.63804
29/01/2018 17:06,2016,2,WESTERN EUROPE-OTHER,SWITZERLAND,2,EDINBURGH,ZURICH,16235,14769,1466,12072,10802,1270,34.48476
29/01/2018 17:06,2016,2,WESTERN EUROPE-OTHER,SWITZERLAND,2,EXETER,GENEVA,5706,2560,3146,5533,2225,3308,3.12669
29/01/2018 17:06,2016,2,WESTERN EUROPE-OTHER,SWITZERLAND,2,GLASGOW,GENEVA,13541,13170,371,13271,13271,0,2.03451
29/01/2018 17:06,2016,2,WESTERN EUROPE-OTHER,SWITZERLAND,2,GLASGOW,ZURICH,46,0,46,0,0,0,0
29/01/2018 17:06,2016,2,WESTERN EUROPE-OTHER,SWITZERLAND,2,GUERNSEY,GENEVA,88,0,88,0,0,0,0
29/01/2018 17:06,2016,2,WESTERN EUROPE-OTHER,SWITZERLAND,2,GUERNSEY,ZURICH,0,0,0,719,425,294,-100
29/01/2018 17:06,2016,2,WESTERN EUROPE-OTHER,SWITZERLAND,2,INVERNESS,GENEVA,2303,2303,0,1662,1662,0,38.56799
29/01/2018 17:06,2016,2,WESTERN EUROPE-OTHER,SWITZERLAND,2,INVERNESS,ZURICH,702,702,0,2207,0,2207,-68.19212
29/01/2018 17:06,2016,2,WESTERN EUROPE-OTHER,SWITZERLAND,2,ISLE OF MAN,GENEVA,1557,1557,0,2104,2104,0,-25.9981
29/01/2018 17:06,2016,2,WESTERN EUROPE-OTHER,SWITZERLAND,2,ISLE OF MAN,ZURICH,0,0,0,37,0,37,-100
29/01/2018 17:06,2016,2,WESTERN EUROPE-OTHER,SWITZERLAND,2,JERSEY,BERNE,1063,1063,0,298,298,0,256.71141
29/01/2018 17:06,2016,2,WESTERN EUROPE-OTHER,SWITZERLAND,2,JERSEY,GENEVA,4320,4320,0,5304,5304,0,-18.55204
29/01/2018 17:06,2016,2,WESTERN EUROPE-OTHER,SWITZERLAND,2,JERSEY,ZURICH,1262,1119,143,769,751,18,64.10923
29/01/2018 17:06,2016,2,WESTERN EUROPE-OTHER,SWITZERLAND,2,LEEDS BRADFORD,GENEVA,40099,40099,0,40254,40254,0,-0.38505
29/01/2018 17:06,2016,2,WESTERN EUROPE-OTHER,SWITZERLAND,2,LEEDS BRADFORD,ZURICH,1,0,1,0,0,0,0
29/01/2018 17:06,2016,2,WESTERN EUROPE-OTHER,SWITZERLAND,2,LIVERPOOL (JOHN LENNON),ALTENRHEIN,94,0,94,35,0,35,168.57143
29/01/2018 17:06,2016,2,WESTERN EUROPE-OTHER,SWITZERLAND,2,LIVERPOOL (JOHN LENNON),BALE MULHOUSE,5774,2154,3620,0,0,0,0
29/01/2018 17:06,2016,2,WESTERN EUROPE-OTHER,SWITZERLAND,2,LIVERPOOL (JOHN LENNON),BERNE,34,0,34,291,0,291,-88.31615
29/01/2018 17:06,2016,2,WESTERN EUROPE-OTHER,SWITZERLAND,2,LIVERPOOL (JOHN LENNON),GENEVA,126216,126216,0,132201,132014,187,-4.5272
29/01/2018 17:06,2016,2,WESTERN EUROPE-OTHER,SWITZERLAND,2,LIVERPOOL (JOHN LENNON),SION,15,0,15,177,0,177,-91.52542
29/01/2018 17:06,2016,2,WESTERN EUROPE-OTHER,SWITZERLAND,2,LIVERPOOL (JOHN LENNON),ZURICH,0,0,0,650,0,650,-100
29/01/2018 17:06,2016,2,WESTERN EUROPE-OTHER,SWITZERLAND,2,LYDD,GENEVA,18,0,18,0,0,0,0
29/01/2018 17:06,2016,2,WESTERN EUROPE-OTHER,SWITZERLAND,2,MANCHESTER,BALE MULHOUSE,92240,91072,1168,78036,77216,820,18.20186
29/01/2018 17:06,2016,2,WESTERN EUROPE-OTHER,SWITZERLAND,2,MANCHESTER,BERNE,2,2,0,0,0,0,0
29/01/2018 17:06,2016,2,WESTERN EUROPE-OTHER,SWITZERLAND,2,MANCHESTER,GENEVA,230319,224209,6110,182604,170871,11733,26.13031
29/01/2018 17:06,2016,2,WESTERN EUROPE-OTHER,SWITZERLAND,2,MANCHESTER,ZURICH,124416,124416,0,129701,129701,0,-4.07476
29/01/2018 17:06,2016,2,WESTERN EUROPE-OTHER,SWITZERLAND,2,NEWCASTLE,GENEVA,68226,63502,4724,61175,57053,4122,11.52595
29/01/2018 17:06,2016,2,WESTERN EUROPE-OTHER,SWITZERLAND,2,SOUTHAMPTON,BALE MULHOUSE,21,21,0,0,0,0,0
29/01/2018 17:06,2016,2,WESTERN EUROPE-OTHER,SWITZERLAND,2,SOUTHAMPTON,GENEVA,6073,5930,143,9421,9421,0,-35.53763
29/01/2018 17:06,2016,2,WESTERN EUROPE-OTHER,TURKEY,1,GATWICK,ANKARA (ESENBOGA),0,0,0,9,0,9,-100
29/01/2018 17:06,2016,2,WESTERN EUROPE-OTHER,TURKEY,1,GATWICK,ANTALYA,221147,164861,56286,289395,88919,200476,-23.58299
29/01/2018 17:06,2016,2,WESTERN EUROPE-OTHER,TURKEY,1,GATWICK,BODRUM (MILAS),112456,93179,19277,151055,78686,72369,-25.55294
29/01/2018 17:06,2016,2,WESTERN EUROPE-OTHER,TURKEY,1,GATWICK,BURSA YENISEHIR,59,0,59,0,0,0,0
29/01/2018 17:06,2016,2,WESTERN EUROPE-OTHER,TURKEY,1,GATWICK,DALAMAN,289475,236668,52807,452424,210540,241884,-36.01688
29/01/2018 17:06,2016,2,WESTERN EUROPE-OTHER,TURKEY,1,GATWICK,ISTANBUL,257161,257161,0,273046,272617,429,-5.8177
29/01/2018 17:06,2016,2,WESTERN EUROPE-OTHER,TURKEY,1,GATWICK,ISTANBUL (SABIHA GOKCEN),176108,176108,0,150805,147644,3161,16.77862
29/01/2018 17:06,2016,2,WESTERN EUROPE-OTHER,TURKEY,1,GATWICK,IZMIR (ADNAN MENDERES),54163,42071,12092,73975,32361,41614,-26.78202
29/01/2018 17:06,2016,2,WESTERN EUROPE-OTHER,TURKEY,1,HEATHROW,BODRUM (MILAS),0,0,0,6788,0,6788,-100
29/01/2018 17:06,2016,2,WESTERN EUROPE-OTHER,TURKEY,1,HEATHROW,DALAMAN,0,0,0,18370,0,18370,-100
29/01/2018 17:06,2016,2,WESTERN EUROPE-OTHER,TURKEY,1,HEATHROW,ISTANBUL,956654,956654,0,933038,932909,129,2.53109
29/01/2018 17:06,2016,2,WESTERN EUROPE-OTHER,TURKEY,1,HEATHROW,ISTANBUL (SABIHA GOKCEN),0,0,0,2019,0,2019,-100
29/01/2018 17:06,2016,2,WESTERN EUROPE-OTHER,TURKEY,1,HEATHROW,IZMIR (ADNAN MENDERES),7796,0,7796,0,0,0,0
29/01/2018 17:06,2016,2,WESTERN EUROPE-OTHER,TURKEY,1,LUTON,ANKARA (ESENBOGA),62,0,62,34,0,34,82.35294
29/01/2018 17:06,2016,2,WESTERN EUROPE-OTHER,TURKEY,1,LUTON,ANTALYA,26911,18028,8883,26062,16706,9356,3.25762
29/01/2018 17:06,2016,2,WESTERN EUROPE-OTHER,TURKEY,1,LUTON,BODRUM (MILAS),14477,14477,0,20762,11829,8933,-30.27165
29/01/2018 17:06,2016,2,WESTERN EUROPE-OTHER,TURKEY,1,LUTON,DALAMAN,36650,18451,18199,51715,31975,19740,-29.13081
29/01/2018 17:06,2016,2,WESTERN EUROPE-OTHER,TURKEY,1,LUTON,ISTANBUL,69521,69521,0,80357,80357,0,-13.48482
29/01/2018 17:06,2016,2,WESTERN EUROPE-OTHER,TURKEY,1,LUTON,ISTANBUL (SABIHA GOKCEN),71,0,71,2,0,2,3450
29/01/2018 17:06,2016,2,WESTERN EUROPE-OTHER,TURKEY,1,LUTON,IZMIR (ADNAN MENDERES),6694,6694,0,6905,6893,12,-3.05576
29/01/2018 17:06,2016,2,WESTERN EUROPE-OTHER,TURKEY,1,LUTON,NEVSEHIR KAPADOKYA ,0,0,0,170,0,170,-100
29/01/2018 17:06,2016,2,WESTERN EUROPE-OTHER,TURKEY,1,LUTON,TRABZON,51,0,51,36,0,36,41.66667
29/01/2018 17:06,2016,2,WESTERN EUROPE-OTHER,TURKEY,1,STANSTED,ADANA,267,267,0,0,0,0,0
29/01/2018 17:06,2016,2,WESTERN EUROPE-OTHER,TURKEY,1,STANSTED,ANTALYA,44732,29011,15721,64197,0,64197,-30.32073
29/01/2018 17:06,2016,2,WESTERN EUROPE-OTHER,TURKEY,1,STANSTED,BODRUM (MILAS),32740,32548,192,34196,27311,6885,-4.25781
29/01/2018 17:06,2016,2,WESTERN EUROPE-OTHER,TURKEY,1,STANSTED,DALAMAN,89696,80178,9518,102896,38087,64809,-12.82849
29/01/2018 17:06,2016,2,WESTERN EUROPE-OTHER,TURKEY,1,STANSTED,GAZIANTEP,866,163,703,1622,0,1622,-46.60912
29/01/2018 17:06,2016,2,WESTERN EUROPE-OTHER,TURKEY,1,STANSTED,ISTANBUL,14794,14794,0,69,0,69,21340.57971
29/01/2018 17:06,2016,2,WESTERN EUROPE-OTHER,TURKEY,1,STANSTED,ISTANBUL (SABIHA GOKCEN),229947,229947,0,240429,239675,754,-4.35971
29/01/2018 17:06,2016,2,WESTERN EUROPE-OTHER,TURKEY,1,STANSTED,IZMIR (ADNAN MENDERES),39563,39563,0,45564,37979,7585,-13.17049
29/01/2018 17:06,2016,2,WESTERN EUROPE-OTHER,TURKEY,2,ABERDEEN,DALAMAN,6774,0,6774,19247,0,19247,-64.8049
29/01/2018 17:06,2016,2,WESTERN EUROPE-OTHER,TURKEY,2,BELFAST INTERNATIONAL,BODRUM (MILAS),9050,0,9050,9214,0,9214,-1.7799
29/01/2018 17:06,2016,2,WESTERN EUROPE-OTHER,TURKEY,2,BELFAST INTERNATIONAL,DALAMAN,26688,0,26688,31395,0,31395,-14.99283
29/01/2018 17:06,2016,2,WESTERN EUROPE-OTHER,TURKEY,2,BELFAST INTERNATIONAL,ISTANBUL,117,0,117,0,0,0,0
29/01/2018 17:06,2016,2,WESTERN EUROPE-OTHER,TURKEY,2,BELFAST INTERNATIONAL,ISTANBUL (SABIHA GOKCEN),66,0,66,0,0,0,0
29/01/2018 17:06,2016,2,WESTERN EUROPE-OTHER,TURKEY,2,BIRMINGHAM,ANTALYA,51133,35023,16110,60928,0,60928,-16.07635
29/01/2018 17:06,2016,2,WESTERN EUROPE-OTHER,TURKEY,2,BIRMINGHAM,BODRUM (MILAS),14029,7034,6995,56790,20810,35980,-75.29671
29/01/2018 17:06,2016,2,WESTERN EUROPE-OTHER,TURKEY,2,BIRMINGHAM,BURSA YENISEHIR,54,0,54,0,0,0,0
29/01/2018 17:06,2016,2,WESTERN EUROPE-OTHER,TURKEY,2,BIRMINGHAM,DALAMAN,114486,85200,29286,170610,58499,112111,-32.89608
29/01/2018 17:06,2016,2,WESTERN EUROPE-OTHER,TURKEY,2,BIRMINGHAM,ISTANBUL,138778,138613,165,139296,139296,0,-0.37187
29/01/2018 17:06,2016,2,WESTERN EUROPE-OTHER,TURKEY,2,BIRMINGHAM,ISTANBUL (SABIHA GOKCEN),0,0,0,1380,0,1380,-100
29/01/2018 17:06,2016,2,WESTERN EUROPE-OTHER,TURKEY,2,BIRMINGHAM,IZMIR (ADNAN MENDERES),7966,7966,0,13191,0,13191,-39.61034
29/01/2018 17:06,2016,2,WESTERN EUROPE-OTHER,TURKEY,2,BOURNEMOUTH,ANTALYA,0,0,0,7240,0,7240,-100
29/01/2018 17:06,2016,2,WESTERN EUROPE-OTHER,TURKEY,2,BOURNEMOUTH,DALAMAN,15929,0,15929,16771,0,16771,-5.02057
29/01/2018 17:06,2016,2,WESTERN EUROPE-OTHER,TURKEY,2,BRISTOL,ANTALYA,28598,22188,6410,44354,0,44354,-35.52329
29/01/2018 17:06,2016,2,WESTERN EUROPE-OTHER,TURKEY,2,BRISTOL,BODRUM (MILAS),27630,22484,5146,32380,25846,6534,-14.66955
29/01/2018 17:06,2016,2,WESTERN EUROPE-OTHER,TURKEY,2,BRISTOL,DALAMAN,66407,56595,9812,89217,28598,60619,-25.56688
29/01/2018 17:06,2016,2,WESTERN EUROPE-OTHER,TURKEY,2,CARDIFF WALES,ANTALYA,0,0,0,8300,0,8300,-100
29/01/2018 17:06,2016,2,WESTERN EUROPE-OTHER,TURKEY,2,CARDIFF WALES,DALAMAN,20869,0,20869,32507,0,32507,-35.80152
29/01/2018 17:06,2016,2,WESTERN EUROPE-OTHER,TURKEY,2,DONCASTER SHEFFIELD,DALAMAN,17823,0,17823,29303,0,29303,-39.17688
29/01/2018 17:06,2016,2,WESTERN EUROPE-OTHER,TURKEY,2,EAST MIDLANDS INTERNATIONAL,ANTALYA,33492,20992,12500,31886,7545,24341,5.03669
29/01/2018 17:06,2016,2,WESTERN EUROPE-OTHER,TURKEY,2,EAST MIDLANDS INTERNATIONAL,BODRUM (MILAS),8616,8616,0,16625,8722,7903,-48.17444
29/01/2018 17:06,2016,2,WESTERN EUROPE-OTHER,TURKEY,2,EAST MIDLANDS INTERNATIONAL,DALAMAN,45712,36286,9426,66278,26477,39801,-31.0299
29/01/2018 17:06,2016,2,WESTERN EUROPE-OTHER,TURKEY,2,EDINBURGH,ANTALYA,7303,0,7303,7310,0,7310,-0.09576
29/01/2018 17:06,2016,2,WESTERN EUROPE-OTHER,TURKEY,2,EDINBURGH,BODRUM (MILAS),19602,19602,0,19009,19009,0,3.11957
29/01/2018 17:06,2016,2,WESTERN EUROPE-OTHER,TURKEY,2,EDINBURGH,DALAMAN,42869,26171,16698,36301,17993,18308,18.09317
29/01/2018 17:06,2016,2,WESTERN EUROPE-OTHER,TURKEY,2,EDINBURGH,ISTANBUL,94899,94899,0,97498,97498,0,-2.6657
29/01/2018 17:06,2016,2,WESTERN EUROPE-OTHER,TURKEY,2,EXETER,DALAMAN,14960,0,14960,18373,0,18373,-18.57617
29/01/2018 17:06,2016,2,WESTERN EUROPE-OTHER,TURKEY,2,GLASGOW,ANTALYA,53194,34988,18206,81890,15634,66256,-35.04213
29/01/2018 17:06,2016,2,WESTERN EUROPE-OTHER,TURKEY,2,GLASGOW,BODRUM (MILAS),8458,8458,0,32052,16216,15836,-73.61163
29/01/2018 17:06,2016,2,WESTERN EUROPE-OTHER,TURKEY,2,GLASGOW,DALAMAN,85983,49906,36077,131455,42312,89143,-34.59131
29/01/2018 17:06,2016,2,WESTERN EUROPE-OTHER,TURKEY,2,GLASGOW,ISTANBUL (SABIHA GOKCEN),0,0,0,893,0,893,-100
29/01/2018 17:06,2016,2,WESTERN EUROPE-OTHER,TURKEY,2,HUMBERSIDE,ANTALYA,0,0,0,364,0,364,-100
29/01/2018 17:06,2016,2,WESTERN EUROPE-OTHER,TURKEY,2,LEEDS BRADFORD,ANTALYA,18305,18305,0,33512,33512,0,-45.37778
29/01/2018 17:06,2016,2,WESTERN EUROPE-OTHER,TURKEY,2,LEEDS BRADFORD,BODRUM (MILAS),14852,14852,0,17131,17131,0,-13.30337
29/01/2018 17:06,2016,2,WESTERN EUROPE-OTHER,TURKEY,2,LEEDS BRADFORD,DALAMAN,44166,44166,0,77327,58690,18637,-42.88412
29/01/2018 17:06,2016,2,WESTERN EUROPE-OTHER,TURKEY,2,LIVERPOOL (JOHN LENNON),BODRUM (MILAS),18563,18563,0,16232,16232,0,14.36052
29/01/2018 17:06,2016,2,WESTERN EUROPE-OTHER,TURKEY,2,LIVERPOOL (JOHN LENNON),ISTANBUL (SABIHA GOKCEN),0,0,0,826,0,826,-100
29/01/2018 17:06,2016,2,WESTERN EUROPE-OTHER,TURKEY,2,MANCHESTER,ANKARA (ESENBOGA),2,2,0,0,0,0,0
29/01/2018 17:06,2016,2,WESTERN EUROPE-OTHER,TURKEY,2,MANCHESTER,ANTALYA,173934,129039,44895,215991,43171,172820,-19.47164
29/01/2018 17:06,2016,2,WESTERN EUROPE-OTHER,TURKEY,2,MANCHESTER,BODRUM (MILAS),53452,34969,18483,75018,19517,55501,-28.74777
29/01/2018 17:06,2016,2,WESTERN EUROPE-OTHER,TURKEY,2,MANCHESTER,CORLU (AFB),0,0,0,130,0,130,-100
29/01/2018 17:06,2016,2,WESTERN EUROPE-OTHER,TURKEY,2,MANCHESTER,DALAMAN,230097,184587,45510,411777,168662,243115,-44.12097
29/01/2018 17:06,2016,2,WESTERN EUROPE-OTHER,TURKEY,2,MANCHESTER,ISTANBUL,258276,258157,119,247367,247367,0,4.41005
29/01/2018 17:06,2016,2,WESTERN EUROPE-OTHER,TURKEY,2,MANCHESTER,ISTANBUL (SABIHA GOKCEN),757,0,757,2601,0,2601,-70.89581
29/01/2018 17:06,2016,2,WESTERN EUROPE-OTHER,TURKEY,2,MANCHESTER,IZMIR (ADNAN MENDERES),33755,23877,9878,39177,0,39177,-13.83975
29/01/2018 17:06,2016,2,WESTERN EUROPE-OTHER,TURKEY,2,MANCHESTER,TEKIRDAG (CORLU),0,0,0,773,0,773,-100
29/01/2018 17:06,2016,2,WESTERN EUROPE-OTHER,TURKEY,2,NEWCASTLE,ANTALYA,31607,31607,0,40630,7857,32773,-22.20773
29/01/2018 17:06,2016,2,WESTERN EUROPE-OTHER,TURKEY,2,NEWCASTLE,BODRUM (MILAS),17251,17251,0,19234,8772,10462,-10.30987
29/01/2018 17:06,2016,2,WESTERN EUROPE-OTHER,TURKEY,2,NEWCASTLE,DALAMAN,78001,77527,474,126517,26985,99532,-38.34742
29/01/2018 17:06,2016,2,WESTERN EUROPE-OTHER,TURKEY,2,NORWICH,ANTALYA,0,0,0,282,0,282,-100
29/01/2018 17:06,2016,2,WESTERN EUROPE-OTHER,TURKEY,2,NORWICH,DALAMAN,0,0,0,13318,0,13318,-100
29/01/2018 17:06,2016,3,EASTERN EUROPE-EU,BULGARIA,1,GATWICK,BURGAS,50195,18908,31287,37500,0,37500,33.85333
29/01/2018 17:06,2016,3,EASTERN EUROPE-EU,BULGARIA,1,GATWICK,PLOVDIV,0,0,0,2918,0,2918,-100
29/01/2018 17:06,2016,3,EASTERN EUROPE-EU,BULGARIA,1,GATWICK,ROUSE,482,0,482,0,0,0,0
29/01/2018 17:06,2016,3,EASTERN EUROPE-EU,BULGARIA,1,GATWICK,SOFIA,131602,123751,7851,126376,114923,11453,4.13528
29/01/2018 17:06,2016,3,EASTERN EUROPE-EU,BULGARIA,1,GATWICK,VARNA,2865,0,2865,1965,0,1965,45.80153
29/01/2018 17:06,2016,3,EASTERN EUROPE-EU,BULGARIA,1,HEATHROW,SOFIA,163653,163653,0,182313,182313,0,-10.23515
29/01/2018 17:06,2016,3,EASTERN EUROPE-EU,BULGARIA,1,LUTON,BURGAS,79124,72024,7100,81774,74903,6871,-3.24064
29/01/2018 17:06,2016,3,EASTERN EUROPE-EU,BULGARIA,1,LUTON,SOFIA,279840,279840,0,231215,231215,0,21.03021
29/01/2018 17:06,2016,3,EASTERN EUROPE-EU,BULGARIA,1,LUTON,VARNA,89099,89099,0,75005,75005,0,18.79075
29/01/2018 17:06,2016,3,EASTERN EUROPE-EU,BULGARIA,1,STANSTED,BURGAS,4047,2116,1931,2247,0,2247,80.10681
29/01/2018 17:06,2016,3,EASTERN EUROPE-EU,BULGARIA,1,STANSTED,PLOVDIV,54518,54518,0,54612,54612,0,-0.17212
29/01/2018 17:06,2016,3,EASTERN EUROPE-EU,BULGARIA,1,STANSTED,SOFIA,115885,115676,209,11508,11508,0,906.99513
29/01/2018 17:06,2016,3,EASTERN EUROPE-EU,BULGARIA,2,ABERDEEN,BURGAS,6793,0,6793,5638,0,5638,20.48599
29/01/2018 17:06,2016,3,EASTERN EUROPE-EU,BULGARIA,2,BELFAST INTERNATIONAL,BURGAS,15998,0,15998,13208,0,13208,21.12356
29/01/2018 17:06,2016,3,EASTERN EUROPE-EU,BULGARIA,2,BELFAST INTERNATIONAL,PLOVDIV,3494,0,3494,2923,0,2923,19.53472
29/01/2018 17:06,2016,3,EASTERN EUROPE-EU,BULGARIA,2,BELFAST INTERNATIONAL,SOFIA,264,0,264,0,0,0,0
29/01/2018 17:06,2016,3,EASTERN EUROPE-EU,BULGARIA,2,BIRMINGHAM,BURGAS,28538,7017,21521,21330,0,21330,33.79278
29/01/2018 17:06,2016,3,EASTERN EUROPE-EU,BULGARIA,2,BIRMINGHAM,SOFIA,41985,38444,3541,3423,0,3423,1126.55565
29/01/2018 17:06,2016,3,EASTERN EUROPE-EU,BULGARIA,2,BRISTOL,BURGAS,13155,0,13155,19727,0,19727,-33.31475
29/01/2018 17:06,2016,3,EASTERN EUROPE-EU,BULGARIA,2,BRISTOL,SOFIA,35439,31181,4258,4051,0,4051,774.82103
29/01/2018 17:06,2016,3,EASTERN EUROPE-EU,BULGARIA,2,CARDIFF WALES,BURGAS,18199,0,18199,12882,0,12882,41.27465
29/01/2018 17:06,2016,3,EASTERN EUROPE-EU,BULGARIA,2,DONCASTER SHEFFIELD,BURGAS,5812,0,5812,5222,0,5222,11.29835
29/01/2018 17:06,2016,3,EASTERN EUROPE-EU,BULGARIA,2,DONCASTER SHEFFIELD,SOFIA,857,857,0,0,0,0,0
29/01/2018 17:06,2016,3,EASTERN EUROPE-EU,BULGARIA,2,EAST MIDLANDS INTERNATIONAL,BURGAS,24327,7289,17038,19375,0,19375,25.55871
29/01/2018 17:06,2016,3,EASTERN EUROPE-EU,BULGARIA,2,EAST MIDLANDS INTERNATIONAL,SOFIA,3087,69,3018,4460,0,4460,-30.78475
29/01/2018 17:06,2016,3,EASTERN EUROPE-EU,BULGARIA,2,EDINBURGH,BURGAS,10440,0,10440,10297,0,10297,1.38875
29/01/2018 17:06,2016,3,EASTERN EUROPE-EU,BULGARIA,2,EDINBURGH,SOFIA,127,0,127,0,0,0,0
29/01/2018 17:06,2016,3,EASTERN EUROPE-EU,BULGARIA,2,GLASGOW,BURGAS,20528,3062,17466,23357,0,23357,-12.112
29/01/2018 17:06,2016,3,EASTERN EUROPE-EU,BULGARIA,2,GLASGOW,SOFIA,10534,10534,0,0,0,0,0
29/01/2018 17:06,2016,3,EASTERN EUROPE-EU,BULGARIA,2,GLASGOW,VARNA,1224,0,1224,0,0,0,0
29/01/2018 17:06,2016,3,EASTERN EUROPE-EU,BULGARIA,2,HUMBERSIDE,BURGAS,6195,0,6195,4932,0,4932,25.60827
29/01/2018 17:06,2016,3,EASTERN EUROPE-EU,BULGARIA,2,HUMBERSIDE,SOFIA,0,0,0,183,0,183,-100
29/01/2018 17:06,2016,3,EASTERN EUROPE-EU,BULGARIA,2,LEEDS BRADFORD,BURGAS,5937,0,5937,4817,0,4817,23.25099
29/01/2018 17:06,2016,3,EASTERN EUROPE-EU,BULGARIA,2,LIVERPOOL (JOHN LENNON),SOFIA,10861,10861,0,0,0,0,0
29/01/2018 17:06,2016,3,EASTERN EUROPE-EU,BULGARIA,2,MANCHESTER,BURGAS,77221,27676,49545,64549,10072,54477,19.6316
29/01/2018 17:06,2016,3,EASTERN EUROPE-EU,BULGARIA,2,MANCHESTER,SOFIA,65037,57874,7163,57365,49002,8363,13.37401
29/01/2018 17:06,2016,3,EASTERN EUROPE-EU,BULGARIA,2,MANCHESTER,VARNA,6013,0,6013,6035,0,6035,-0.36454
29/01/2018 17:06,2016,3,EASTERN EUROPE-EU,BULGARIA,2,NEWCASTLE,BURGAS,28222,28222,0,28977,0,28977,-2.60551
29/01/2018 17:06,2016,3,EASTERN EUROPE-EU,BULGARIA,2,NEWCASTLE,SOFIA,2598,92,2506,2106,0,2106,23.36182
29/01/2018 17:06,2016,3,EASTERN EUROPE-EU,BULGARIA,2,NORWICH,BURGAS,0,0,0,4279,0,4279,-100
29/01/2018 17:06,2016,3,EASTERN EUROPE-EU,CZECH REPUBLIC,1,GATWICK,PRAGUE,343771,343769,2,243500,243461,39,41.17906
29/01/2018 17:06,2016,3,EASTERN EUROPE-EU,CZECH REPUBLIC,1,HEATHROW,PRAGUE,433214,433214,0,433345,433345,0,-0.03023
29/01/2018 17:06,2016,3,EASTERN EUROPE-EU,CZECH REPUBLIC,1,LUTON,BRNO (TURANY),46758,46758,0,45470,45470,0,2.83264
29/01/2018 17:06,2016,3,EASTERN EUROPE-EU,CZECH REPUBLIC,1,LUTON,PRAGUE,122408,122289,119,126735,126519,216,-3.41421
29/01/2018 17:06,2016,3,EASTERN EUROPE-EU,CZECH REPUBLIC,1,SOUTHEND,PRAGUE,0,0,0,33,0,33,-100
29/01/2018 17:06,2016,3,EASTERN EUROPE-EU,CZECH REPUBLIC,1,STANSTED,BRNO (TURANY),113883,113883,0,116274,116274,0,-2.05635
29/01/2018 17:06,2016,3,EASTERN EUROPE-EU,CZECH REPUBLIC,1,STANSTED,OSTRAVA,61978,61978,0,57526,57526,0,7.73911
29/01/2018 17:06,2016,3,EASTERN EUROPE-EU,CZECH REPUBLIC,1,STANSTED,PRAGUE,351882,351882,0,333672,333444,228,5.45746
29/01/2018 17:06,2016,3,EASTERN EUROPE-EU,CZECH REPUBLIC,2,BELFAST INTERNATIONAL,PRAGUE,522,362,160,19641,19641,0,-97.34229
29/01/2018 17:06,2016,3,EASTERN EUROPE-EU,CZECH REPUBLIC,2,BIRMINGHAM,BRNO (TURANY),0,0,0,43,0,43,-100
29/01/2018 17:06,2016,3,EASTERN EUROPE-EU,CZECH REPUBLIC,2,BIRMINGHAM,PRAGUE,36908,36565,343,106,0,106,34718.86792
29/01/2018 17:06,2016,3,EASTERN EUROPE-EU,CZECH REPUBLIC,2,BOURNEMOUTH,PRAGUE,720,0,720,0,0,0,0
29/01/2018 17:06,2016,3,EASTERN EUROPE-EU,CZECH REPUBLIC,2,BRISTOL,PRAGUE,68100,68100,0,65469,65469,0,4.0187
29/01/2018 17:06,2016,3,EASTERN EUROPE-EU,CZECH REPUBLIC,2,CARDIFF WALES,PRAGUE,94,0,94,0,0,0,0
29/01/2018 17:06,2016,3,EASTERN EUROPE-EU,CZECH REPUBLIC,2,EAST MIDLANDS INTERNATIONAL,PRAGUE,23362,23362,0,26119,26119,0,-10.55553
29/01/2018 17:06,2016,3,EASTERN EUROPE-EU,CZECH REPUBLIC,2,EDINBURGH,PRAGUE,71422,71101,321,73992,73992,0,-3.47335
29/01/2018 17:06,2016,3,EASTERN EUROPE-EU,CZECH REPUBLIC,2,GLASGOW,PRAGUE,26487,26313,174,22277,22163,114,18.89842
29/01/2018 17:06,2016,3,EASTERN EUROPE-EU,CZECH REPUBLIC,2,INVERNESS,BRNO (TURANY),0,0,0,82,0,82,-100
29/01/2018 17:06,2016,3,EASTERN EUROPE-EU,CZECH REPUBLIC,2,INVERNESS,PRAGUE,0,0,0,82,0,82,-100
29/01/2018 17:06,2016,3,EASTERN EUROPE-EU,CZECH REPUBLIC,2,LEEDS BRADFORD,PRAGUE,34145,34145,0,34304,34304,0,-0.4635
29/01/2018 17:06,2016,3,EASTERN EUROPE-EU,CZECH REPUBLIC,2,LIVERPOOL (JOHN LENNON),PRAGUE,12435,12435,0,3838,3838,0,223.99687
29/01/2018 17:06,2016,3,EASTERN EUROPE-EU,CZECH REPUBLIC,2,MANCHESTER,PRAGUE,151612,151612,0,118455,118368,87,27.99122
29/01/2018 17:06,2016,3,EASTERN EUROPE-EU,CZECH REPUBLIC,2,NEWCASTLE,PRAGUE,26194,26194,0,25547,25547,0,2.53259
29/01/2018 17:06,2016,3,EASTERN EUROPE-EU,ESTONIA,1,GATWICK,TALLIN,31154,31154,0,53770,53770,0,-42.06063
29/01/2018 17:06,2016,3,EASTERN EUROPE-EU,ESTONIA,1,LUTON,TALLIN,0,0,0,8,0,8,-100
29/01/2018 17:06,2016,3,EASTERN EUROPE-EU,ESTONIA,1,STANSTED,TALLIN,75076,75076,0,72491,72491,0,3.56596
29/01/2018 17:06,2016,3,EASTERN EUROPE-EU,ESTONIA,2,ABERDEEN,TALLIN,0,0,0,44,0,44,-100
29/01/2018 17:06,2016,3,EASTERN EUROPE-EU,ESTONIA,2,BRISTOL,TALLIN,0,0,0,6,0,6,-100
29/01/2018 17:06,2016,3,EASTERN EUROPE-EU,ESTONIA,2,EDINBURGH,TALLIN,144,0,144,0,0,0,0
29/01/2018 17:06,2016,3,EASTERN EUROPE-EU,ESTONIA,2,GLASGOW,TALLIN,0,0,0,152,0,152,-100
29/01/2018 17:06,2016,3,EASTERN EUROPE-EU,ESTONIA,2,LIVERPOOL (JOHN LENNON),TALLIN,280,0,280,0,0,0,0
29/01/2018 17:06,2016,3,EASTERN EUROPE-EU,ESTONIA,2,MANCHESTER,TALLIN,0,0,0,20639,20639,0,-100
29/01/2018 17:06,2016,3,EASTERN EUROPE-EU,HUNGARY,1,GATWICK,BUDAPEST,226442,225966,476,185030,184593,437,22.38124
29/01/2018 17:06,2016,3,EASTERN EUROPE-EU,HUNGARY,1,HEATHROW,BUDAPEST,329022,329022,0,291955,291955,0,12.69613
29/01/2018 17:06,2016,3,EASTERN EUROPE-EU,HUNGARY,1,LUTON,BUDAPEST,572472,572472,0,468107,467949,158,22.29512
29/01/2018 17:06,2016,3,EASTERN EUROPE-EU,HUNGARY,1,LUTON,DEBRECEN,135199,135199,0,108515,108515,0,24.59015
29/01/2018 17:06,2016,3,EASTERN EUROPE-EU,HUNGARY,1,STANSTED,BUDAPEST,369838,369838,0,368605,368446,159,0.3345
29/01/2018 17:06,2016,3,EASTERN EUROPE-EU,HUNGARY,2,ABERDEEN,BUDAPEST,175,175,0,0,0,0,0
29/01/2018 17:06,2016,3,EASTERN EUROPE-EU,HUNGARY,2,BELFAST INTERNATIONAL,BUDAPEST,0,0,0,362,0,362,-100
29/01/2018 17:06,2016,3,EASTERN EUROPE-EU,HUNGARY,2,BIRMINGHAM,BUDAPEST,45905,45905,0,9225,9147,78,397.61518
29/01/2018 17:06,2016,3,EASTERN EUROPE-EU,HUNGARY,2,BRISTOL,BUDAPEST,56541,56541,0,57028,57028,0,-0.85397
29/01/2018 17:06,2016,3,EASTERN EUROPE-EU,HUNGARY,2,DONCASTER SHEFFIELD,BUDAPEST,135,135,0,0,0,0,0
29/01/2018 17:06,2016,3,EASTERN EUROPE-EU,HUNGARY,2,EAST MIDLANDS INTERNATIONAL,BUDAPEST,20735,20735,0,25101,25101,0,-17.39373
29/01/2018 17:06,2016,3,EASTERN EUROPE-EU,HUNGARY,2,EDINBURGH,BUDAPEST,44247,44247,0,43178,43178,0,2.4758
29/01/2018 17:06,2016,3,EASTERN EUROPE-EU,HUNGARY,2,GLASGOW,BUDAPEST,42434,42434,0,17421,17278,143,143.57959
29/01/2018 17:06,2016,3,EASTERN EUROPE-EU,HUNGARY,2,LEEDS BRADFORD,BUDAPEST,27707,27707,0,26496,26496,0,4.5705
29/01/2018 17:06,2016,3,EASTERN EUROPE-EU,HUNGARY,2,LIVERPOOL (JOHN LENNON),BUDAPEST,25368,25368,0,0,0,0,0
29/01/2018 17:06,2016,3,EASTERN EUROPE-EU,HUNGARY,2,MANCHESTER,BUDAPEST,135779,135437,342,135536,135367,169,0.17929
29/01/2018 17:06,2016,3,EASTERN EUROPE-EU,LATVIA,1,GATWICK,RIGA,108894,108894,0,87226,87226,0,24.84122
29/01/2018 17:06,2016,3,EASTERN EUROPE-EU,LATVIA,1,LUTON,RIGA,171218,171218,0,154227,154227,0,11.01688
29/01/2018 17:06,2016,3,EASTERN EUROPE-EU,LATVIA,1,STANSTED,RIGA,258113,258113,0,255605,255605,0,0.9812
29/01/2018 17:06,2016,3,EASTERN EUROPE-EU,LATVIA,2,ABERDEEN,RIGA,186,92,94,0,0,0,0
29/01/2018 17:06,2016,3,EASTERN EUROPE-EU,LATVIA,2,BELFAST INTERNATIONAL,RIGA,0,0,0,67,0,67,-100
29/01/2018 17:06,2016,3,EASTERN EUROPE-EU,LATVIA,2,DONCASTER SHEFFIELD,RIGA,38796,38796,0,33410,33410,0,16.12092
29/01/2018 17:06,2016,3,EASTERN EUROPE-EU,LATVIA,2,EAST MIDLANDS INTERNATIONAL,RIGA,58333,58333,0,59526,59526,0,-2.00417
29/01/2018 17:06,2016,3,EASTERN EUROPE-EU,LATVIA,2,GLASGOW,RIGA,29355,29355,0,20325,20325,0,44.42804
29/01/2018 17:06,2016,3,EASTERN EUROPE-EU,LATVIA,2,LEEDS BRADFORD,RIGA,35635,35635,0,34740,34740,0,2.57628
29/01/2018 17:06,2016,3,EASTERN EUROPE-EU,LATVIA,2,LIVERPOOL (JOHN LENNON),RIGA,30712,30712,0,20281,20281,0,51.43238
29/01/2018 17:06,2016,3,EASTERN EUROPE-EU,LATVIA,2,MANCHESTER,RIGA,55687,55687,0,52951,52951,0,5.16704
29/01/2018 17:06,2016,3,EASTERN EUROPE-EU,LITHUANIA,1,GATWICK,KAUNAS,46823,46823,0,55465,55465,0,-15.581
29/01/2018 17:06,2016,3,EASTERN EUROPE-EU,LITHUANIA,1,GATWICK,VILNIUS,25,0,25,415,0,415,-93.9759
29/01/2018 17:06,2016,3,EASTERN EUROPE-EU,LITHUANIA,1,LUTON,KAUNAS,177131,177131,0,86289,86289,0,105.27645
29/01/2018 17:06,2016,3,EASTERN EUROPE-EU,LITHUANIA,1,LUTON,PALANGA,36263,36263,0,0,0,0,0
29/01/2018 17:06,2016,3,EASTERN EUROPE-EU,LITHUANIA,1,LUTON,VILNIUS,297840,297840,0,230143,230091,52,29.41519
29/01/2018 17:06,2016,3,EASTERN EUROPE-EU,LITHUANIA,1,STANSTED,KAUNAS,47462,47462,0,134168,134168,0,-64.62495
29/01/2018 17:06,2016,3,EASTERN EUROPE-EU,LITHUANIA,1,STANSTED,PALANGA,29129,29129,0,0,0,0,0
29/01/2018 17:06,2016,3,EASTERN EUROPE-EU,LITHUANIA,1,STANSTED,VILNIUS,129487,129487,0,128544,128544,0,0.7336
29/01/2018 17:06,2016,3,EASTERN EUROPE-EU,LITHUANIA,2,ABERDEEN,VILNIUS,0,0,0,3,0,3,-100
29/01/2018 17:06,2016,3,EASTERN EUROPE-EU,LITHUANIA,2,BELFAST INTERNATIONAL,VILNIUS,29897,29897,0,21777,21777,0,37.28705
29/01/2018 17:06,2016,3,EASTERN EUROPE-EU,LITHUANIA,2,BIRMINGHAM,KAUNAS,8321,8321,0,34763,34763,0,-76.06363
29/01/2018 17:06,2016,3,EASTERN EUROPE-EU,LITHUANIA,2,BIRMINGHAM,VILNIUS,27694,27694,0,0,0,0,0
29/01/2018 17:06,2016,3,EASTERN EUROPE-EU,LITHUANIA,2,BRISTOL,KAUNAS,37947,37947,0,36704,36704,0,3.38655
29/01/2018 17:06,2016,3,EASTERN EUROPE-EU,LITHUANIA,2,DONCASTER SHEFFIELD,VILNIUS,41795,41795,0,40597,40597,0,2.95096
29/01/2018 17:06,2016,3,EASTERN EUROPE-EU,LITHUANIA,2,EDINBURGH,KAUNAS,21099,21099,0,21276,21276,0,-0.83192
29/01/2018 17:06,2016,3,EASTERN EUROPE-EU,LITHUANIA,2,EDINBURGH,VILNIUS,0,0,0,258,0,258,-100
29/01/2018 17:06,2016,3,EASTERN EUROPE-EU,LITHUANIA,2,GLASGOW,VILNIUS,15084,14972,112,8222,8222,0,83.45901
29/01/2018 17:06,2016,3,EASTERN EUROPE-EU,LITHUANIA,2,LEEDS BRADFORD,VILNIUS,5520,5520,0,0,0,0,0
29/01/2018 17:06,2016,3,EASTERN EUROPE-EU,LITHUANIA,2,LIVERPOOL (JOHN LENNON),VILNIUS,36432,36432,0,37103,37103,0,-1.80848
29/01/2018 17:06,2016,3,EASTERN EUROPE-EU,POLAND,1,GATWICK,KRAKOW,133952,133083,869,105487,104640,847,26.98437
29/01/2018 17:06,2016,3,EASTERN EUROPE-EU,POLAND,1,GATWICK,RZESZOW,359,0,359,359,0,359,0
29/01/2018 17:06,2016,3,EASTERN EUROPE-EU,POLAND,1,GATWICK,WARSAW (CHOPIN),66994,66994,0,84334,84334,0,-20.5611
29/01/2018 17:06,2016,3,EASTERN EUROPE-EU,POLAND,1,GATWICK,WROCLAW,107,0,107,0,0,0,0
29/01/2018 17:06,2016,3,EASTERN EUROPE-EU,POLAND,1,HEATHROW,KRAKOW,84174,84174,0,38287,38287,0,119.85008
29/01/2018 17:06,2016,3,EASTERN EUROPE-EU,POLAND,1,HEATHROW,WARSAW (CHOPIN),408657,408657,0,417107,417107,0,-2.02586
29/01/2018 17:06,2016,3,EASTERN EUROPE-EU,POLAND,1,LUTON,BYDGOSZCZ,145,145,0,777,0,777,-81.33848
29/01/2018 17:06,2016,3,EASTERN EUROPE-EU,POLAND,1,LUTON,GDANSK,268657,268643,14,270356,270221,135,-0.62843
29/01/2018 17:06,2016,3,EASTERN EUROPE-EU,POLAND,1,LUTON,KATOWICE,314117,314117,0,299739,299739,0,4.79684
29/01/2018 17:06,2016,3,EASTERN EUROPE-EU,POLAND,1,LUTON,KRAKOW,808,0,808,876,0,876,-7.76256
29/01/2018 17:06,2016,3,EASTERN EUROPE-EU,POLAND,1,LUTON,LUBLIN (PORT LOTNICZY),106103,106103,0,88724,88724,0,19.58771
29/01/2018 17:06,2016,3,EASTERN EUROPE-EU,POLAND,1,LUTON,POZNAN,168258,168258,0,136493,136493,0,23.27226
29/01/2018 17:06,2016,3,EASTERN EUROPE-EU,POLAND,1,LUTON,RZESZOW,56588,56588,0,54681,54681,0,3.4875
29/01/2018 17:06,2016,3,EASTERN EUROPE-EU,POLAND,1,LUTON,SZCZECIN (GOLENOW),47079,47079,0,44842,44842,0,4.98863
29/01/2018 17:06,2016,3,EASTERN EUROPE-EU,POLAND,1,LUTON,SZYMANY (MAZURY),22897,22897,0,0,0,0,0
29/01/2018 17:06,2016,3,EASTERN EUROPE-EU,POLAND,1,LUTON,WARSAW (CHOPIN),400944,400736,208,356462,356462,0,12.47875
29/01/2018 17:06,2016,3,EASTERN EUROPE-EU,POLAND,1,LUTON,WROCLAW,116274,116274,0,103239,103239,0,12.62604
29/01/2018 17:06,2016,3,EASTERN EUROPE-EU,POLAND,1,STANSTED,BYDGOSZCZ,120188,120188,0,113907,113907,0,5.51415
29/01/2018 17:06,2016,3,EASTERN EUROPE-EU,POLAND,1,STANSTED,GDANSK,214893,214893,0,207284,207284,0,3.67081
29/01/2018 17:06,2016,3,EASTERN EUROPE-EU,POLAND,1,STANSTED,KATOWICE,132021,132021,0,132461,132461,0,-0.33217
29/01/2018 17:06,2016,3,EASTERN EUROPE-EU,POLAND,1,STANSTED,KRAKOW,352119,351737,382,307139,306043,1096,14.64484
29/01/2018 17:06,2016,3,EASTERN EUROPE-EU,POLAND,1,STANSTED,LODZ LUBLINEK,109484,109484,0,106128,106128,0,3.16222
29/01/2018 17:06,2016,3,EASTERN EUROPE-EU,POLAND,1,STANSTED,LUBLIN (PORT LOTNICZY),69556,69556,0,68294,68294,0,1.84789
29/01/2018 17:06,2016,3,EASTERN EUROPE-EU,POLAND,1,STANSTED,POZNAN,131277,131277,0,124916,124916,0,5.09222
29/01/2018 17:06,2016,3,EASTERN EUROPE-EU,POLAND,1,STANSTED,RZESZOW,144844,144844,0,140157,140157,0,3.34411
29/01/2018 17:06,2016,3,EASTERN EUROPE-EU,POLAND,1,STANSTED,SZCZECIN (GOLENOW),111168,111168,0,98677,98677,0,12.65847
29/01/2018 17:06,2016,3,EASTERN EUROPE-EU,POLAND,1,STANSTED,SZYMANY (MAZURY),7262,7262,0,0,0,0,0
29/01/2018 17:06,2016,3,EASTERN EUROPE-EU,POLAND,1,STANSTED,WARSAW (CHOPIN),150,150,0,0,0,0,0
29/01/2018 17:06,2016,3,EASTERN EUROPE-EU,POLAND,1,STANSTED,WARSAW (MODLIN MASOVIA),432509,432509,0,371836,371836,0,16.31714
29/01/2018 17:06,2016,3,EASTERN EUROPE-EU,POLAND,1,STANSTED,WROCLAW,224462,224462,0,209654,209654,0,7.06307
29/01/2018 17:06,2016,3,EASTERN EUROPE-EU,POLAND,2,ABERDEEN,GDANSK,36826,36826,0,18118,18118,0,103.25643
29/01/2018 17:06,2016,3,EASTERN EUROPE-EU,POLAND,2,ABERDEEN,WARSAW (CHOPIN),21470,21470,0,0,0,0,0
29/01/2018 17:06,2016,3,EASTERN EUROPE-EU,POLAND,2,BELFAST INTERNATIONAL,GDANSK,5004,5004,0,0,0,0,0
29/01/2018 17:06,2016,3,EASTERN EUROPE-EU,POLAND,2,BELFAST INTERNATIONAL,KATOWICE,27851,27851,0,23155,23155,0,20.28072
29/01/2018 17:06,2016,3,EASTERN EUROPE-EU,POLAND,2,BELFAST INTERNATIONAL,KRAKOW,54580,54580,0,44157,44157,0,23.60441
29/01/2018 17:06,2016,3,EASTERN EUROPE-EU,POLAND,2,BELFAST INTERNATIONAL,WARSAW (MODLIN MASOVIA),5761,5761,0,0,0,0,0
29/01/2018 17:06,2016,3,EASTERN EUROPE-EU,POLAND,2,BELFAST INTERNATIONAL,WROCLAW,4986,4986,0,0,0,0,0
29/01/2018 17:06,2016,3,EASTERN EUROPE-EU,POLAND,2,BIRMINGHAM,BYDGOSZCZ,55647,55647,0,52020,52020,0,6.97232
29/01/2018 17:06,2016,3,EASTERN EUROPE-EU,POLAND,2,BIRMINGHAM,GDANSK,36874,36874,0,39394,39394,0,-6.39691
29/01/2018 17:06,2016,3,EASTERN EUROPE-EU,POLAND,2,BIRMINGHAM,KATOWICE,37018,37018,0,37154,37105,49,-0.36604
29/01/2018 17:06,2016,3,EASTERN EUROPE-EU,POLAND,2,BIRMINGHAM,KRAKOW,39234,38027,1207,38173,37349,824,2.77945
29/01/2018 17:06,2016,3,EASTERN EUROPE-EU,POLAND,2,BIRMINGHAM,POZNAN,31333,31333,0,863,863,0,3530.70684
29/01/2018 17:06,2016,3,EASTERN EUROPE-EU,POLAND,2,BIRMINGHAM,WARSAW (CHOPIN),41967,41967,0,9027,9027,0,364.90528
29/01/2018 17:06,2016,3,EASTERN EUROPE-EU,POLAND,2,BIRMINGHAM,WARSAW (MODLIN MASOVIA),7862,7862,0,0,0,0,0
29/01/2018 17:06,2016,3,EASTERN EUROPE-EU,POLAND,2,BIRMINGHAM,WROCLAW,25303,25303,0,0,0,0,0
29/01/2018 17:06,2016,3,EASTERN EUROPE-EU,POLAND,2,BOURNEMOUTH,KRAKOW,6234,6234,0,0,0,0,0
29/01/2018 17:06,2016,3,EASTERN EUROPE-EU,POLAND,2,BRISTOL,GDANSK,39397,39397,0,37815,37815,0,4.18353
29/01/2018 17:06,2016,3,EASTERN EUROPE-EU,POLAND,2,BRISTOL,KATOWICE,42789,42789,0,21856,21856,0,95.7769
29/01/2018 17:06,2016,3,EASTERN EUROPE-EU,POLAND,2,BRISTOL,KRAKOW,112119,112119,0,59842,59842,0,87.35838
29/01/2018 17:06,2016,3,EASTERN EUROPE-EU,POLAND,2,BRISTOL,POZNAN,37686,37686,0,35257,35257,0,6.88941
29/01/2018 17:06,2016,3,EASTERN EUROPE-EU,POLAND,2,BRISTOL,RZESZOW,37904,37904,0,28491,28491,0,33.0385
29/01/2018 17:06,2016,3,EASTERN EUROPE-EU,POLAND,2,BRISTOL,WARSAW (CHOPIN),20217,20217,0,0,0,0,0
29/01/2018 17:06,2016,3,EASTERN EUROPE-EU,POLAND,2,BRISTOL,WARSAW (MODLIN MASOVIA),59307,59307,0,55946,55946,0,6.00758
29/01/2018 17:06,2016,3,EASTERN EUROPE-EU,POLAND,2,BRISTOL,WROCLAW,43137,43137,0,38130,38130,0,13.13139
29/01/2018 17:06,2016,3,EASTERN EUROPE-EU,POLAND,2,CARDIFF WALES,GDANSK,367,367,0,0,0,0,0
29/01/2018 17:06,2016,3,EASTERN EUROPE-EU,POLAND,2,CARDIFF WALES,KRAKOW,369,0,369,366,0,366,0.81967
29/01/2018 17:06,2016,3,EASTERN EUROPE-EU,POLAND,2,DONCASTER SHEFFIELD,GDANSK,81458,81458,0,76029,76029,0,7.1407
29/01/2018 17:06,2016,3,EASTERN EUROPE-EU,POLAND,2,DONCASTER SHEFFIELD,KATOWICE,94917,94917,0,77627,77627,0,22.27318
29/01/2018 17:06,2016,3,EASTERN EUROPE-EU,POLAND,2,DONCASTER SHEFFIELD,LUBLIN (PORT LOTNICZY),40241,40241,0,9348,9348,0,330.47711
29/01/2018 17:06,2016,3,EASTERN EUROPE-EU,POLAND,2,DONCASTER SHEFFIELD,POZNAN,75906,75906,0,54101,54101,0,40.30425
29/01/2018 17:06,2016,3,EASTERN EUROPE-EU,POLAND,2,DONCASTER SHEFFIELD,WARSAW (CHOPIN),57298,57298,0,44286,44286,0,29.38175
29/01/2018 17:06,2016,3,EASTERN EUROPE-EU,POLAND,2,DONCASTER SHEFFIELD,WARSAW (MODLIN MASOVIA),0,0,0,144,144,0,-100
29/01/2018 17:06,2016,3,EASTERN EUROPE-EU,POLAND,2,DONCASTER SHEFFIELD,WROCLAW,51969,51969,0,48618,48618,0,6.89251
29/01/2018 17:06,2016,3,EASTERN EUROPE-EU,POLAND,2,EAST MIDLANDS INTERNATIONAL,KRAKOW,56202,55769,433,46814,46383,431,20.05383
29/01/2018 17:06,2016,3,EASTERN EUROPE-EU,POLAND,2,EAST MIDLANDS INTERNATIONAL,LODZ LUBLINEK,37846,37846,0,46701,46701,0,-18.96105
29/01/2018 17:06,2016,3,EASTERN EUROPE-EU,POLAND,2,EAST MIDLANDS INTERNATIONAL,RZESZOW,54402,54402,0,55202,55202,0,-1.44922
29/01/2018 17:06,2016,3,EASTERN EUROPE-EU,POLAND,2,EAST MIDLANDS INTERNATIONAL,WARSAW (CHOPIN),161,161,0,21,0,21,666.66667
29/01/2018 17:06,2016,3,EASTERN EUROPE-EU,POLAND,2,EAST MIDLANDS INTERNATIONAL,WARSAW (MODLIN MASOVIA),53702,53702,0,53860,53860,0,-0.29335
29/01/2018 17:06,2016,3,EASTERN EUROPE-EU,POLAND,2,EAST MIDLANDS INTERNATIONAL,WROCLAW,83116,83116,0,81458,81458,0,2.0354
29/01/2018 17:06,2016,3,EASTERN EUROPE-EU,POLAND,2,EDINBURGH,GDANSK,56269,56086,183,50064,49664,400,12.39414
29/01/2018 17:06,2016,3,EASTERN EUROPE-EU,POLAND,2,EDINBURGH,KRAKOW,138180,137711,469,117527,117071,456,17.57298
29/01/2018 17:06,2016,3,EASTERN EUROPE-EU,POLAND,2,EDINBURGH,POZNAN,30078,29927,151,19388,19388,0,55.1372
29/01/2018 17:06,2016,3,EASTERN EUROPE-EU,POLAND,2,EDINBURGH,RZESZOW,375,375,0,6568,6568,0,-94.2905
29/01/2018 17:06,2016,3,EASTERN EUROPE-EU,POLAND,2,EDINBURGH,WARSAW (CHOPIN),345,0,345,0,0,0,0
29/01/2018 17:06,2016,3,EASTERN EUROPE-EU,POLAND,2,EDINBURGH,WARSAW (MODLIN MASOVIA),9192,9192,0,0,0,0,0
29/01/2018 17:06,2016,3,EASTERN EUROPE-EU,POLAND,2,EXETER,KRAKOW,431,0,431,434,0,434,-0.69124
29/01/2018 17:06,2016,3,EASTERN EUROPE-EU,POLAND,2,GLASGOW,BYDGOSZCZ,29145,29145,0,32474,32474,0,-10.25128
29/01/2018 17:06,2016,3,EASTERN EUROPE-EU,POLAND,2,GLASGOW,GDANSK,33135,33135,0,37849,37849,0,-12.45475
29/01/2018 17:06,2016,3,EASTERN EUROPE-EU,POLAND,2,GLASGOW,KATOWICE,38243,38243,0,33393,33393,0,14.524
29/01/2018 17:06,2016,3,EASTERN EUROPE-EU,POLAND,2,GLASGOW,KRAKOW,467,0,467,436,0,436,7.11009
29/01/2018 17:06,2016,3,EASTERN EUROPE-EU,POLAND,2,GLASGOW,LUBLIN (PORT LOTNICZY),29772,29772,0,8929,8929,0,233.4304
29/01/2018 17:06,2016,3,EASTERN EUROPE-EU,POLAND,2,GLASGOW,POZNAN,30969,30969,0,30146,30146,0,2.73005
29/01/2018 17:06,2016,3,EASTERN EUROPE-EU,POLAND,2,GLASGOW,WARSAW (CHOPIN),41970,41970,0,42207,41762,445,-0.56152
29/01/2018 17:06,2016,3,EASTERN EUROPE-EU,POLAND,2,GLASGOW,WARSAW (MODLIN MASOVIA),55198,55198,0,54653,54653,0,0.9972
29/01/2018 17:06,2016,3,EASTERN EUROPE-EU,POLAND,2,GLASGOW,WROCLAW,38175,38175,0,37924,37924,0,0.66185
29/01/2018 17:06,2016,3,EASTERN EUROPE-EU,POLAND,2,LEEDS BRADFORD,GDANSK,67486,67486,0,40357,40357,0,67.22254
29/01/2018 17:06,2016,3,EASTERN EUROPE-EU,POLAND,2,LEEDS BRADFORD,KRAKOW,58652,57953,699,55172,54714,458,6.30755
29/01/2018 17:06,2016,3,EASTERN EUROPE-EU,POLAND,2,LEEDS BRADFORD,WARSAW (MODLIN MASOVIA),5884,5884,0,0,0,0,0
29/01/2018 17:06,2016,3,EASTERN EUROPE-EU,POLAND,2,LIVERPOOL (JOHN LENNON),GDANSK,57342,57342,0,52589,52589,0,9.03801
29/01/2018 17:06,2016,3,EASTERN EUROPE-EU,POLAND,2,LIVERPOOL (JOHN LENNON),KATOWICE,28997,28997,0,0,0,0,0
29/01/2018 17:06,2016,3,EASTERN EUROPE-EU,POLAND,2,LIVERPOOL (JOHN LENNON),KRAKOW,101251,101251,0,104733,104733,0,-3.32464
29/01/2018 17:06,2016,3,EASTERN EUROPE-EU,POLAND,2,LIVERPOOL (JOHN LENNON),POZNAN,39307,39307,0,35579,35579,0,10.47809
29/01/2018 17:06,2016,3,EASTERN EUROPE-EU,POLAND,2,LIVERPOOL (JOHN LENNON),SZCZECIN (GOLENOW),27601,27601,0,23274,23274,0,18.59156
29/01/2018 17:06,2016,3,EASTERN EUROPE-EU,POLAND,2,LIVERPOOL (JOHN LENNON),WARSAW (CHOPIN),34305,34305,0,32936,32936,0,4.15655
29/01/2018 17:06,2016,3,EASTERN EUROPE-EU,POLAND,2,LIVERPOOL (JOHN LENNON),WARSAW (MODLIN MASOVIA),71247,71247,0,70969,70969,0,0.39172
29/01/2018 17:06,2016,3,EASTERN EUROPE-EU,POLAND,2,LIVERPOOL (JOHN LENNON),WROCLAW,58026,58026,0,57519,57519,0,0.88145
29/01/2018 17:06,2016,3,EASTERN EUROPE-EU,POLAND,2,MANCHESTER,GDANSK,36737,36737,0,35766,35766,0,2.71487
29/01/2018 17:06,2016,3,EASTERN EUROPE-EU,POLAND,2,MANCHESTER,KRAKOW,88784,88324,460,57939,57084,855,53.23703
29/01/2018 17:06,2016,3,EASTERN EUROPE-EU,POLAND,2,MANCHESTER,POZNAN,0,0,0,167,167,0,-100
29/01/2018 17:06,2016,3,EASTERN EUROPE-EU,POLAND,2,MANCHESTER,RZESZOW,37993,37993,0,37947,37947,0,0.12122
29/01/2018 17:06,2016,3,EASTERN EUROPE-EU,POLAND,2,MANCHESTER,WARSAW (MODLIN MASOVIA),55814,55814,0,44257,44257,0,26.11338
29/01/2018 17:06,2016,3,EASTERN EUROPE-EU,POLAND,2,MANCHESTER,WROCLAW,8943,8943,0,0,0,0,0
29/01/2018 17:06,2016,3,EASTERN EUROPE-EU,POLAND,2,NEWCASTLE,GDANSK,4697,4697,0,0,0,0,0
29/01/2018 17:06,2016,3,EASTERN EUROPE-EU,POLAND,2,NEWCASTLE,KRAKOW,27196,26800,396,26556,26124,432,2.41
29/01/2018 17:06,2016,3,EASTERN EUROPE-EU,POLAND,2,NEWCASTLE,WARSAW (MODLIN MASOVIA),4962,4962,0,0,0,0,0
29/01/2018 17:06,2016,3,EASTERN EUROPE-EU,POLAND,2,NEWCASTLE,WROCLAW,5022,5022,0,0,0,0,0
29/01/2018 17:06,2016,3,EASTERN EUROPE-EU,ROMANIA,1,GATWICK,BUCHAREST (OTOPENI),70183,70183,0,13332,13332,0,426.42514
29/01/2018 17:06,2016,3,EASTERN EUROPE-EU,ROMANIA,1,HEATHROW,BUCHAREST (BANEASA),0,0,0,13,0,13,-100
29/01/2018 17:06,2016,3,EASTERN EUROPE-EU,ROMANIA,1,HEATHROW,BUCHAREST (OTOPENI),263321,263321,0,253590,253590,0,3.8373
29/01/2018 17:06,2016,3,EASTERN EUROPE-EU,ROMANIA,1,LUTON,BACAU,77591,77591,0,72459,72459,0,7.08263
29/01/2018 17:06,2016,3,EASTERN EUROPE-EU,ROMANIA,1,LUTON,BUCHAREST (OTOPENI),513647,513647,0,417520,417481,39,23.02333
29/01/2018 17:06,2016,3,EASTERN EUROPE-EU,ROMANIA,1,LUTON,CLUJ NAPOCA,240485,240465,20,190976,190955,21,25.9242
29/01/2018 17:06,2016,3,EASTERN EUROPE-EU,ROMANIA,1,LUTON,CONSTANTA,32844,32844,0,17583,17583,0,86.79406
29/01/2018 17:06,2016,3,EASTERN EUROPE-EU,ROMANIA,1,LUTON,CRAIOVA,79203,79203,0,27092,27092,0,192.34829
29/01/2018 17:06,2016,3,EASTERN EUROPE-EU,ROMANIA,1,LUTON,IASI,140416,140416,0,34589,34589,0,305.95565
29/01/2018 17:06,2016,3,EASTERN EUROPE-EU,ROMANIA,1,LUTON,SATU MARE,5328,5328,0,0,0,0,0
29/01/2018 17:06,2016,3,EASTERN EUROPE-EU,ROMANIA,1,LUTON,SIBIU,60676,60676,0,40064,40064,0,51.44768
29/01/2018 17:06,2016,3,EASTERN EUROPE-EU,ROMANIA,1,LUTON,SUCEAVA,20364,20364,0,0,0,0,0
29/01/2018 17:06,2016,3,EASTERN EUROPE-EU,ROMANIA,1,LUTON,TIMISOARA,106716,106603,113,75878,75878,0,40.64156
29/01/2018 17:06,2016,3,EASTERN EUROPE-EU,ROMANIA,1,LUTON,TIRGU MURES,62356,62356,0,69163,69163,0,-9.84197
29/01/2018 17:06,2016,3,EASTERN EUROPE-EU,ROMANIA,1,STANSTED,BUCHAREST (BANEASA),59,0,59,0,0,0,0
29/01/2018 17:06,2016,3,EASTERN EUROPE-EU,ROMANIA,1,STANSTED,BUCHAREST (OTOPENI),257720,257720,0,252646,252646,0,2.00834
29/01/2018 17:06,2016,3,EASTERN EUROPE-EU,ROMANIA,1,STANSTED,TIMISOARA,38818,38818,0,0,0,0,0
29/01/2018 17:06,2016,3,EASTERN EUROPE-EU,ROMANIA,2,BELFAST INTERNATIONAL,BUCHAREST (OTOPENI),0,0,0,290,0,290,-100
29/01/2018 17:06,2016,3,EASTERN EUROPE-EU,ROMANIA,2,BIRMINGHAM,BUCHAREST (OTOPENI),22000,22000,0,0,0,0,0
29/01/2018 17:06,2016,3,EASTERN EUROPE-EU,ROMANIA,2,BRISTOL,BUCHAREST (OTOPENI),3601,3601,0,0,0,0,0
29/01/2018 17:06,2016,3,EASTERN EUROPE-EU,ROMANIA,2,DONCASTER SHEFFIELD,BUCHAREST (OTOPENI),45818,45818,0,32822,32822,0,39.59539
29/01/2018 17:06,2016,3,EASTERN EUROPE-EU,ROMANIA,2,DONCASTER SHEFFIELD,CLUJ NAPOCA,13517,13517,0,0,0,0,0
29/01/2018 17:06,2016,3,EASTERN EUROPE-EU,ROMANIA,2,GLASGOW,BUCHAREST (OTOPENI),58222,58222,0,1923,1923,0,2927.66511
29/01/2018 17:06,2016,3,EASTERN EUROPE-EU,ROMANIA,2,INVERNESS,BUCHAREST (OTOPENI),0,0,0,78,0,78,-100
29/01/2018 17:06,2016,3,EASTERN EUROPE-EU,ROMANIA,2,LIVERPOOL (JOHN LENNON),BACAU,19715,19715,0,12451,12451,0,58.3407
29/01/2018 17:06,2016,3,EASTERN EUROPE-EU,ROMANIA,2,LIVERPOOL (JOHN LENNON),BUCHAREST (OTOPENI),50559,50559,0,40303,40303,0,25.44724
29/01/2018 17:06,2016,3,EASTERN EUROPE-EU,ROMANIA,2,LIVERPOOL (JOHN LENNON),CLUJ NAPOCA,14832,14832,0,0,0,0,0
29/01/2018 17:06,2016,3,EASTERN EUROPE-EU,ROMANIA,2,MANCHESTER,BUCHAREST (OTOPENI),305,0,305,0,0,0,0
29/01/2018 17:06,2016,3,EASTERN EUROPE-EU,SLOVAK REPUBLIC,1,LUTON,BRATISLAVA,59167,58986,181,72175,72127,48,-18.02286
29/01/2018 17:06,2016,3,EASTERN EUROPE-EU,SLOVAK REPUBLIC,1,LUTON,KOSICE,135116,135116,0,127734,127734,0,5.7792
29/01/2018 17:06,2016,3,EASTERN EUROPE-EU,SLOVAK REPUBLIC,1,LUTON,TATRY-POPRAD,62002,62002,0,62428,62428,0,-0.68239
29/01/2018 17:06,2016,3,EASTERN EUROPE-EU,SLOVAK REPUBLIC,1,SOUTHEND,BRATISLAVA,0,0,0,33,0,33,-100
29/01/2018 17:06,2016,3,EASTERN EUROPE-EU,SLOVAK REPUBLIC,1,STANSTED,BRATISLAVA,236563,236563,0,232641,232641,0,1.68586
29/01/2018 17:06,2016,3,EASTERN EUROPE-EU,SLOVAK REPUBLIC,2,BELFAST INTERNATIONAL,BRATISLAVA,0,0,0,250,52,198,-100
29/01/2018 17:06,2016,3,EASTERN EUROPE-EU,SLOVAK REPUBLIC,2,BELFAST INTERNATIONAL,PIESTANY,0,0,0,86,0,86,-100
29/01/2018 17:06,2016,3,EASTERN EUROPE-EU,SLOVAK REPUBLIC,2,BIRMINGHAM,BRATISLAVA,55113,55113,0,54278,54278,0,1.53838
29/01/2018 17:06,2016,3,EASTERN EUROPE-EU,SLOVAK REPUBLIC,2,BRISTOL,KOSICE,29766,29766,0,6186,6186,0,381.18332
29/01/2018 17:06,2016,3,EASTERN EUROPE-EU,SLOVAK REPUBLIC,2,CARDIFF WALES,BRATISLAVA,5,0,5,0,0,0,0
29/01/2018 17:06,2016,3,EASTERN EUROPE-EU,SLOVAK REPUBLIC,2,DONCASTER SHEFFIELD,KOSICE,40533,40533,0,19314,19314,0,109.86331
29/01/2018 17:06,2016,3,EASTERN EUROPE-EU,SLOVAK REPUBLIC,2,EDINBURGH,BRATISLAVA,30771,30771,0,23561,23561,0,30.60142
29/01/2018 17:06,2016,3,EASTERN EUROPE-EU,SLOVAK REPUBLIC,2,GLASGOW,BRATISLAVA,152,0,152,0,0,0,0
29/01/2018 17:06,2016,3,EASTERN EUROPE-EU,SLOVAK REPUBLIC,2,LEEDS BRADFORD,BRATISLAVA,4967,4967,0,0,0,0,0
29/01/2018 17:06,2016,3,EASTERN EUROPE-EU,SLOVAK REPUBLIC,2,LIVERPOOL (JOHN LENNON),BRATISLAVA,12818,12818,0,54677,54677,0,-76.55687
29/01/2018 17:06,2016,3,EASTERN EUROPE-EU,SLOVAK REPUBLIC,2,MANCHESTER,BRATISLAVA,41912,41912,0,0,0,0,0
29/01/2018 17:06,2016,4,EASTERN EUROPE -OTHER,ALBANIA,1,GATWICK,TIRANA,84525,73389,11136,74159,62687,11472,13.97807
29/01/2018 17:06,2016,4,EASTERN EUROPE -OTHER,ALBANIA,1,STANSTED,TIRANA,2468,0,2468,2106,0,2106,17.18898
29/01/2018 17:06,2016,4,EASTERN EUROPE -OTHER,ALBANIA,2,BELFAST INTERNATIONAL,TIRANA,0,0,0,60,0,60,-100
29/01/2018 17:06,2016,4,EASTERN EUROPE -OTHER,ARMENIA,2,EDINBURGH,YEREVAN,0,0,0,218,0,218,-100
29/01/2018 17:06,2016,4,EASTERN EUROPE -OTHER,AZERBAIJAN,1,HEATHROW,BAKU (HEYDER ALIYEV INT'L),57801,57801,0,82685,82685,0,-30.09494
29/01/2018 17:06,2016,4,EASTERN EUROPE -OTHER,AZERBAIJAN,1,LUTON,BAKU (HEYDER ALIYEV INT'L),756,0,756,12,0,12,6200
29/01/2018 17:06,2016,4,EASTERN EUROPE -OTHER,AZERBAIJAN,2,BELFAST INTERNATIONAL,BAKU (HEYDER ALIYEV INT'L),168,0,168,0,0,0,0
29/01/2018 17:06,2016,4,EASTERN EUROPE -OTHER,AZERBAIJAN,2,GLASGOW,BAKU (HEYDER ALIYEV INT'L),0,0,0,218,0,218,-100
29/01/2018 17:06,2016,4,EASTERN EUROPE -OTHER,BELARUS,1,GATWICK,MINSK INT'L ,24733,24733,0,22137,22137,0,11.72697
29/01/2018 17:06,2016,4,EASTERN EUROPE -OTHER,BELARUS,2,BELFAST INTERNATIONAL,MINSK INT'L ,0,0,0,66,0,66,-100
29/01/2018 17:06,2016,4,EASTERN EUROPE -OTHER,BELARUS,2,BELFAST INTERNATIONAL,MINSK LOSHITSA,40,0,40,0,0,0,0
29/01/2018 17:06,2016,4,EASTERN EUROPE -OTHER,BELARUS,2,MANCHESTER,MINSK INT'L ,2655,2655,0,2323,2323,0,14.29186
29/01/2018 17:06,2016,4,EASTERN EUROPE -OTHER,GEORGIA,1,LUTON,TBILISI,6,0,6,0,0,0,0
29/01/2018 17:06,2016,4,EASTERN EUROPE -OTHER,GEORGIA,2,GLASGOW,TBILISI,0,0,0,254,0,254,-100
29/01/2018 17:06,2016,4,EASTERN EUROPE -OTHER,KAZAKHSTAN,1,HEATHROW,ALMATY,200,0,200,23259,23259,0,-99.14012
29/01/2018 17:06,2016,4,EASTERN EUROPE -OTHER,KAZAKHSTAN,1,HEATHROW,ASTANA,32872,32872,0,26197,26197,0,25.48002
29/01/2018 17:06,2016,4,EASTERN EUROPE -OTHER,KAZAKHSTAN,1,LUTON,ALMATY,212,0,212,2,0,2,10500
29/01/2018 17:06,2016,4,EASTERN EUROPE -OTHER,KAZAKHSTAN,2,GLASGOW,ASTANA,130,0,130,0,0,0,0
29/01/2018 17:06,2016,4,EASTERN EUROPE -OTHER,REPUBLIC OF MOLDOVA,1,LUTON,CHISINAU (KISHINEV),61699,61699,0,7832,7832,0,687.7809
29/01/2018 17:06,2016,4,EASTERN EUROPE -OTHER,REPUBLIC OF MOLDOVA,1,STANSTED,CHISINAU (KISHINEV),43885,43885,0,33598,33598,0,30.61789
29/01/2018 17:06,2016,4,EASTERN EUROPE -OTHER,REPUBLIC OF MOLDOVA,2,BIRMINGHAM,CHISINAU (KISHINEV),172,172,0,0,0,0,0
29/01/2018 17:06,2016,4,EASTERN EUROPE -OTHER,REPUBLIC OF MOLDOVA,2,CARDIFF WALES,CHISINAU (KISHINEV),74,0,74,0,0,0,0
29/01/2018 17:06,2016,4,EASTERN EUROPE -OTHER,RUSSIA,1,GATWICK,ADLER / SOCHI,1160,0,1160,0,0,0,0
29/01/2018 17:06,2016,4,EASTERN EUROPE -OTHER,RUSSIA,1,GATWICK,MOSCOW (DOMODEDOVO),19894,19894,0,113235,113235,0,-82.43123
29/01/2018 17:06,2016,4,EASTERN EUROPE -OTHER,RUSSIA,1,GATWICK,MOSCOW (SHEREMETYEVO),8995,8995,0,0,0,0,0
29/01/2018 17:06,2016,4,EASTERN EUROPE -OTHER,RUSSIA,1,HEATHROW,KHANTY-MANSIYSK,184,184,0,0,0,0,0
29/01/2018 17:06,2016,4,EASTERN EUROPE -OTHER,RUSSIA,1,HEATHROW,MOSCOW (DOMODEDOVO),247423,247423,0,247141,247141,0,0.1141
29/01/2018 17:06,2016,4,EASTERN EUROPE -OTHER,RUSSIA,1,HEATHROW,MOSCOW (SHEREMETYEVO),366209,366209,0,293876,293876,0,24.61344
29/01/2018 17:06,2016,4,EASTERN EUROPE -OTHER,RUSSIA,1,HEATHROW,MOSCOW (VNUKOVO),14,14,0,90672,90672,0,-99.98456
29/01/2018 17:06,2016,4,EASTERN EUROPE -OTHER,RUSSIA,1,HEATHROW,ST PETERSBURG,86566,86566,0,79823,79823,0,8.44744
29/01/2018 17:06,2016,4,EASTERN EUROPE -OTHER,RUSSIA,1,LUTON,ADLER / SOCHI,172,0,172,1230,0,1230,-86.01626
29/01/2018 17:06,2016,4,EASTERN EUROPE -OTHER,RUSSIA,1,LUTON,MOSCOW (SHEREMETYEVO),158,0,158,3,0,3,5166.66667
29/01/2018 17:06,2016,4,EASTERN EUROPE -OTHER,RUSSIA,1,LUTON,MOSCOW (VNUKOVO),84,0,84,3,0,3,2700
29/01/2018 17:06,2016,4,EASTERN EUROPE -OTHER,RUSSIA,1,LUTON,NOVOSIBIRSK (TOLMACHEVO),1,0,1,0,0,0,0
29/01/2018 17:06,2016,4,EASTERN EUROPE -OTHER,RUSSIA,1,LUTON,ST PETERSBURG,11,0,11,2,0,2,450
29/01/2018 17:06,2016,4,EASTERN EUROPE -OTHER,RUSSIA,1,STANSTED,ST PETERSBURG,145,145,0,0,0,0,0
29/01/2018 17:06,2016,4,EASTERN EUROPE -OTHER,RUSSIA,2,ABERDEEN,KAZAN,0,0,0,44,0,44,-100
29/01/2018 17:06,2016,4,EASTERN EUROPE -OTHER,RUSSIA,2,ABERDEEN,MOSCOW (SHEREMETYEVO),0,0,0,43,0,43,-100
29/01/2018 17:06,2016,4,EASTERN EUROPE -OTHER,RUSSIA,2,BIGGIN HILL,MOSCOW (SHEREMETYEVO),0,0,0,10,0,10,-100
29/01/2018 17:06,2016,4,EASTERN EUROPE -OTHER,RUSSIA,2,EDINBURGH,MOSCOW (VNUKOVO),26,0,26,0,0,0,0
29/01/2018 17:06,2016,4,EASTERN EUROPE -OTHER,RUSSIA,2,GLASGOW,MOSCOW (SHEREMETYEVO),84,0,84,0,0,0,0
29/01/2018 17:06,2016,4,EASTERN EUROPE -OTHER,RUSSIA,2,LIVERPOOL (JOHN LENNON),KAZAN,0,0,0,163,0,163,-100
29/01/2018 17:06,2016,4,EASTERN EUROPE -OTHER,RUSSIA,2,LIVERPOOL (JOHN LENNON),KRASNODAR,0,0,0,41,0,41,-100
29/01/2018 17:06,2016,4,EASTERN EUROPE -OTHER,RUSSIA,2,MANCHESTER,BOLSHOYE SAVINO,66,0,66,0,0,0,0
29/01/2018 17:06,2016,4,EASTERN EUROPE -OTHER,RUSSIA,2,MANCHESTER,MOSCOW (DOMODEDOVO),0,0,0,19426,19426,0,-100
29/01/2018 17:06,2016,4,EASTERN EUROPE -OTHER,RUSSIA,2,MANCHESTER,MOSCOW (SHEREMETYEVO),0,0,0,431,0,431,-100
29/01/2018 17:06,2016,4,EASTERN EUROPE -OTHER,RUSSIA,2,MANCHESTER,ST PETERSBURG,1,1,0,0,0,0,0
29/01/2018 17:06,2016,4,EASTERN EUROPE -OTHER,TURKMENISTAN,1,HEATHROW,ASHKHABAD,12093,12093,0,18493,18493,0,-34.60769
29/01/2018 17:06,2016,4,EASTERN EUROPE -OTHER,TURKMENISTAN,2,BIRMINGHAM,ASHKHABAD,35474,35474,0,43933,43933,0,-19.25432
29/01/2018 17:06,2016,4,EASTERN EUROPE -OTHER,UKRAINE,1,GATWICK,KIEV (BORISPOL),157426,157426,0,125892,125426,466,25.04845
29/01/2018 17:06,2016,4,EASTERN EUROPE -OTHER,UKRAINE,1,GATWICK,KIEV (ZHULYANY),147,147,0,0,0,0,0
29/01/2018 17:06,2016,4,EASTERN EUROPE -OTHER,UKRAINE,1,HEATHROW,KIEV (BORISPOL),78349,78349,0,72523,72523,0,8.03331
29/01/2018 17:06,2016,4,EASTERN EUROPE -OTHER,UKRAINE,1,LUTON,KIEV (BORISPOL),246,244,2,120,0,120,105
29/01/2018 17:06,2016,4,EASTERN EUROPE -OTHER,UKRAINE,1,LUTON,KIEV (ZHULYANY),31227,31208,19,30092,30088,4,3.77177
29/01/2018 17:06,2016,4,EASTERN EUROPE -OTHER,UKRAINE,1,LUTON,LVOV,3,0,3,0,0,0,0
29/01/2018 17:06,2016,4,EASTERN EUROPE -OTHER,UKRAINE,1,LUTON,ODESSA,4,0,4,0,0,0,0
29/01/2018 17:06,2016,4,EASTERN EUROPE -OTHER,UKRAINE,2,CARDIFF WALES,KIEV (ZHULYANY),139,0,139,0,0,0,0
29/01/2018 17:06,2016,4,EASTERN EUROPE -OTHER,UKRAINE,2,LIVERPOOL (JOHN LENNON),KIEV (BORISPOL),0,0,0,299,0,299,-100
29/01/2018 17:06,2016,4,EASTERN EUROPE -OTHER,UKRAINE,2,LIVERPOOL (JOHN LENNON),KIEV (ZHULYANY),0,0,0,460,0,460,-100
29/01/2018 17:06,2016,4,EASTERN EUROPE -OTHER,UKRAINE,2,MANCHESTER,KIEV (ZHULYANY),595,0,595,0,0,0,0
29/01/2018 17:06,2016,4,EASTERN EUROPE -OTHER,UKRAINE,2,MANCHESTER,ODESSA,571,0,571,0,0,0,0
29/01/2018 17:06,2016,4,EASTERN EUROPE -OTHER,UKRAINE,2,MANCHESTER,ZAPOROZHYE,93,0,93,0,0,0,0
29/01/2018 17:06,2016,4,EASTERN EUROPE -OTHER,UZBEKISTAN,1,GATWICK,TASHKENT,0,0,0,205,0,205,-100
29/01/2018 17:06,2016,4,EASTERN EUROPE -OTHER,UZBEKISTAN,1,HEATHROW,TASHKENT,23545,23545,0,25098,25098,0,-6.18774
29/01/2018 17:06,2016,25,NEAR EAST,ISRAEL,1,GATWICK,TEL AVIV,44782,44782,0,51911,51387,524,-13.73312
29/01/2018 17:06,2016,25,NEAR EAST,ISRAEL,1,HEATHROW,TEL AVIV,568922,568664,258,584298,584298,0,-2.63153
29/01/2018 17:06,2016,25,NEAR EAST,ISRAEL,1,LUTON,OVDA,4592,4293,299,1067,671,396,330.36551
29/01/2018 17:06,2016,25,NEAR EAST,ISRAEL,1,LUTON,TEL AVIV,370135,366993,3142,313035,310174,2861,18.24077
29/01/2018 17:06,2016,25,NEAR EAST,ISRAEL,1,STANSTED,TEL AVIV,0,0,0,365,0,365,-100
29/01/2018 17:06,2016,25,NEAR EAST,ISRAEL,2,BOURNEMOUTH,TEL AVIV,94,0,94,0,0,0,0
29/01/2018 17:06,2016,25,NEAR EAST,ISRAEL,2,CARDIFF WALES,TEL AVIV,0,0,0,283,0,283,-100
29/01/2018 17:06,2016,25,NEAR EAST,ISRAEL,2,GLASGOW,TEL AVIV,321,0,321,0,0,0,0
29/01/2018 17:06,2016,25,NEAR EAST,ISRAEL,2,MANCHESTER,OVDA,0,0,0,7,0,7,-100
29/01/2018 17:06,2016,25,NEAR EAST,ISRAEL,2,MANCHESTER,TEL AVIV,59234,59234,0,34193,34193,0,73.23429
29/01/2018 17:06,2016,25,NEAR EAST,JORDAN,1,GATWICK,AQABA,340,120,220,0,0,0,0
29/01/2018 17:06,2016,25,NEAR EAST,JORDAN,1,HEATHROW,AMMAN,209751,209751,0,203783,203783,0,2.92861
29/01/2018 17:06,2016,25,NEAR EAST,JORDAN,1,LUTON,AMMAN (KING HUSSEIN),4,0,4,0,0,0,0
29/01/2018 17:06,2016,25,NEAR EAST,JORDAN,1,STANSTED,AMMAN,248,0,248,0,0,0,0
29/01/2018 17:06,2016,25,NEAR EAST,JORDAN,2,BELFAST INTERNATIONAL,AMMAN,80,0,80,0,0,0,0
29/01/2018 17:06,2016,25,NEAR EAST,JORDAN,2,BIRMINGHAM,AQABA,576,0,576,0,0,0,0
29/01/2018 17:06,2016,25,NEAR EAST,JORDAN,2,GLASGOW,AMMAN,0,0,0,112,0,112,-100
29/01/2018 17:06,2016,25,NEAR EAST,JORDAN,2,GLASGOW,AQABA,496,0,496,0,0,0,0
29/01/2018 17:06,2016,25,NEAR EAST,JORDAN,2,MANCHESTER,AMMAN,161,0,161,103,0,103,56.31068
29/01/2018 17:06,2016,25,NEAR EAST,JORDAN,2,MANCHESTER,AQABA,576,0,576,0,0,0,0
29/01/2018 17:06,2016,25,NEAR EAST,LEBANON,1,HEATHROW,BEIRUT,271359,271359,0,255510,255510,0,6.20289
29/01/2018 17:06,2016,25,NEAR EAST,LEBANON,2,BELFAST INTERNATIONAL,BEIRUT,61,0,61,51,0,51,19.60784
29/01/2018 17:06,2016,25,NEAR EAST,LEBANON,2,CARDIFF WALES,BEIRUT,115,0,115,0,0,0,0
29/01/2018 17:06,2016,25,NEAR EAST,LEBANON,2,GLASGOW,BEIRUT,123,0,123,0,0,0,0
29/01/2018 17:06,2016,25,NEAR EAST,LEBANON,2,LEEDS BRADFORD,BEIRUT,230,0,230,0,0,0,0
29/01/2018 17:06,2016,25,NEAR EAST,LEBANON,2,NEWCASTLE,BEIRUT,178,0,178,0,0,0,0
29/01/2018 17:06,2016,30,NORTH AFRICA,ALGERIA,1,GATWICK,ALGIERS,51063,51063,0,54914,54914,0,-7.01278
29/01/2018 17:06,2016,30,NORTH AFRICA,ALGERIA,1,GATWICK,HASSI MESSAOUD,0,0,0,2838,0,2838,-100
29/01/2018 17:06,2016,30,NORTH AFRICA,ALGERIA,1,HEATHROW,ALGIERS,76807,76807,0,71565,71565,0,7.32481
29/01/2018 17:06,2016,30,NORTH AFRICA,ALGERIA,1,LUTON,ALGIERS,6,0,6,5,0,5,20
29/01/2018 17:06,2016,30,NORTH AFRICA,ALGERIA,1,STANSTED,HASSI MESSAOUD,5585,0,5585,5752,0,5752,-2.90334
29/01/2018 17:06,2016,30,NORTH AFRICA,EGYPT,1,GATWICK,HURGHADA,133686,48278,85408,150140,60339,89801,-10.9591
29/01/2018 17:06,2016,30,NORTH AFRICA,EGYPT,1,GATWICK,LUXOR,3794,0,3794,8569,0,8569,-55.72412
29/01/2018 17:06,2016,30,NORTH AFRICA,EGYPT,1,GATWICK,MARSA ALAM,16800,0,16800,16545,0,16545,1.54125
29/01/2018 17:06,2016,30,NORTH AFRICA,EGYPT,1,GATWICK,MERSA MATROUH,0,0,0,150,0,150,-100
29/01/2018 17:06,2016,30,NORTH AFRICA,EGYPT,1,GATWICK,SHARM EL SHEIKH (OPHIRA),2,0,2,364385,192213,172172,-99.99945
29/01/2018 17:06,2016,30,NORTH AFRICA,EGYPT,1,HEATHROW,CAIRO,351703,351703,0,337505,337505,0,4.20675
29/01/2018 17:06,2016,30,NORTH AFRICA,EGYPT,1,HEATHROW,LUXOR,5105,5105,0,11067,11067,0,-53.87187
29/01/2018 17:06,2016,30,NORTH AFRICA,EGYPT,1,LUTON,CAIRO,1,0,1,0,0,0,0
29/01/2018 17:06,2016,30,NORTH AFRICA,EGYPT,1,LUTON,HURGHADA,18,0,18,0,0,0,0
29/01/2018 17:06,2016,30,NORTH AFRICA,EGYPT,1,LUTON,MERSA MATROUH,0,0,0,133,0,133,-100
29/01/2018 17:06,2016,30,NORTH AFRICA,EGYPT,1,LUTON,SHARM EL SHEIKH (OPHIRA),0,0,0,127600,114858,12742,-100
29/01/2018 17:06,2016,30,NORTH AFRICA,EGYPT,1,STANSTED,SHARM EL SHEIKH (OPHIRA),0,0,0,50202,35432,14770,-100
29/01/2018 17:06,2016,30,NORTH AFRICA,EGYPT,2,BELFAST INTERNATIONAL,SHARM EL SHEIKH (OPHIRA),0,0,0,6289,0,6289,-100
29/01/2018 17:06,2016,30,NORTH AFRICA,EGYPT,2,BIRMINGHAM,HURGHADA,19664,0,19664,26631,9831,16800,-26.16124
29/01/2018 17:06,2016,30,NORTH AFRICA,EGYPT,2,BIRMINGHAM,SHARM EL SHEIKH (OPHIRA),0,0,0,127024,60363,66661,-100
29/01/2018 17:06,2016,30,NORTH AFRICA,EGYPT,2,BOURNEMOUTH,SHARM EL SHEIKH (OPHIRA),0,0,0,381,0,381,-100
29/01/2018 17:06,2016,30,NORTH AFRICA,EGYPT,2,BRISTOL,SHARM EL SHEIKH (OPHIRA),0,0,0,38037,0,38037,-100
29/01/2018 17:06,2016,30,NORTH AFRICA,EGYPT,2,CARDIFF WALES,SHARM EL SHEIKH (OPHIRA),0,0,0,15448,0,15448,-100
29/01/2018 17:06,2016,30,NORTH AFRICA,EGYPT,2,DONCASTER SHEFFIELD,SHARM EL SHEIKH (OPHIRA),0,0,0,21724,0,21724,-100
29/01/2018 17:06,2016,30,NORTH AFRICA,EGYPT,2,EAST MIDLANDS INTERNATIONAL,HURGHADA,4300,0,4300,5787,0,5787,-25.69552
29/01/2018 17:06,2016,30,NORTH AFRICA,EGYPT,2,EAST MIDLANDS INTERNATIONAL,SHARM EL SHEIKH (OPHIRA),0,0,0,34398,0,34398,-100
29/01/2018 17:06,2016,30,NORTH AFRICA,EGYPT,2,EDINBURGH,SHARM EL SHEIKH (OPHIRA),0,0,0,17019,0,17019,-100
29/01/2018 17:06,2016,30,NORTH AFRICA,EGYPT,2,EXETER,SHARM EL SHEIKH (OPHIRA),0,0,0,13834,0,13834,-100
29/01/2018 17:06,2016,30,NORTH AFRICA,EGYPT,2,GLASGOW,SHARM EL SHEIKH (OPHIRA),0,0,0,27921,0,27921,-100
29/01/2018 17:06,2016,30,NORTH AFRICA,EGYPT,2,LIVERPOOL (JOHN LENNON),CAIRO,0,0,0,2,0,2,-100
29/01/2018 17:06,2016,30,NORTH AFRICA,EGYPT,2,MANCHESTER,CAIRO,0,0,0,13260,13260,0,-100
29/01/2018 17:06,2016,30,NORTH AFRICA,EGYPT,2,MANCHESTER,HURGHADA,79564,9531,70033,124896,34962,89934,-36.2958
29/01/2018 17:06,2016,30,NORTH AFRICA,EGYPT,2,MANCHESTER,SHARM EL SHEIKH (OPHIRA),0,0,0,281697,114258,167439,-100
29/01/2018 17:06,2016,30,NORTH AFRICA,EGYPT,2,NEWCASTLE,HURGHADA,0,0,0,14855,0,14855,-100
29/01/2018 17:06,2016,30,NORTH AFRICA,EGYPT,2,NEWCASTLE,SHARM EL SHEIKH (OPHIRA),0,0,0,49521,0,49521,-100
29/01/2018 17:06,2016,30,NORTH AFRICA,MOROCCO,1,GATWICK,AGADIR (AL MASSIRA),85625,84144,1481,84769,84507,262,1.0098
29/01/2018 17:06,2016,30,NORTH AFRICA,MOROCCO,1,GATWICK,CASABLANCA MOHAMED V,46604,46604,0,46916,46916,0,-0.66502
29/01/2018 17:06,2016,30,NORTH AFRICA,MOROCCO,1,GATWICK,MARRAKESH,303777,303666,111,307440,307052,388,-1.19145
29/01/2018 17:06,2016,30,NORTH AFRICA,MOROCCO,1,GATWICK,OUARZAZATE,787,0,787,928,0,928,-15.19397
29/01/2018 17:06,2016,30,NORTH AFRICA,MOROCCO,1,GATWICK,RABAT,21085,20850,235,2689,2689,0,684.12049
29/01/2018 17:06,2016,30,NORTH AFRICA,MOROCCO,1,GATWICK,TANGIERS (IBN BATUTA),23589,23589,0,23634,23634,0,-0.1904
29/01/2018 17:06,2016,30,NORTH AFRICA,MOROCCO,1,HEATHROW,CASABLANCA MOHAMED V,89851,89851,0,96311,96311,0,-6.70744
29/01/2018 17:06,2016,30,NORTH AFRICA,MOROCCO,1,HEATHROW,MARRAKESH,516,516,0,0,0,0,0
29/01/2018 17:06,2016,30,NORTH AFRICA,MOROCCO,1,LUTON,ESSAOUIRA,28147,28147,0,17883,17883,0,57.39529
29/01/2018 17:06,2016,30,NORTH AFRICA,MOROCCO,1,LUTON,MARRAKESH,69887,69738,149,65905,65898,7,6.04203
29/01/2018 17:06,2016,30,NORTH AFRICA,MOROCCO,1,LUTON,RABAT,9,0,9,0,0,0,0
29/01/2018 17:06,2016,30,NORTH AFRICA,MOROCCO,1,LUTON,TANGIERS (IBN BATUTA),0,0,0,39,0,39,-100
29/01/2018 17:06,2016,30,NORTH AFRICA,MOROCCO,1,STANSTED,AGADIR (AL MASSIRA),5392,5392,0,0,0,0,0
29/01/2018 17:06,2016,30,NORTH AFRICA,MOROCCO,1,STANSTED,FEZ,34475,34475,0,33316,33316,0,3.47881
29/01/2018 17:06,2016,30,NORTH AFRICA,MOROCCO,1,STANSTED,MARRAKESH,127361,126506,855,146752,146752,0,-13.21345
29/01/2018 17:06,2016,30,NORTH AFRICA,MOROCCO,1,STANSTED,RABAT,52542,52542,0,51774,51774,0,1.48337
29/01/2018 17:06,2016,30,NORTH AFRICA,MOROCCO,2,BIGGIN HILL,MARRAKESH,0,0,0,18,0,18,-100
29/01/2018 17:06,2016,30,NORTH AFRICA,MOROCCO,2,BIRMINGHAM,MARRAKESH,18588,18479,109,12297,12297,0,51.15882
29/01/2018 17:06,2016,30,NORTH AFRICA,MOROCCO,2,BRISTOL,MARRAKESH,32601,32601,0,30627,30627,0,6.44529
29/01/2018 17:06,2016,30,NORTH AFRICA,MOROCCO,2,GLASGOW,MARRAKESH,15753,15753,0,30913,30913,0,-49.04086
29/01/2018 17:06,2016,30,NORTH AFRICA,MOROCCO,2,LIVERPOOL (JOHN LENNON),MARRAKESH,5572,5484,88,0,0,0,0
29/01/2018 17:06,2016,30,NORTH AFRICA,MOROCCO,2,MANCHESTER,AGADIR (AL MASSIRA),44716,44716,0,65478,65478,0,-31.70836
29/01/2018 17:06,2016,30,NORTH AFRICA,MOROCCO,2,MANCHESTER,CASABLANCA MOHAMED V,0,0,0,171,0,171,-100
29/01/2018 17:06,2016,30,NORTH AFRICA,MOROCCO,2,MANCHESTER,MARRAKESH,86114,85791,323,83456,83456,0,3.18491
29/01/2018 17:06,2016,30,NORTH AFRICA,TUNISIA,1,GATWICK,ENFIDHA - HAMMAMET INTL,0,0,0,67715,12877,54838,-100
29/01/2018 17:06,2016,30,NORTH AFRICA,TUNISIA,1,GATWICK,JERBA,0,0,0,7231,0,7231,-100
29/01/2018 17:06,2016,30,NORTH AFRICA,TUNISIA,1,GATWICK,MONASTIR,0,0,0,2906,0,2906,-100
29/01/2018 17:06,2016,30,NORTH AFRICA,TUNISIA,1,GATWICK,TUNIS,23703,23703,0,23475,23475,0,0.97125
29/01/2018 17:06,2016,30,NORTH AFRICA,TUNISIA,1,HEATHROW,MONASTIR,0,0,0,104,104,0,-100
29/01/2018 17:06,2016,30,NORTH AFRICA,TUNISIA,1,HEATHROW,TUNIS,43423,43423,0,41927,41927,0,3.56811
29/01/2018 17:06,2016,30,NORTH AFRICA,TUNISIA,1,LUTON,ENFIDHA - HAMMAMET INTL,0,0,0,4735,0,4735,-100
29/01/2018 17:06,2016,30,NORTH AFRICA,TUNISIA,1,STANSTED,ENFIDHA - HAMMAMET INTL,0,0,0,15493,0,15493,-100
29/01/2018 17:06,2016,30,NORTH AFRICA,TUNISIA,1,STANSTED,MONASTIR,0,0,0,2371,2371,0,-100
29/01/2018 17:06,2016,30,NORTH AFRICA,TUNISIA,2,BELFAST INTERNATIONAL,ENFIDHA - HAMMAMET INTL,0,0,0,2902,0,2902,-100
29/01/2018 17:06,2016,30,NORTH AFRICA,TUNISIA,2,BIRMINGHAM,ENFIDHA - HAMMAMET INTL,0,0,0,39542,0,39542,-100
29/01/2018 17:06,2016,30,NORTH AFRICA,TUNISIA,2,BIRMINGHAM,JERBA,0,0,0,3160,0,3160,-100
29/01/2018 17:06,2016,30,NORTH AFRICA,TUNISIA,2,BRISTOL,ENFIDHA - HAMMAMET INTL,0,0,0,2970,0,2970,-100
29/01/2018 17:06,2016,30,NORTH AFRICA,TUNISIA,2,CARDIFF WALES,ENFIDHA - HAMMAMET INTL,0,0,0,9798,0,9798,-100
29/01/2018 17:06,2016,30,NORTH AFRICA,TUNISIA,2,DONCASTER SHEFFIELD,ENFIDHA - HAMMAMET INTL,0,0,0,9392,0,9392,-100
29/01/2018 17:06,2016,30,NORTH AFRICA,TUNISIA,2,EAST MIDLANDS INTERNATIONAL,ENFIDHA - HAMMAMET INTL,0,0,0,36584,1228,35356,-100
29/01/2018 17:06,2016,30,NORTH AFRICA,TUNISIA,2,EDINBURGH,ENFIDHA - HAMMAMET INTL,0,0,0,2903,0,2903,-100
29/01/2018 17:06,2016,30,NORTH AFRICA,TUNISIA,2,EXETER,ENFIDHA - HAMMAMET INTL,0,0,0,1653,0,1653,-100
29/01/2018 17:06,2016,30,NORTH AFRICA,TUNISIA,2,GLASGOW,ENFIDHA - HAMMAMET INTL,0,0,0,32294,1775,30519,-100
29/01/2018 17:06,2016,30,NORTH AFRICA,TUNISIA,2,LEEDS BRADFORD,ENFIDHA - HAMMAMET INTL,0,0,0,4159,1360,2799,-100
29/01/2018 17:06,2016,30,NORTH AFRICA,TUNISIA,2,MANCHESTER,ENFIDHA - HAMMAMET INTL,0,0,0,79106,12507,66599,-100
29/01/2018 17:06,2016,30,NORTH AFRICA,TUNISIA,2,MANCHESTER,JERBA,0,0,0,6040,0,6040,-100
29/01/2018 17:06,2016,30,NORTH AFRICA,TUNISIA,2,MANCHESTER,MONASTIR,0,0,0,3720,0,3720,-100
29/01/2018 17:06,2016,30,NORTH AFRICA,TUNISIA,2,NEWCASTLE,ENFIDHA - HAMMAMET INTL,0,0,0,21192,1224,19968,-100
29/01/2018 17:06,2016,30,NORTH AFRICA,TUNISIA,2,NORWICH,ENFIDHA - HAMMAMET INTL,0,0,0,4101,0,4101,-100
29/01/2018 17:06,2016,35,EAST AFRICA,ETHIOPIA,1,HEATHROW,ADDIS ABABA,176975,176975,0,161558,161558,0,9.5427
29/01/2018 17:06,2016,35,EAST AFRICA,KENYA,1,HEATHROW,MOMBASA,0,0,0,224,224,0,-100
29/01/2018 17:06,2016,35,EAST AFRICA,KENYA,1,HEATHROW,NAIROBI,310425,310425,0,290217,290217,0,6.96307
29/01/2018 17:06,2016,35,EAST AFRICA,KENYA,2,DURHAM TEES VALLEY,NAIROBI,0,0,0,453,0,453,-100
29/01/2018 17:06,2016,35,EAST AFRICA,KENYA,2,MANCHESTER,NAIROBI,0,0,0,580,0,580,-100
29/01/2018 17:06,2016,35,EAST AFRICA,UGANDA,1,HEATHROW,ENTEBBE,0,0,0,43857,43857,0,-100
29/01/2018 17:06,2016,40,WEST AFRICA,GAMBIA,1,GATWICK,BANJUL,49078,29033,20045,42880,9023,33857,14.45429
29/01/2018 17:06,2016,40,WEST AFRICA,GAMBIA,2,BIRMINGHAM,BANJUL,10749,10749,0,7999,3324,4675,34.3793
29/01/2018 17:06,2016,40,WEST AFRICA,GAMBIA,2,EAST MIDLANDS INTERNATIONAL,BANJUL,0,0,0,218,0,218,-100
29/01/2018 17:06,2016,40,WEST AFRICA,GAMBIA,2,MANCHESTER,BANJUL,27473,27473,0,19036,6475,12561,44.32129
29/01/2018 17:06,2016,40,WEST AFRICA,GHANA,1,GATWICK,ACCRA,534,0,534,560,0,560,-4.64286
29/01/2018 17:06,2016,40,WEST AFRICA,GHANA,1,HEATHROW,ACCRA,213543,213543,0,194935,194935,0,9.54575
29/01/2018 17:06,2016,40,WEST AFRICA,NIGERIA,1,GATWICK,LAGOS,53618,53618,0,5175,5105,70,936.09662
29/01/2018 17:06,2016,40,WEST AFRICA,NIGERIA,1,HEATHROW,ABUJA,106766,106766,0,133971,133971,0,-20.30663
29/01/2018 17:06,2016,40,WEST AFRICA,NIGERIA,1,HEATHROW,LAGOS,393612,393612,0,448473,448473,0,-12.23284
29/01/2018 17:06,2016,40,WEST AFRICA,SENEGAL,1,LUTON,DAKAR,0,0,0,44,0,44,-100
29/01/2018 17:06,2016,45,CENTRAL AFRICA,ANGOLA,1,HEATHROW,LUANDA,17449,17449,0,29953,29953,0,-41.7454
29/01/2018 17:06,2016,50,SOUTHERN AFRICA,REPUBLIC OF SOUTH AFRICA,1,GATWICK,CAPE TOWN,10164,10164,0,0,0,0,0
29/01/2018 17:06,2016,50,SOUTHERN AFRICA,REPUBLIC OF SOUTH AFRICA,1,HEATHROW,CAPE TOWN,324307,324307,0,417649,417649,0,-22.34939
29/01/2018 17:06,2016,50,SOUTHERN AFRICA,REPUBLIC OF SOUTH AFRICA,1,HEATHROW,JOHANNESBURG,966897,966897,0,938503,938503,0,3.02546
29/01/2018 17:06,2016,50,SOUTHERN AFRICA,REPUBLIC OF SOUTH AFRICA,2,GLASGOW,JOHANNESBURG,5,0,5,0,0,0,0
29/01/2018 17:06,2016,55,MIDDLE EAST,BAHRAIN,1,HEATHROW,BAHRAIN,284005,284005,0,282835,282835,0,0.41367
29/01/2018 17:06,2016,55,MIDDLE EAST,BAHRAIN,1,LUTON,BAHRAIN,0,0,0,4,0,4,-100
29/01/2018 17:06,2016,55,MIDDLE EAST,IRAN,1,HEATHROW,TEHRAN IMAM KHOMEINI,78027,78027,0,50397,50397,0,54.82469
29/01/2018 17:06,2016,55,MIDDLE EAST,IRAN,1,LUTON,TEHRAN,4,0,4,0,0,0,0
29/01/2018 17:06,2016,55,MIDDLE EAST,IRAQ,1,GATWICK,BAGHDAD (GECA),6451,6392,59,12760,12760,0,-49.44357
29/01/2018 17:06,2016,55,MIDDLE EAST,IRAQ,1,GATWICK,ERBIL INTERNATIONAL,0,0,0,2468,2468,0,-100
29/01/2018 17:06,2016,55,MIDDLE EAST,IRAQ,1,GATWICK,SULAYMANIYAH INT,8274,8274,0,12082,12082,0,-31.51796
29/01/2018 17:06,2016,55,MIDDLE EAST,IRAQ,2,MANCHESTER,BAGHDAD (GECA),781,781,0,0,0,0,0
29/01/2018 17:06,2016,55,MIDDLE EAST,IRAQ,2,MANCHESTER,ERBIL INTERNATIONAL,0,0,0,2089,2089,0,-100
29/01/2018 17:06,2016,55,MIDDLE EAST,IRAQ,2,MANCHESTER,SULAYMANIYAH INT,0,0,0,5804,5804,0,-100
29/01/2018 17:06,2016,55,MIDDLE EAST,KUWAIT,1,HEATHROW,KUWAIT,279983,279983,0,272975,272975,0,2.56727
29/01/2018 17:06,2016,55,MIDDLE EAST,KUWAIT,1,LUTON,KUWAIT,18,0,18,0,0,0,0
29/01/2018 17:06,2016,55,MIDDLE EAST,KUWAIT,2,BIRMINGHAM,KUWAIT,220,220,0,0,0,0,0
29/01/2018 17:06,2016,55,MIDDLE EAST,OMAN,1,GATWICK,MUSCAT,0,0,0,536,0,536,-100
29/01/2018 17:06,2016,55,MIDDLE EAST,OMAN,1,HEATHROW,MUSCAT,252613,252613,0,179275,179275,0,40.9081
29/01/2018 17:06,2016,55,MIDDLE EAST,QATAR,1,HEATHROW,DOHA HAMAD,1206752,1206571,181,1072031,1072001,30,12.56689
29/01/2018 17:06,2016,55,MIDDLE EAST,QATAR,2,BIRMINGHAM,DOHA HAMAD,110585,110585,0,208,208,0,53065.86538
29/01/2018 17:06,2016,55,MIDDLE EAST,QATAR,2,EDINBURGH,DOHA HAMAD,133983,133983,0,115529,115529,0,15.97348
29/01/2018 17:06,2016,55,MIDDLE EAST,QATAR,2,LIVERPOOL (JOHN LENNON),DOHA HAMAD,0,0,0,44,0,44,-100
29/01/2018 17:06,2016,55,MIDDLE EAST,QATAR,2,MANCHESTER,DOHA HAMAD,336461,336461,0,293357,293357,0,14.69336
29/01/2018 17:06,2016,55,MIDDLE EAST,SAUDI ARABIA,1,GATWICK,RIYADH,0,0,0,29,0,29,-100
29/01/2018 17:06,2016,55,MIDDLE EAST,SAUDI ARABIA,1,HEATHROW,JEDDAH,248046,248046,0,223910,223910,0,10.77933
29/01/2018 17:06,2016,55,MIDDLE EAST,SAUDI ARABIA,1,HEATHROW,MEDINA,3929,3929,0,0,0,0,0
29/01/2018 17:06,2016,55,MIDDLE EAST,SAUDI ARABIA,1,HEATHROW,RIYADH,253021,253021,0,258982,258982,0,-2.3017
29/01/2018 17:06,2016,55,MIDDLE EAST,SAUDI ARABIA,1,LUTON,DHAHRAN,4,0,4,0,0,0,0
29/01/2018 17:06,2016,55,MIDDLE EAST,SAUDI ARABIA,1,LUTON,JEDDAH,3,0,3,35,0,35,-91.42857
29/01/2018 17:06,2016,55,MIDDLE EAST,SAUDI ARABIA,1,LUTON,RIYADH,9,0,9,33,0,33,-72.72727
29/01/2018 17:06,2016,55,MIDDLE EAST,SAUDI ARABIA,1,LUTON,TABUK,0,0,0,7,0,7,-100
29/01/2018 17:06,2016,55,MIDDLE EAST,SAUDI ARABIA,2,MANCHESTER,JEDDAH,86930,86930,0,77982,77982,0,11.47444
29/01/2018 17:06,2016,55,MIDDLE EAST,SAUDI ARABIA,2,MANCHESTER,MEDINA,186,186,0,0,0,0,0
29/01/2018 17:06,2016,55,MIDDLE EAST,UNITED ARAB EMIRATES,1,GATWICK,DUBAI,920462,920462,0,866101,866101,0,6.27652
29/01/2018 17:06,2016,55,MIDDLE EAST,UNITED ARAB EMIRATES,1,GATWICK,DUBAI (WORLD CENTRAL),1105,0,1105,0,0,0,0
29/01/2018 17:06,2016,55,MIDDLE EAST,UNITED ARAB EMIRATES,1,HEATHROW,ABU DHABI INTERNATIONAL,929020,929020,0,835901,835901,0,11.13996
29/01/2018 17:06,2016,55,MIDDLE EAST,UNITED ARAB EMIRATES,1,HEATHROW,DUBAI,2651776,2651776,0,2451738,2451738,0,8.15903
29/01/2018 17:06,2016,55,MIDDLE EAST,UNITED ARAB EMIRATES,1,LUTON,ABU DHABI - BATEEN,33,0,33,10,0,10,230
29/01/2018 17:06,2016,55,MIDDLE EAST,UNITED ARAB EMIRATES,1,LUTON,DUBAI,2,0,2,0,0,0,0
29/01/2018 17:06,2016,55,MIDDLE EAST,UNITED ARAB EMIRATES,1,SOUTHEND,SHARJAH,0,0,0,8,0,8,-100
29/01/2018 17:06,2016,55,MIDDLE EAST,UNITED ARAB EMIRATES,2,BIRMINGHAM,DUBAI,704632,704632,0,610649,610649,0,15.39067
29/01/2018 17:06,2016,55,MIDDLE EAST,UNITED ARAB EMIRATES,2,BIRMINGHAM,DUBAI (WORLD CENTRAL),1076,0,1076,1,0,1,107500
29/01/2018 17:06,2016,55,MIDDLE EAST,UNITED ARAB EMIRATES,2,CARDIFF WALES,SHARJAH,0,0,0,79,0,79,-100
29/01/2018 17:06,2016,55,MIDDLE EAST,UNITED ARAB EMIRATES,2,EDINBURGH,ABU DHABI INTERNATIONAL,127346,127346,0,72773,72773,0,74.99072
29/01/2018 17:06,2016,55,MIDDLE EAST,UNITED ARAB EMIRATES,2,GLASGOW,DUBAI,428098,428098,0,429602,429602,0,-0.35009
29/01/2018 17:06,2016,55,MIDDLE EAST,UNITED ARAB EMIRATES,2,GLASGOW,DUBAI (WORLD CENTRAL),280,0,280,0,0,0,0
29/01/2018 17:06,2016,55,MIDDLE EAST,UNITED ARAB EMIRATES,2,GLASGOW,SHARJAH,0,0,0,1,0,1,-100
29/01/2018 17:06,2016,55,MIDDLE EAST,UNITED ARAB EMIRATES,2,MANCHESTER,ABU DHABI INTERNATIONAL,436139,436139,0,431673,431364,309,1.03458
29/01/2018 17:06,2016,55,MIDDLE EAST,UNITED ARAB EMIRATES,2,MANCHESTER,DUBAI,932315,932315,0,861194,861194,0,8.25842
29/01/2018 17:06,2016,55,MIDDLE EAST,UNITED ARAB EMIRATES,2,MANCHESTER,DUBAI (WORLD CENTRAL),1661,0,1661,0,0,0,0
29/01/2018 17:06,2016,55,MIDDLE EAST,UNITED ARAB EMIRATES,2,NEWCASTLE,DUBAI,231047,231047,0,233489,233489,0,-1.04587
29/01/2018 17:06,2016,55,MIDDLE EAST,UNITED ARAB EMIRATES,2,NEWCASTLE,DUBAI (WORLD CENTRAL),291,0,291,0,0,0,0
29/01/2018 17:06,2016,60,INDIAN SUB-CONTINENT,BANGLADESH,1,HEATHROW,DHAKHA,71419,71419,0,68105,68105,0,4.86602
29/01/2018 17:06,2016,60,INDIAN SUB-CONTINENT,BANGLADESH,1,HEATHROW,SYLHET,52875,52875,0,49083,49083,0,7.72569
29/01/2018 17:06,2016,60,INDIAN SUB-CONTINENT,INDIA,1,GATWICK,GOA,39460,19102,20358,42653,8389,34264,-7.48599
29/01/2018 17:06,2016,60,INDIAN SUB-CONTINENT,INDIA,1,HEATHROW,AHMEDABAD,31524,31524,0,0,0,0,0
29/01/2018 17:06,2016,60,INDIAN SUB-CONTINENT,INDIA,1,HEATHROW,AMRITSAR,6927,6927,0,601,601,0,1052.57903
29/01/2018 17:06,2016,60,INDIAN SUB-CONTINENT,INDIA,1,HEATHROW,BANGALORE (BENGALURU),167169,167169,0,171970,171970,0,-2.79177
29/01/2018 17:06,2016,60,INDIAN SUB-CONTINENT,INDIA,1,HEATHROW,CHENNAI,131092,131092,0,126878,126878,0,3.3213
29/01/2018 17:06,2016,60,INDIAN SUB-CONTINENT,INDIA,1,HEATHROW,DELHI,1042532,1042532,0,1034172,1034172,0,0.80838
29/01/2018 17:06,2016,60,INDIAN SUB-CONTINENT,INDIA,1,HEATHROW,HYDERABAD ( RAJIV GHANDI ),135936,135936,0,136114,136114,0,-0.13077
29/01/2018 17:06,2016,60,INDIAN SUB-CONTINENT,INDIA,1,HEATHROW,MUMBAI,916714,916714,0,949485,949354,131,-3.45145
29/01/2018 17:06,2016,60,INDIAN SUB-CONTINENT,INDIA,1,LUTON,JAIPUR,56,0,56,0,0,0,0
29/01/2018 17:06,2016,60,INDIAN SUB-CONTINENT,INDIA,2,BIRMINGHAM,AMRITSAR,50591,50591,0,0,0,0,0
29/01/2018 17:06,2016,60,INDIAN SUB-CONTINENT,INDIA,2,BIRMINGHAM,DELHI,89747,89747,0,130092,130092,0,-31.01267
29/01/2018 17:06,2016,60,INDIAN SUB-CONTINENT,INDIA,2,BIRMINGHAM,MUMBAI,0,0,0,4240,4240,0,-100
29/01/2018 17:06,2016,60,INDIAN SUB-CONTINENT,INDIA,2,MANCHESTER,GOA,31184,26810,4374,27257,9230,18027,14.40731
29/01/2018 17:06,2016,60,INDIAN SUB-CONTINENT,PAKISTAN,1,GATWICK,ISLAMABAD,650,80,570,1137,0,1137,-42.83201
29/01/2018 17:06,2016,60,INDIAN SUB-CONTINENT,PAKISTAN,1,HEATHROW,ISLAMABAD,98916,98916,0,114875,114875,0,-13.89249
29/01/2018 17:06,2016,60,INDIAN SUB-CONTINENT,PAKISTAN,1,HEATHROW,KARACHI,43763,43763,0,35202,35202,0,24.31964
29/01/2018 17:06,2016,60,INDIAN SUB-CONTINENT,PAKISTAN,1,HEATHROW,LAHORE,75075,75075,0,95362,95362,0,-21.27367
29/01/2018 17:06,2016,60,INDIAN SUB-CONTINENT,PAKISTAN,2,BIRMINGHAM,ISLAMABAD,85642,85642,0,72160,72160,0,18.68348
29/01/2018 17:06,2016,60,INDIAN SUB-CONTINENT,PAKISTAN,2,MANCHESTER,ISLAMABAD,218981,218981,0,134049,134049,0,63.35892
29/01/2018 17:06,2016,60,INDIAN SUB-CONTINENT,PAKISTAN,2,MANCHESTER,KARACHI,2622,2622,0,1028,1028,0,155.05837
29/01/2018 17:06,2016,60,INDIAN SUB-CONTINENT,PAKISTAN,2,MANCHESTER,LAHORE,44890,44890,0,48913,48913,0,-8.22481
29/01/2018 17:06,2016,60,INDIAN SUB-CONTINENT,SRI LANKA,1,GATWICK,COLOMBO,3477,0,3477,19126,19126,0,-81.82056
29/01/2018 17:06,2016,60,INDIAN SUB-CONTINENT,SRI LANKA,1,HEATHROW,COLOMBO,208816,208816,0,203205,203205,0,2.76125
29/01/2018 17:06,2016,65,FAR EAST,BRUNEI,1,HEATHROW,BANDAR SERI BEGAWAN,77577,77577,0,85594,85594,0,-9.36631
29/01/2018 17:06,2016,65,FAR EAST,CHINA,1,GATWICK,CHONGQING JIANGBEI INTERNATIONAL,6719,6719,0,0,0,0,0
29/01/2018 17:06,2016,65,FAR EAST,CHINA,1,GATWICK,TIANJIN,11587,11587,0,0,0,0,0
29/01/2018 17:06,2016,65,FAR EAST,CHINA,1,GATWICK,XIAMEN,5,0,5,0,0,0,0
29/01/2018 17:06,2016,65,FAR EAST,CHINA,1,HEATHROW,BEIJING,494984,494984,0,448316,448316,0,10.40962
29/01/2018 17:06,2016,65,FAR EAST,CHINA,1,HEATHROW,CHENGDU,57107,57107,0,56649,56649,0,0.80849
29/01/2018 17:06,2016,65,FAR EAST,CHINA,1,HEATHROW,GUANGZHOU BAIYUN INTERNATIONAL,134854,134854,0,136498,136498,0,-1.20441
29/01/2018 17:06,2016,65,FAR EAST,CHINA,1,HEATHROW,SHANGHAI (PU DONG),464022,464022,0,431072,431072,0,7.64373
29/01/2018 17:06,2016,65,FAR EAST,CHINA,2,BIRMINGHAM,BEIJING,0,0,0,6715,0,6715,-100
29/01/2018 17:06,2016,65,FAR EAST,CHINA,2,MANCHESTER,BEIJING,54969,54860,109,0,0,0,0
29/01/2018 17:06,2016,65,FAR EAST,CHINA,2,MANCHESTER,SHANGHAI (PU DONG),110,0,110,0,0,0,0
29/01/2018 17:06,2016,65,FAR EAST,CHINA,2,MANCHESTER,SHENZHEN (HUANGTIAN),112,0,112,0,0,0,0
29/01/2018 17:06,2016,65,FAR EAST,HONG KONG,1,GATWICK,HONG KONG (CHEK LAP KOK),33325,33325,0,0,0,0,0
29/01/2018 17:06,2016,65,FAR EAST,HONG KONG,1,HEATHROW,HONG KONG (CHEK LAP KOK),1574741,1574741,0,1584486,1584486,0,-0.61503
29/01/2018 17:06,2016,65,FAR EAST,HONG KONG,2,BIRMINGHAM,HONG KONG (CHEK LAP KOK),345,345,0,0,0,0,0
29/01/2018 17:06,2016,65,FAR EAST,HONG KONG,2,MANCHESTER,HONG KONG (CHEK LAP KOK),121625,121625,0,124172,124172,0,-2.05119
29/01/2018 17:06,2016,65,FAR EAST,INDONESIA,1,GATWICK,JAKARTA (SOEKARNO-HATTA INTNL),8323,8323,0,72838,72838,0,-88.57327
29/01/2018 17:06,2016,65,FAR EAST,INDONESIA,1,HEATHROW,JAKARTA (SOEKARNO-HATTA INTNL),28052,28052,0,0,0,0,0
29/01/2018 17:06,2016,65,FAR EAST,JAPAN,1,HEATHROW,TOKYO (HANEDA),458382,458382,0,429905,429905,0,6.62402
29/01/2018 17:06,2016,65,FAR EAST,JAPAN,1,HEATHROW,TOKYO (NARITA),149651,149651,0,181423,181423,0,-17.51266
29/01/2018 17:06,2016,65,FAR EAST,MALAYSIA,1,HEATHROW,KUALA LUMPUR (SEPANG),622852,622852,0,606746,606746,0,2.65449
29/01/2018 17:06,2016,65,FAR EAST,MALAYSIA,2,LIVERPOOL (JOHN LENNON),KUALA LUMPUR (SEPANG),0,0,0,108,0,108,-100
29/01/2018 17:06,2016,65,FAR EAST,PHILIPPINES,1,HEATHROW,MANILA,108664,108664,0,85392,85392,0,27.25314
29/01/2018 17:06,2016,65,FAR EAST,REPUBLIC OF KOREA,1,HEATHROW,SEOUL (INCHEON),473602,473569,33,456557,456557,0,3.73338
29/01/2018 17:06,2016,65,FAR EAST,REPUBLIC OF KOREA,2,GLASGOW,SEOUL AFB,199,0,199,0,0,0,0
29/01/2018 17:06,2016,65,FAR EAST,SINGAPORE,1,HEATHROW,SINGAPORE,1198727,1198727,0,1150240,1150240,0,4.21538
29/01/2018 17:06,2016,65,FAR EAST,SINGAPORE,2,MANCHESTER,SINGAPORE,97512,97512,0,108950,108950,0,-10.49839
29/01/2018 17:06,2016,65,FAR EAST,TAIWAN,1,HEATHROW,TAIPEI,44681,44681,0,123578,123578,0,-63.84389
29/01/2018 17:06,2016,65,FAR EAST,THAILAND,1,GATWICK,PHUKET,14543,0,14543,12928,0,12928,12.49226
29/01/2018 17:06,2016,65,FAR EAST,THAILAND,1,HEATHROW,BANGKOK SUVARNABHUMI ,773105,773105,0,599558,599558,0,28.94582
29/01/2018 17:06,2016,65,FAR EAST,THAILAND,2,MANCHESTER,BANGKOK (DON MUANG),0,0,0,95,0,95,-100
29/01/2018 17:06,2016,65,FAR EAST,THAILAND,2,MANCHESTER,PHUKET,2501,0,2501,0,0,0,0
29/01/2018 17:06,2016,65,FAR EAST,VIETNAM,1,GATWICK,HANOI,0,0,0,11857,11857,0,-100
29/01/2018 17:06,2016,65,FAR EAST,VIETNAM,1,GATWICK,HO CHI MINH CITY,0,0,0,11894,11894,0,-100
29/01/2018 17:06,2016,65,FAR EAST,VIETNAM,1,HEATHROW,HANOI,72965,72965,0,46106,46106,0,58.25489
29/01/2018 17:06,2016,65,FAR EAST,VIETNAM,1,HEATHROW,HO CHI MINH CITY,59873,59873,0,36852,36852,0,62.46879
29/01/2018 17:06,2016,70,AUSTRALASIA,AUSTRALIA,1,HEATHROW,BRISBANE,332,0,332,0,0,0,0
29/01/2018 17:06,2016,70,AUSTRALASIA,AUSTRALIA,1,HEATHROW,MELBOURNE,134547,134211,336,139556,139224,332,-3.58924
29/01/2018 17:06,2016,70,AUSTRALASIA,AUSTRALIA,1,HEATHROW,SYDNEY,290552,289883,669,304131,302799,1332,-4.46485
29/01/2018 17:06,2016,70,AUSTRALASIA,AUSTRALIA,1,STANSTED,SYDNEY,1042,0,1042,0,0,0,0
29/01/2018 17:06,2016,70,AUSTRALASIA,NEW ZEALAND,1,HEATHROW,AUCKLAND INTERNATIONAL,36071,36071,0,125887,125887,0,-71.34653
29/01/2018 17:06,2016,75,CANADA,CANADA,1,GATWICK,CALGARY,99035,99035,0,34589,34589,0,186.31935
29/01/2018 17:06,2016,75,CANADA,CANADA,1,GATWICK,EDMONTON,22870,22870,0,0,0,0,0
29/01/2018 17:06,2016,75,CANADA,CANADA,1,GATWICK,HALIFAX INT,0,0,0,5688,5688,0,-100
29/01/2018 17:06,2016,75,CANADA,CANADA,1,GATWICK,MONTREAL (DORVAL),24304,24304,0,18495,18425,70,31.40849
29/01/2018 17:06,2016,75,CANADA,CANADA,1,GATWICK,OTTAWA INTERNATIONAL,36146,36146,0,0,0,0,0
29/01/2018 17:06,2016,75,CANADA,CANADA,1,GATWICK,ST JOHNS,242,242,0,0,0,0,0
29/01/2018 17:06,2016,75,CANADA,CANADA,1,GATWICK,TORONTO,387774,387774,0,197014,197014,0,96.82561
29/01/2018 17:06,2016,75,CANADA,CANADA,1,GATWICK,VANCOUVER,171121,171121,0,102678,102678,0,66.6579
29/01/2018 17:06,2016,75,CANADA,CANADA,1,GATWICK,WINNIPEG,10480,10480,0,0,0,0,0
29/01/2018 17:06,2016,75,CANADA,CANADA,1,HEATHROW,CALGARY,287730,287730,0,304623,304623,0,-5.54554
29/01/2018 17:06,2016,75,CANADA,CANADA,1,HEATHROW,EDMONTON,0,0,0,39754,39754,0,-100
29/01/2018 17:06,2016,75,CANADA,CANADA,1,HEATHROW,HALIFAX INT,77811,77811,0,84120,84120,0,-7.5
29/01/2018 17:06,2016,75,CANADA,CANADA,1,HEATHROW,MONTREAL (DORVAL),311076,311076,0,317390,317390,0,-1.98935
29/01/2018 17:06,2016,75,CANADA,CANADA,1,HEATHROW,OTTAWA INTERNATIONAL,115498,115498,0,112635,112635,0,2.54184
29/01/2018 17:06,2016,75,CANADA,CANADA,1,HEATHROW,ST JOHNS,35434,35434,0,41995,41995,0,-15.62329
29/01/2018 17:06,2016,75,CANADA,CANADA,1,HEATHROW,TORONTO,1053524,1053208,316,1032206,1032206,0,2.06529
29/01/2018 17:06,2016,75,CANADA,CANADA,1,HEATHROW,VANCOUVER,567804,567804,0,550641,550641,0,3.11691
29/01/2018 17:06,2016,75,CANADA,CANADA,1,LUTON,GANDER,6,0,6,0,0,0,0
29/01/2018 17:06,2016,75,CANADA,CANADA,2,BELFAST INTERNATIONAL,TORONTO,0,0,0,221,0,221,-100
29/01/2018 17:06,2016,75,CANADA,CANADA,2,BIRMINGHAM,TORONTO,12302,12290,12,12024,12024,0,2.31204
29/01/2018 17:06,2016,75,CANADA,CANADA,2,EDINBURGH,GANDER,0,0,0,176,0,176,-100
29/01/2018 17:06,2016,75,CANADA,CANADA,2,EDINBURGH,TORONTO,25707,25707,0,32316,32219,97,-20.45117
29/01/2018 17:06,2016,75,CANADA,CANADA,2,GLASGOW,CALGARY,0,0,0,4055,4055,0,-100
29/01/2018 17:06,2016,75,CANADA,CANADA,2,GLASGOW,HALIFAX INT,118,118,0,0,0,0,0
29/01/2018 17:06,2016,75,CANADA,CANADA,2,GLASGOW,MONTREAL (DORVAL),4158,4158,0,0,0,0,0
29/01/2018 17:06,2016,75,CANADA,CANADA,2,GLASGOW,TORONTO,123313,123313,0,96959,96959,0,27.18056
29/01/2018 17:06,2016,75,CANADA,CANADA,2,GLASGOW,VANCOUVER,13213,13213,0,14931,14931,0,-11.50626
29/01/2018 17:06,2016,75,CANADA,CANADA,2,MANCHESTER,CALGARY,16637,16637,0,20047,20047,0,-17.01003
29/01/2018 17:06,2016,75,CANADA,CANADA,2,MANCHESTER,TORONTO,105480,105480,0,103453,103369,84,1.95934
29/01/2018 17:06,2016,75,CANADA,CANADA,2,MANCHESTER,VANCOUVER,27590,27590,0,28206,28206,0,-2.18393
29/01/2018 17:06,2016,75,CANADA,CANADA,2,NEWCASTLE,HALIFAX INT,39,0,39,0,0,0,0
29/01/2018 17:06,2016,75,CANADA,CANADA,2,PRESTWICK,TORONTO,93,0,93,0,0,0,0
29/01/2018 17:06,2016,80,UNITED STATES OF AMERICA,USA,1,GATWICK,BOSTON,94713,94713,0,0,0,0,0
29/01/2018 17:06,2016,80,UNITED STATES OF AMERICA,USA,1,GATWICK,BUFFALO,0,0,0,382,0,382,-100
29/01/2018 17:06,2016,80,UNITED STATES OF AMERICA,USA,1,GATWICK,DETROIT,65,65,0,0,0,0,0
29/01/2018 17:06,2016,80,UNITED STATES OF AMERICA,USA,1,GATWICK,FORT LAUDERDALE,50383,50383,0,40848,40848,0,23.34264
29/01/2018 17:06,2016,80,UNITED STATES OF AMERICA,USA,1,GATWICK,INDIANAPOLIS,451,0,451,0,0,0,0
29/01/2018 17:06,2016,80,UNITED STATES OF AMERICA,USA,1,GATWICK,LAS VEGAS,284941,284941,0,309622,309622,0,-7.97133
29/01/2018 17:06,2016,80,UNITED STATES OF AMERICA,USA,1,GATWICK,LOS ANGELES INTERNATIONAL,141341,141252,89,88490,88391,99,59.72539
29/01/2018 17:06,2016,80,UNITED STATES OF AMERICA,USA,1,GATWICK,MINNEAPOLIS-ST PAUL,86,0,86,0,0,0,0
29/01/2018 17:06,2016,80,UNITED STATES OF AMERICA,USA,1,GATWICK,NEW ORLEANS,1142,0,1142,0,0,0,0
29/01/2018 17:06,2016,80,UNITED STATES OF AMERICA,USA,1,GATWICK,NEW YORK (JF KENNEDY),330755,330755,0,147879,147879,0,123.66597
29/01/2018 17:06,2016,80,UNITED STATES OF AMERICA,USA,1,GATWICK,OAKLAND,55917,55917,0,0,0,0,0
29/01/2018 17:06,2016,80,UNITED STATES OF AMERICA,USA,1,GATWICK,ORLANDO,791669,791668,1,737221,737221,0,7.38557
29/01/2018 17:06,2016,80,UNITED STATES OF AMERICA,USA,1,GATWICK,SANFORD,41493,0,41493,49491,0,49491,-16.16051
29/01/2018 17:06,2016,80,UNITED STATES OF AMERICA,USA,1,GATWICK,TAMPA,156276,156276,0,158156,158156,0,-1.1887
29/01/2018 17:06,2016,80,UNITED STATES OF AMERICA,USA,1,GATWICK,WASHINGTON (DULLES),0,0,0,81,0,81,-100
29/01/2018 17:06,2016,80,UNITED STATES OF AMERICA,USA,1,HEATHROW,ATLANTA,638995,638995,0,611883,611883,0,4.43091
29/01/2018 17:06,2016,80,UNITED STATES OF AMERICA,USA,1,HEATHROW,AUSTIN (BERGSTROM),130614,130614,0,124495,124495,0,4.91506
29/01/2018 17:06,2016,80,UNITED STATES OF AMERICA,USA,1,HEATHROW,BALTIMORE,120460,120460,0,113531,113531,0,6.10318
29/01/2018 17:06,2016,80,UNITED STATES OF AMERICA,USA,1,HEATHROW,BOSTON,798119,798119,0,858358,858358,0,-7.01793
29/01/2018 17:06,2016,80,UNITED STATES OF AMERICA,USA,1,HEATHROW,BUFFALO,0,0,0,361,0,361,-100
29/01/2018 17:06,2016,80,UNITED STATES OF AMERICA,USA,1,HEATHROW,CHARLOTTE,301682,301682,0,292938,292938,0,2.98493
29/01/2018 17:06,2016,80,UNITED STATES OF AMERICA,USA,1,HEATHROW,CHICAGO (O'HARE),1072875,1072875,0,1059686,1059686,0,1.24461
29/01/2018 17:06,2016,80,UNITED STATES OF AMERICA,USA,1,HEATHROW,CINCINNATI,336,0,336,0,0,0,0
29/01/2018 17:06,2016,80,UNITED STATES OF AMERICA,USA,1,HEATHROW,COLUMBUS RICKENBACKER AFB,0,0,0,529,0,529,-100
29/01/2018 17:06,2016,80,UNITED STATES OF AMERICA,USA,1,HEATHROW,DALLAS/FORT WORTH,655590,655590,0,637977,637977,0,2.76076
29/01/2018 17:06,2016,80,UNITED STATES OF AMERICA,USA,1,HEATHROW,DENVER INTERNATIONAL,192441,192441,0,187639,187639,0,2.55917
29/01/2018 17:06,2016,80,UNITED STATES OF AMERICA,USA,1,HEATHROW,DETROIT,215904,215742,162,191483,191189,294,12.75361
29/01/2018 17:06,2016,80,UNITED STATES OF AMERICA,USA,1,HEATHROW,FORT LAUDERDALE,0,0,0,179,0,179,-100
29/01/2018 17:06,2016,80,UNITED STATES OF AMERICA,USA,1,HEATHROW,HOUSTON,515278,515278,0,564300,564300,0,-8.68722
29/01/2018 17:06,2016,80,UNITED STATES OF AMERICA,USA,1,HEATHROW,INDIANAPOLIS,336,0,336,0,0,0,0
29/01/2018 17:06,2016,80,UNITED STATES OF AMERICA,USA,1,HEATHROW,JACKSONVILLE,404,0,404,404,0,404,0
29/01/2018 17:06,2016,80,UNITED STATES OF AMERICA,USA,1,HEATHROW,KANSAS CITY,0,0,0,403,0,403,-100
29/01/2018 17:06,2016,80,UNITED STATES OF AMERICA,USA,1,HEATHROW,LAS VEGAS,312708,312708,0,231104,231104,0,35.31051
29/01/2018 17:06,2016,80,UNITED STATES OF AMERICA,USA,1,HEATHROW,LOS ANGELES INTERNATIONAL,1529632,1529455,177,1518903,1518903,0,0.70637
29/01/2018 17:06,2016,80,UNITED STATES OF AMERICA,USA,1,HEATHROW,MIAMI INTERNATIONAL,1030483,1030483,0,1030673,1030489,184,-0.01843
29/01/2018 17:06,2016,80,UNITED STATES OF AMERICA,USA,1,HEATHROW,MINNEAPOLIS-ST PAUL,134659,134235,424,138063,138063,0,-2.46554
29/01/2018 17:06,2016,80,UNITED STATES OF AMERICA,USA,1,HEATHROW,NEW YORK (JF KENNEDY),2934554,2934554,0,3050499,3050499,0,-3.80085
29/01/2018 17:06,2016,80,UNITED STATES OF AMERICA,USA,1,HEATHROW,NEW YORK (NEWARK),944639,944225,414,999986,999577,409,-5.53478
29/01/2018 17:06,2016,80,UNITED STATES OF AMERICA,USA,1,HEATHROW,ORLANDO,1004,0,1004,653,0,653,53.75191
29/01/2018 17:06,2016,80,UNITED STATES OF AMERICA,USA,1,HEATHROW,PHILADELPHIA INTERNATIONAL,457612,457612,0,468083,468083,0,-2.237
29/01/2018 17:06,2016,80,UNITED STATES OF AMERICA,USA,1,HEATHROW,PHOENIX,216995,216995,0,216935,216935,0,0.02766
29/01/2018 17:06,2016,80,UNITED STATES OF AMERICA,USA,1,HEATHROW,RALEIGH,111152,111152,0,115279,115279,0,-3.58001
29/01/2018 17:06,2016,80,UNITED STATES OF AMERICA,USA,1,HEATHROW,SALT LAKE CITY,63606,63606,0,0,0,0,0
29/01/2018 17:06,2016,80,UNITED STATES OF AMERICA,USA,1,HEATHROW,SAN DIEGO,196067,196067,0,177623,177623,0,10.38379
29/01/2018 17:06,2016,80,UNITED STATES OF AMERICA,USA,1,HEATHROW,SAN FRANCISCO,1016616,1016616,0,1046981,1046981,0,-2.90024
29/01/2018 17:06,2016,80,UNITED STATES OF AMERICA,USA,1,HEATHROW,SAN JOSE,76302,76302,0,0,0,0,0
29/01/2018 17:06,2016,80,UNITED STATES OF AMERICA,USA,1,HEATHROW,SEATTLE (TACOMA),370113,370113,0,349759,349759,0,5.81944
29/01/2018 17:06,2016,80,UNITED STATES OF AMERICA,USA,1,HEATHROW,WASHINGTON (DULLES),849690,849381,309,866457,866457,0,-1.93512
29/01/2018 17:06,2016,80,UNITED STATES OF AMERICA,USA,1,LONDON CITY,NEW YORK (JF KENNEDY),18850,18850,0,21375,21375,0,-11.81287
29/01/2018 17:06,2016,80,UNITED STATES OF AMERICA,USA,1,LUTON,BOSTON,7,0,7,6,0,6,16.66667
29/01/2018 17:06,2016,80,UNITED STATES OF AMERICA,USA,1,LUTON,DALLAS,9,0,9,2,0,2,350
29/01/2018 17:06,2016,80,UNITED STATES OF AMERICA,USA,1,LUTON,INDIANAPOLIS,8,0,8,0,0,0,0
29/01/2018 17:06,2016,80,UNITED STATES OF AMERICA,USA,1,LUTON,LOS ANGELES INTERNATIONAL,6,0,6,0,0,0,0
29/01/2018 17:06,2016,80,UNITED STATES OF AMERICA,USA,1,LUTON,MILWAUKEE,0,0,0,78,0,78,-100
29/01/2018 17:06,2016,80,UNITED STATES OF AMERICA,USA,1,LUTON,MINNEAPOLIS-ST PAUL,4,0,4,0,0,0,0
29/01/2018 17:06,2016,80,UNITED STATES OF AMERICA,USA,1,LUTON,NEW YORK (JF KENNEDY),0,0,0,27,0,27,-100
29/01/2018 17:06,2016,80,UNITED STATES OF AMERICA,USA,1,LUTON,NEW YORK (NEWARK),16333,16323,10,12660,12660,0,29.01264
29/01/2018 17:06,2016,80,UNITED STATES OF AMERICA,USA,1,LUTON,WASHINGTON (DULLES),4,0,4,0,0,0,0
29/01/2018 17:06,2016,80,UNITED STATES OF AMERICA,USA,1,SOUTHEND,LOS ANGELES INTERNATIONAL,0,0,0,8,0,8,-100
29/01/2018 17:06,2016,80,UNITED STATES OF AMERICA,USA,1,STANSTED,FORT LAUDERDALE,321,321,0,0,0,0,0
29/01/2018 17:06,2016,80,UNITED STATES OF AMERICA,USA,1,STANSTED,LAS VEGAS,3515,3515,0,3226,3226,0,8.95846
29/01/2018 17:06,2016,80,UNITED STATES OF AMERICA,USA,1,STANSTED,ORLANDO,39819,39819,0,6340,6340,0,528.05994
29/01/2018 17:06,2016,80,UNITED STATES OF AMERICA,USA,1,STANSTED,SANFORD,11365,0,11365,0,0,0,0
29/01/2018 17:06,2016,80,UNITED STATES OF AMERICA,USA,2,BELFAST INTERNATIONAL,CHICAGO (O'HARE),0,0,0,260,0,260,-100
29/01/2018 17:06,2016,80,UNITED STATES OF AMERICA,USA,2,BELFAST INTERNATIONAL,LAS VEGAS,0,0,0,1118,622,496,-100
29/01/2018 17:06,2016,80,UNITED STATES OF AMERICA,USA,2,BELFAST INTERNATIONAL,NEW YORK (JF KENNEDY),0,0,0,553,0,553,-100
29/01/2018 17:06,2016,80,UNITED STATES OF AMERICA,USA,2,BELFAST INTERNATIONAL,NEW YORK (NEWARK),79042,79042,0,69258,69258,0,14.12689
29/01/2018 17:06,2016,80,UNITED STATES OF AMERICA,USA,2,BELFAST INTERNATIONAL,ORLANDO,5508,3095,2413,5831,2925,2906,-5.53936
29/01/2018 17:06,2016,80,UNITED STATES OF AMERICA,USA,2,BIRMINGHAM,NEW ORLEANS,574,0,574,0,0,0,0
29/01/2018 17:06,2016,80,UNITED STATES OF AMERICA,USA,2,BIRMINGHAM,NEW YORK (JF KENNEDY),69526,69526,0,50950,50950,0,36.45927
29/01/2018 17:06,2016,80,UNITED STATES OF AMERICA,USA,2,BIRMINGHAM,NEW YORK (NEWARK),78469,78469,0,88573,88573,0,-11.40754
29/01/2018 17:06,2016,80,UNITED STATES OF AMERICA,USA,2,BIRMINGHAM,SANFORD,17190,0,17190,15550,0,15550,10.54662
29/01/2018 17:06,2016,80,UNITED STATES OF AMERICA,USA,2,CARDIFF WALES,FORT LAUDERDALE,44,0,44,0,0,0,0
29/01/2018 17:06,2016,80,UNITED STATES OF AMERICA,USA,2,CARDIFF WALES,ORLANDO,617,0,617,555,0,555,11.17117
29/01/2018 17:06,2016,80,UNITED STATES OF AMERICA,USA,2,EAST MIDLANDS INTERNATIONAL,NEW YORK (NEWARK),880,880,0,866,866,0,1.61663
29/01/2018 17:06,2016,80,UNITED STATES OF AMERICA,USA,2,EAST MIDLANDS INTERNATIONAL,SANFORD,12060,293,11767,12115,0,12115,-0.45398
29/01/2018 17:06,2016,80,UNITED STATES OF AMERICA,USA,2,EDINBURGH,CHICAGO (O'HARE),31868,31868,0,33479,33479,0,-4.81197
29/01/2018 17:06,2016,80,UNITED STATES OF AMERICA,USA,2,EDINBURGH,MOLINE (QUAD CITY),0,0,0,98,0,98,-100
29/01/2018 17:06,2016,80,UNITED STATES OF AMERICA,USA,2,EDINBURGH,NEW YORK (JF KENNEDY),117128,117128,0,45471,45471,0,157.58835
29/01/2018 17:06,2016,80,UNITED STATES OF AMERICA,USA,2,EDINBURGH,NEW YORK (NEWARK),133650,133650,0,143414,143414,0,-6.80826
29/01/2018 17:06,2016,80,UNITED STATES OF AMERICA,USA,2,EDINBURGH,SANFORD,2328,0,2328,2331,0,2331,-0.1287
29/01/2018 17:06,2016,80,UNITED STATES OF AMERICA,USA,2,GLASGOW,LAS VEGAS,22156,8263,13893,19370,19370,0,14.38307
29/01/2018 17:06,2016,80,UNITED STATES OF AMERICA,USA,2,GLASGOW,MINOT INTERNATIONAL,0,0,0,1,0,1,-100
29/01/2018 17:06,2016,80,UNITED STATES OF AMERICA,USA,2,GLASGOW,NEW YORK (NEWARK),99975,99975,0,105588,105582,6,-5.31594
29/01/2018 17:06,2016,80,UNITED STATES OF AMERICA,USA,2,GLASGOW,ORLANDO,98805,81199,17606,80669,80412,257,22.48199
29/01/2018 17:06,2016,80,UNITED STATES OF AMERICA,USA,2,GLASGOW,PHILADELPHIA INTERNATIONAL,36292,36292,0,42696,42696,0,-14.99906
29/01/2018 17:06,2016,80,UNITED STATES OF AMERICA,USA,2,GLASGOW,SANFORD,16530,0,16530,16008,0,16008,3.26087
29/01/2018 17:06,2016,80,UNITED STATES OF AMERICA,USA,2,LEEDS BRADFORD,NEW YORK (NEWARK),2873,2873,0,2195,2195,0,30.88838
29/01/2018 17:06,2016,80,UNITED STATES OF AMERICA,USA,2,LIVERPOOL (JOHN LENNON),SAN JOSE,86,0,86,0,0,0,0
29/01/2018 17:06,2016,80,UNITED STATES OF AMERICA,USA,2,LIVERPOOL (JOHN LENNON),ST LOUIS (LAMBERT),95,0,95,0,0,0,0
29/01/2018 17:06,2016,80,UNITED STATES OF AMERICA,USA,2,MANCHESTER,ATLANTA,152368,152368,0,140600,140600,0,8.36984
29/01/2018 17:06,2016,80,UNITED STATES OF AMERICA,USA,2,MANCHESTER,BOSTON,15843,15843,0,0,0,0,0
29/01/2018 17:06,2016,80,UNITED STATES OF AMERICA,USA,2,MANCHESTER,CHICAGO (O'HARE),76214,76214,0,82222,82222,0,-7.30705
29/01/2018 17:06,2016,80,UNITED STATES OF AMERICA,USA,2,MANCHESTER,HOUSTON,5603,5603,0,0,0,0,0
29/01/2018 17:06,2016,80,UNITED STATES OF AMERICA,USA,2,MANCHESTER,LAS VEGAS,138335,138335,0,113577,113577,0,21.79843
29/01/2018 17:06,2016,80,UNITED STATES OF AMERICA,USA,2,MANCHESTER,LOS ANGELES INTERNATIONAL,28791,28791,0,0,0,0,0
29/01/2018 17:06,2016,80,UNITED STATES OF AMERICA,USA,2,MANCHESTER,MIAMI INTERNATIONAL,35715,35371,344,36594,36594,0,-2.40203
29/01/2018 17:06,2016,80,UNITED STATES OF AMERICA,USA,2,MANCHESTER,NEW ORLEANS,1138,0,1138,0,0,0,0
29/01/2018 17:06,2016,80,UNITED STATES OF AMERICA,USA,2,MANCHESTER,NEW YORK (JF KENNEDY),321887,321887,0,232786,232786,0,38.27593
29/01/2018 17:06,2016,80,UNITED STATES OF AMERICA,USA,2,MANCHESTER,NEW YORK (LA GUARDIA),0,0,0,88,0,88,-100
29/01/2018 17:06,2016,80,UNITED STATES OF AMERICA,USA,2,MANCHESTER,NEW YORK (NEWARK),104148,104148,0,111439,111439,0,-6.54259
29/01/2018 17:06,2016,80,UNITED STATES OF AMERICA,USA,2,MANCHESTER,ORLANDO,490439,490439,0,450575,450575,0,8.84736
29/01/2018 17:06,2016,80,UNITED STATES OF AMERICA,USA,2,MANCHESTER,PHILADELPHIA INTERNATIONAL,120330,120330,0,129865,129865,0,-7.34224
29/01/2018 17:06,2016,80,UNITED STATES OF AMERICA,USA,2,MANCHESTER,SAN FRANCISCO,235,235,0,0,0,0,0
29/01/2018 17:06,2016,80,UNITED STATES OF AMERICA,USA,2,MANCHESTER,SANFORD,52582,0,52582,53213,0,53213,-1.1858
29/01/2018 17:06,2016,80,UNITED STATES OF AMERICA,USA,2,MANCHESTER,SEATTLE (TACOMA),0,0,0,111,0,111,-100
29/01/2018 17:06,2016,80,UNITED STATES OF AMERICA,USA,2,MANCHESTER,WASHINGTON (DULLES),46574,46574,0,64432,64432,0,-27.71604
29/01/2018 17:06,2016,80,UNITED STATES OF AMERICA,USA,2,NEWCASTLE,NEW YORK (NEWARK),20497,20497,0,17044,17044,0,20.25933
29/01/2018 17:06,2016,80,UNITED STATES OF AMERICA,USA,2,NEWCASTLE,SANFORD,17435,17135,300,17126,0,17126,1.80427
29/01/2018 17:06,2016,80,UNITED STATES OF AMERICA,USA,2,PRESTWICK,PHILADELPHIA INTERNATIONAL,54,0,54,0,0,0,0
29/01/2018 17:06,2016,80,UNITED STATES OF AMERICA,USA,2,PRESTWICK,SEATTLE (TACOMA),4,4,0,0,0,0,0
29/01/2018 17:06,2016,85,CENTRAL AMERICA,COSTA RICA,1,GATWICK,LIBERIA,29193,0,29193,4454,0,4454,555.43332
29/01/2018 17:06,2016,85,CENTRAL AMERICA,COSTA RICA,1,GATWICK,SAN JOSE COST RICA,31391,31391,0,0,0,0,0
29/01/2018 17:06,2016,85,CENTRAL AMERICA,CUBA,1,GATWICK,CUNAGUA (CAYO COCO),16624,16624,0,0,0,0,0
29/01/2018 17:06,2016,85,CENTRAL AMERICA,CUBA,1,GATWICK,HAVANA,92242,92242,0,85995,85995,0,7.26438
29/01/2018 17:06,2016,85,CENTRAL AMERICA,CUBA,1,GATWICK,HOLGUIN (FRANK PAIS),30091,30091,0,32605,5188,27417,-7.71047
29/01/2018 17:06,2016,85,CENTRAL AMERICA,CUBA,1,GATWICK,VARADERO,20131,0,20131,0,0,0,0
29/01/2018 17:06,2016,85,CENTRAL AMERICA,CUBA,2,BELFAST INTERNATIONAL,VARADERO,467,0,467,0,0,0,0
29/01/2018 17:06,2016,85,CENTRAL AMERICA,CUBA,2,GLASGOW,CUNAGUA (CAYO COCO),1237,622,615,637,0,637,94.19152
29/01/2018 17:06,2016,85,CENTRAL AMERICA,CUBA,2,GLASGOW,HOLGUIN (FRANK PAIS),1449,558,891,223,223,0,549.77578
29/01/2018 17:06,2016,85,CENTRAL AMERICA,CUBA,2,GLASGOW,VARADERO,205,205,0,0,0,0,0
29/01/2018 17:06,2016,85,CENTRAL AMERICA,CUBA,2,MANCHESTER,CUNAGUA (CAYO COCO),31646,31646,0,32385,3052,29333,-2.28192
29/01/2018 17:06,2016,85,CENTRAL AMERICA,CUBA,2,MANCHESTER,HOLGUIN (FRANK PAIS),51380,43388,7992,47838,0,47838,7.40416
29/01/2018 17:06,2016,85,CENTRAL AMERICA,CUBA,2,MANCHESTER,VARADERO,31482,31482,0,32378,2360,30018,-2.76731
29/01/2018 17:06,2016,85,CENTRAL AMERICA,DOMINICAN REPUBLIC,1,GATWICK,PUERTO PLATA,31292,0,31292,30733,0,30733,1.81889
29/01/2018 17:06,2016,85,CENTRAL AMERICA,DOMINICAN REPUBLIC,1,GATWICK,PUNTA CANA,132532,52149,80383,139339,53046,86293,-4.88521
29/01/2018 17:06,2016,85,CENTRAL AMERICA,DOMINICAN REPUBLIC,2,BIRMINGHAM,PUNTA CANA,20424,0,20424,0,0,0,0
29/01/2018 17:06,2016,85,CENTRAL AMERICA,DOMINICAN REPUBLIC,2,MANCHESTER,PUERTO PLATA,30849,0,30849,29496,0,29496,4.58706
29/01/2018 17:06,2016,85,CENTRAL AMERICA,DOMINICAN REPUBLIC,2,MANCHESTER,PUNTA CANA,107591,0,107591,79181,0,79181,35.87982
29/01/2018 17:06,2016,85,CENTRAL AMERICA,MEXICO,1,GATWICK,ACAPULCO,993,0,993,0,0,0,0
29/01/2018 17:06,2016,85,CENTRAL AMERICA,MEXICO,1,GATWICK,CANCUN,410685,245481,165204,400189,247006,153183,2.62276
29/01/2018 17:06,2016,85,CENTRAL AMERICA,MEXICO,1,GATWICK,COZUMEL,964,0,964,0,0,0,0
29/01/2018 17:06,2016,85,CENTRAL AMERICA,MEXICO,1,GATWICK,PUERTO VALLARTA,30987,0,30987,29385,0,29385,5.45176
29/01/2018 17:06,2016,85,CENTRAL AMERICA,MEXICO,1,HEATHROW,MEXICO CITY,252812,252812,0,232998,232998,0,8.50394
29/01/2018 17:06,2016,85,CENTRAL AMERICA,MEXICO,1,STANSTED,CANCUN,20080,3697,16383,3213,3213,0,524.9611
29/01/2018 17:06,2016,85,CENTRAL AMERICA,MEXICO,2,BIRMINGHAM,CANCUN,57164,0,57164,49210,0,49210,16.16338
29/01/2018 17:06,2016,85,CENTRAL AMERICA,MEXICO,2,CARDIFF WALES,CANCUN,521,0,521,0,0,0,0
29/01/2018 17:06,2016,85,CENTRAL AMERICA,MEXICO,2,EAST MIDLANDS INTERNATIONAL,CANCUN,11891,0,11891,12196,0,12196,-2.50082
29/01/2018 17:06,2016,85,CENTRAL AMERICA,MEXICO,2,EDINBURGH,CANCUN,2328,0,2328,2331,0,2331,-0.1287
29/01/2018 17:06,2016,85,CENTRAL AMERICA,MEXICO,2,GLASGOW,CANCUN,36334,5440,30894,34767,19115,15652,4.50715
29/01/2018 17:06,2016,85,CENTRAL AMERICA,MEXICO,2,MANCHESTER,CANCUN,219452,101000,118452,215852,78821,137031,1.66781
29/01/2018 17:06,2016,85,CENTRAL AMERICA,MEXICO,2,MANCHESTER,PUERTO VALLARTA,30096,0,30096,28104,0,28104,7.08796
29/01/2018 17:06,2016,85,CENTRAL AMERICA,MEXICO,2,NEWCASTLE,CANCUN,24326,24029,297,17327,0,17327,40.39361
29/01/2018 17:06,2016,90,SOUTH AMERICA,ARGENTINA,1,HEATHROW,BUENOS AIRES,177238,177238,0,151603,151190,413,16.9093
29/01/2018 17:06,2016,90,SOUTH AMERICA,BRAZIL,1,HEATHROW,RIO DE JANEIRO (GALEAO),138704,138080,624,166647,166647,0,-16.76778
29/01/2018 17:06,2016,90,SOUTH AMERICA,BRAZIL,1,HEATHROW,SAO PAULO (GUARULHOS),422422,422422,0,462775,462775,0,-8.71979
29/01/2018 17:06,2016,90,SOUTH AMERICA,COLOMBIA,1,GATWICK,CARTAGENA,1470,0,1470,0,0,0,0
29/01/2018 17:06,2016,90,SOUTH AMERICA,COLOMBIA,1,HEATHROW,BOGOTA,149723,149723,0,109427,109427,0,36.82455
29/01/2018 17:06,2016,90,SOUTH AMERICA,ECUADOR,1,GATWICK,GUAYAQUIL,868,0,868,0,0,0,0
29/01/2018 17:06,2016,90,SOUTH AMERICA,PERU,1,GATWICK,LIMA,36744,36744,0,0,0,0,0
29/01/2018 17:06,2016,90,SOUTH AMERICA,VENEZUELA,1,HEATHROW,CARACAS,0,0,0,235,0,235,-100
29/01/2018 17:06,2016,95,CARIBBEAN AREA,ANTIGUA AND BARBUDA,1,GATWICK,ANTIGUA,152851,152851,0,108406,108406,0,40.99865
29/01/2018 17:06,2016,95,CARIBBEAN AREA,ANTIGUA AND BARBUDA,2,MANCHESTER,ANTIGUA,4898,4898,0,2002,2002,0,144.65534
29/01/2018 17:06,2016,95,CARIBBEAN AREA,BAHAMAS,1,GATWICK,NASSAU,312,0,312,0,0,0,0
29/01/2018 17:06,2016,95,CARIBBEAN AREA,BAHAMAS,1,HEATHROW,NASSAU,51108,51108,0,52503,52503,0,-2.65699
29/01/2018 17:06,2016,95,CARIBBEAN AREA,BARBADOS,1,GATWICK,BRIDGETOWN,447003,383182,63821,433135,373150,59985,3.20177
29/01/2018 17:06,2016,95,CARIBBEAN AREA,BARBADOS,1,HEATHROW,BRIDGETOWN,454,454,0,0,0,0,0
29/01/2018 17:06,2016,95,CARIBBEAN AREA,BARBADOS,1,LUTON,BRIDGETOWN,0,0,0,38,0,38,-100
29/01/2018 17:06,2016,95,CARIBBEAN AREA,BARBADOS,1,STANSTED,BRIDGETOWN,584,0,584,188,0,188,210.6383
29/01/2018 17:06,2016,95,CARIBBEAN AREA,BARBADOS,2,BIRMINGHAM,BRIDGETOWN,35517,0,35517,34583,0,34583,2.70075
29/01/2018 17:06,2016,95,CARIBBEAN AREA,BARBADOS,2,BOURNEMOUTH,BRIDGETOWN,2226,0,2226,509,0,509,337.32809
29/01/2018 17:06,2016,95,CARIBBEAN AREA,BARBADOS,2,CARDIFF WALES,BRIDGETOWN,2303,0,2303,1643,0,1643,40.17042
29/01/2018 17:06,2016,95,CARIBBEAN AREA,BARBADOS,2,EAST MIDLANDS INTERNATIONAL,BRIDGETOWN,593,0,593,824,0,824,-28.03398
29/01/2018 17:06,2016,95,CARIBBEAN AREA,BARBADOS,2,GLASGOW,BRIDGETOWN,5127,589,4538,7282,3637,3645,-29.59352
29/01/2018 17:06,2016,95,CARIBBEAN AREA,BARBADOS,2,MANCHESTER,BRIDGETOWN,143975,73275,70700,140426,72165,68261,2.52731
29/01/2018 17:06,2016,95,CARIBBEAN AREA,BARBADOS,2,NEWCASTLE,BRIDGETOWN,2816,242,2574,1654,0,1654,70.25393
29/01/2018 17:06,2016,95,CARIBBEAN AREA,BERMUDA,1,GATWICK,BERMUDA,91856,91856,0,92674,92674,0,-0.88266
29/01/2018 17:06,2016,95,CARIBBEAN AREA,BERMUDA,2,MANCHESTER,BERMUDA,135,135,0,0,0,0,0
29/01/2018 17:06,2016,95,CARIBBEAN AREA,CAYMAN ISLANDS,1,HEATHROW,GRAND CAYMAN,33570,33570,0,31576,31576,0,6.31492
29/01/2018 17:06,2016,95,CARIBBEAN AREA,GRENADA,1,GATWICK,GRENADA,64571,64571,0,98985,98985,0,-34.76688
29/01/2018 17:06,2016,95,CARIBBEAN AREA,ISLE OF CURACAO NETH.ANTILLES,1,GATWICK,ARUBA,17137,0,17137,16282,0,16282,5.2512
29/01/2018 17:06,2016,95,CARIBBEAN AREA,ISLE OF CURACAO NETH.ANTILLES,2,MANCHESTER,ARUBA,14904,0,14904,0,0,0,0
29/01/2018 17:06,2016,95,CARIBBEAN AREA,JAMAICA,1,GATWICK,KINGSTON,84898,84898,0,86131,86131,0,-1.43154
29/01/2018 17:06,2016,95,CARIBBEAN AREA,JAMAICA,1,GATWICK,MONTEGO BAY,216862,116924,99938,206334,115514,90820,5.10241
29/01/2018 17:06,2016,95,CARIBBEAN AREA,JAMAICA,1,STANSTED,MONTEGO BAY,571,0,571,0,0,0,0
29/01/2018 17:06,2016,95,CARIBBEAN AREA,JAMAICA,2,BIRMINGHAM,MONTEGO BAY,38298,0,38298,39266,0,39266,-2.46524
29/01/2018 17:06,2016,95,CARIBBEAN AREA,JAMAICA,2,CARDIFF WALES,MONTEGO BAY,1768,0,1768,1026,0,1026,72.31969
29/01/2018 17:06,2016,95,CARIBBEAN AREA,JAMAICA,2,DONCASTER SHEFFIELD,MONTEGO BAY,0,0,0,435,0,435,-100
29/01/2018 17:06,2016,95,CARIBBEAN AREA,JAMAICA,2,EAST MIDLANDS INTERNATIONAL,MONTEGO BAY,0,0,0,922,0,922,-100
29/01/2018 17:06,2016,95,CARIBBEAN AREA,JAMAICA,2,GLASGOW,MONTEGO BAY,821,0,821,1323,0,1323,-37.94407
29/01/2018 17:06,2016,95,CARIBBEAN AREA,JAMAICA,2,MANCHESTER,MONTEGO BAY,68651,0,68651,81296,20840,60456,-15.55427
29/01/2018 17:06,2016,95,CARIBBEAN AREA,JAMAICA,2,NEWCASTLE,MONTEGO BAY,2275,0,2275,2295,0,2295,-0.87146
29/01/2018 17:06,2016,95,CARIBBEAN AREA,PUERTO RICO,1,GATWICK,SAN JUAN (PUERTO RICO),24748,24748,0,8181,8181,0,202.50581
29/01/2018 17:06,2016,95,CARIBBEAN AREA,SAINT KITTS AND NEVIS,1,GATWICK,ST KITTS,29936,29936,0,52310,52310,0,-42.77194
29/01/2018 17:06,2016,95,CARIBBEAN AREA,SAINT KITTS AND NEVIS,1,STANSTED,ST KITTS,0,0,0,353,0,353,-100
29/01/2018 17:06,2016,95,CARIBBEAN AREA,ST LUCIA,1,GATWICK,ST LUCIA (HEWANORRA),120632,118191,2441,18302,18302,0,559.11922
29/01/2018 17:06,2016,95,CARIBBEAN AREA,ST LUCIA,2,MANCHESTER,ST LUCIA (HEWANORRA),5517,5517,0,3219,3219,0,71.38863
29/01/2018 17:06,2016,95,CARIBBEAN AREA,TRINIDAD AND TOBAGO,1,GATWICK,PORT OF SPAIN,86121,86121,0,178170,178170,0,-51.66358
29/01/2018 17:06,2016,95,CARIBBEAN AREA,TRINIDAD AND TOBAGO,1,GATWICK,TOBAGO,55973,55973,0,81558,70539,11019,-31.37031
29/01/2018 17:06,2016,95,CARIBBEAN AREA,TRINIDAD AND TOBAGO,2,MANCHESTER,TOBAGO,2105,2105,0,0,0,0,0
29/01/2018 17:06,2016,95,CARIBBEAN AREA,TURKS AND CAICOS ISLANDS,1,GATWICK,PROVIDENCIALES,27283,27283,0,22645,22645,0,20.48134
29/01/2018 17:06,2016,95,CARIBBEAN AREA,TURKS AND CAICOS ISLANDS,1,HEATHROW,PROVIDENCIALES,0,0,0,1567,1567,0,-100
29/01/2018 17:06,2016,95,CARIBBEAN AREA,VIRGIN ISLANDS (U.S.A),2,LIVERPOOL (JOHN LENNON),ST THOMAS ISLANDS,0,0,0,56,0,56,-100
29/01/2018 17:06,2016,100,INDIAN OCEAN ISLANDS,MALDIVE ISLANDS,1,GATWICK,MALE INTERNATIONAL,29485,29485,0,10178,10178,0,189.69346
29/01/2018 17:06,2016,100,INDIAN OCEAN ISLANDS,MAURITIUS,1,GATWICK,MAURITIUS,111819,111819,0,109018,108782,236,2.5693
29/01/2018 17:06,2016,100,INDIAN OCEAN ISLANDS,MAURITIUS,1,HEATHROW,MAURITIUS,87081,87081,0,81497,81497,0,6.85179
29/01/2018 17:06,2016,100,INDIAN OCEAN ISLANDS,MAURITIUS,1,STANSTED,MAURITIUS,0,0,0,214,0,214,-100
29/01/2018 17:06,2016,100,INDIAN OCEAN ISLANDS,MAURITIUS,2,MANCHESTER,MAURITIUS,1958,1958,0,0,0,0,0
29/01/2018 17:06,2016,105,ATLANTIC OCEAN ISLANDS,CAPE VERDE ISLANDS,1,GATWICK,BOA VISTA (RABIL),62052,55734,6318,47141,47141,0,31.63064
29/01/2018 17:06,2016,105,ATLANTIC OCEAN ISLANDS,CAPE VERDE ISLANDS,1,GATWICK,ILHA DO SAL C.VERDE,69502,66396,3106,78621,66974,11647,-11.59868
29/01/2018 17:06,2016,105,ATLANTIC OCEAN ISLANDS,CAPE VERDE ISLANDS,1,GATWICK,SAN PEDRO (CAPE VERDE),0,0,0,191,0,191,-100
29/01/2018 17:06,2016,105,ATLANTIC OCEAN ISLANDS,CAPE VERDE ISLANDS,1,STANSTED,BOA VISTA (RABIL),201,201,0,0,0,0,0
29/01/2018 17:06,2016,105,ATLANTIC OCEAN ISLANDS,CAPE VERDE ISLANDS,2,BIRMINGHAM,BOA VISTA (RABIL),21411,21411,0,21002,21002,0,1.94743
29/01/2018 17:06,2016,105,ATLANTIC OCEAN ISLANDS,CAPE VERDE ISLANDS,2,BIRMINGHAM,ILHA DO SAL C.VERDE,24495,24495,0,20889,20889,0,17.26267
29/01/2018 17:06,2016,105,ATLANTIC OCEAN ISLANDS,CAPE VERDE ISLANDS,2,BRISTOL,ILHA DO SAL C.VERDE,21971,21971,0,2976,2976,0,638.27285
29/01/2018 17:06,2016,105,ATLANTIC OCEAN ISLANDS,CAPE VERDE ISLANDS,2,EDINBURGH,ILHA DO SAL C.VERDE,199,199,0,0,0,0,0
29/01/2018 17:06,2016,105,ATLANTIC OCEAN ISLANDS,CAPE VERDE ISLANDS,2,GLASGOW,ILHA DO SAL C.VERDE,3064,0,3064,0,0,0,0
29/01/2018 17:06,2016,105,ATLANTIC OCEAN ISLANDS,CAPE VERDE ISLANDS,2,MANCHESTER,BOA VISTA (RABIL),46573,46573,0,43559,43559,0,6.91935
29/01/2018 17:06,2016,105,ATLANTIC OCEAN ISLANDS,CAPE VERDE ISLANDS,2,MANCHESTER,ILHA DO SAL C.VERDE,57393,49532,7861,35525,35525,0,61.55665
29/01/2018 17:06,2016,105,ATLANTIC OCEAN ISLANDS,FALKLAND ISLANDS,1,GATWICK,MOUNT PLEASANT,902,0,902,426,0,426,111.73709
29/01/2018 17:06,2016,115,OIL RIGS,OIL RIGS,2,ABERDEEN,OIL RIGS,400601,0,400601,510962,0,510962,-21.59867
29/01/2018 17:06,2016,115,OIL RIGS,OIL RIGS,2,BLACKPOOL,OIL RIGS,20489,12648,7841,23155,0,23155,-11.51371
29/01/2018 17:06,2016,115,OIL RIGS,OIL RIGS,2,HUMBERSIDE,OIL RIGS,30227,19900,10327,46631,0,46631,-35.17831
29/01/2018 17:06,2016,115,OIL RIGS,OIL RIGS,2,INVERNESS,OIL RIGS,0,0,0,325,0,325,-100
29/01/2018 17:06,2016,115,OIL RIGS,OIL RIGS,2,KIRKWALL,OIL RIGS,15,0,15,1,0,1,1400
29/01/2018 17:06,2016,115,OIL RIGS,OIL RIGS,2,LERWICK (TINGWALL),OIL RIGS,0,0,0,3,0,3,-100
29/01/2018 17:06,2016,115,OIL RIGS,OIL RIGS,2,NORWICH,OIL RIGS,110902,0,110902,102945,0,102945,7.72937
29/01/2018 17:06,2016,115,OIL RIGS,OIL RIGS,2,SCATSTA,OIL RIGS,73276,0,73276,114434,0,114434,-35.96658
29/01/2018 17:06,2016,115,OIL RIGS,OIL RIGS,2,SUMBURGH,OIL RIGS,65436,0,65436,25887,0,25887,152.77552
29/01/2018 17:06,2016,115,OIL RIGS,OIL RIGS,2,WICK JOHN O GROATS,OIL RIGS,0,0,0,895,0,895,-100

