rundate,report_period,region_num,foreign_region,foreign_country,uk_group,uk_apt,foreign_apt,ty_t_pax,ty_s_pax,ty_c_pax,ly_t_pax,ly_s_pax,ly_c_pax,pc_change
25/03/2022 10:55,2021,,Unknown,Unknown,2,BELFAST CITY (GEORGE BEST),Unknown,0,0,0,30,30,0,-100
25/03/2022 10:55,2021,1,WESTERN EUROPE-EU,AUSTRIA,1,GATWICK,INNSBRUCK,9300,8230,1070,89209,73499,15710,-89.57504
25/03/2022 10:55,2021,1,WESTERN EUROPE-EU,AUSTRIA,1,GATWICK,KLAGENFURT,0,0,0,5021,5021,0,-100
25/03/2022 10:55,2021,1,WESTERN EUROPE-EU,AUSTRIA,1,GATWICK,LINZ,0,0,0,180,180,0,-100
25/03/2022 10:55,2021,1,WESTERN EUROPE-EU,AUSTRIA,1,GATWICK,SALZBURG,1858,1544,314,55958,48726,7232,-96.67965
25/03/2022 10:55,2021,1,WESTERN EUROPE-EU,AUSTRIA,1,GATWICK,VIENNA,106,106,0,30551,30551,0,-99.65304
25/03/2022 10:55,2021,1,WESTERN EUROPE-EU,AUSTRIA,1,HEATHROW,INNSBRUCK,2541,2541,0,15301,15301,0,-83.39324
25/03/2022 10:55,2021,1,WESTERN EUROPE-EU,AUSTRIA,1,HEATHROW,SALZBURG,2419,2419,0,11333,11333,0,-78.65525
25/03/2022 10:55,2021,1,WESTERN EUROPE-EU,AUSTRIA,1,HEATHROW,VIENNA,135223,135223,0,159500,159500,0,-15.22069
25/03/2022 10:55,2021,1,WESTERN EUROPE-EU,AUSTRIA,1,LUTON,GRAZ,0,0,0,129,0,129,-100
25/03/2022 10:55,2021,1,WESTERN EUROPE-EU,AUSTRIA,1,LUTON,INNSBRUCK,679,307,372,8771,8771,0,-92.25858
25/03/2022 10:55,2021,1,WESTERN EUROPE-EU,AUSTRIA,1,LUTON,SALZBURG,492,492,0,6809,5104,1705,-92.77427
25/03/2022 10:55,2021,1,WESTERN EUROPE-EU,AUSTRIA,1,LUTON,VIENNA,19345,19345,0,19852,19852,0,-2.5539
25/03/2022 10:55,2021,1,WESTERN EUROPE-EU,AUSTRIA,1,STANSTED,INNSBRUCK,563,295,268,7031,987,6044,-91.9926
25/03/2022 10:55,2021,1,WESTERN EUROPE-EU,AUSTRIA,1,STANSTED,SALZBURG,4867,4797,70,30345,27669,2676,-83.96111
25/03/2022 10:55,2021,1,WESTERN EUROPE-EU,AUSTRIA,1,STANSTED,VIENNA,69573,68593,980,59919,59834,85,16.11175
25/03/2022 10:55,2021,1,WESTERN EUROPE-EU,AUSTRIA,2,BELFAST CITY (GEORGE BEST),SALZBURG,1,0,1,0,0,0,0
25/03/2022 10:55,2021,1,WESTERN EUROPE-EU,AUSTRIA,2,BELFAST INTERNATIONAL,KLAGENFURT,0,0,0,48,0,48,-100
25/03/2022 10:55,2021,1,WESTERN EUROPE-EU,AUSTRIA,2,BELFAST INTERNATIONAL,SALZBURG,41,41,0,6944,4008,2936,-99.40956
25/03/2022 10:55,2021,1,WESTERN EUROPE-EU,AUSTRIA,2,BELFAST INTERNATIONAL,VIENNA,130,37,93,98,0,98,32.65306
25/03/2022 10:55,2021,1,WESTERN EUROPE-EU,AUSTRIA,2,BIGGIN HILL,SALZBURG,12,0,12,0,0,0,0
25/03/2022 10:55,2021,1,WESTERN EUROPE-EU,AUSTRIA,2,BIGGIN HILL,VIENNA,1,0,1,0,0,0,0
25/03/2022 10:55,2021,1,WESTERN EUROPE-EU,AUSTRIA,2,BIRMINGHAM,GRAZ,101,0,101,0,0,0,0
25/03/2022 10:55,2021,1,WESTERN EUROPE-EU,AUSTRIA,2,BIRMINGHAM,INNSBRUCK,774,346,428,11018,3133,7885,-92.97513
25/03/2022 10:55,2021,1,WESTERN EUROPE-EU,AUSTRIA,2,BIRMINGHAM,SALZBURG,442,231,211,7420,3844,3576,-94.04313
25/03/2022 10:55,2021,1,WESTERN EUROPE-EU,AUSTRIA,2,BIRMINGHAM,VIENNA,0,0,0,15574,15574,0,-100
25/03/2022 10:55,2021,1,WESTERN EUROPE-EU,AUSTRIA,2,BRISTOL,INNSBRUCK,1178,947,231,14440,8538,5902,-91.84211
25/03/2022 10:55,2021,1,WESTERN EUROPE-EU,AUSTRIA,2,BRISTOL,LINZ,0,0,0,148,0,148,-100
25/03/2022 10:55,2021,1,WESTERN EUROPE-EU,AUSTRIA,2,BRISTOL,SALZBURG,422,355,67,8798,5639,3159,-95.20346
25/03/2022 10:55,2021,1,WESTERN EUROPE-EU,AUSTRIA,2,BRISTOL,VIENNA,2212,2212,0,9004,9004,0,-75.43314
25/03/2022 10:55,2021,1,WESTERN EUROPE-EU,AUSTRIA,2,CARDIFF WALES,VIENNA,54,0,54,50,0,50,8
25/03/2022 10:55,2021,1,WESTERN EUROPE-EU,AUSTRIA,2,DONCASTER SHEFFIELD,SALZBURG,0,0,0,163,163,0,-100
25/03/2022 10:55,2021,1,WESTERN EUROPE-EU,AUSTRIA,2,EAST MIDLANDS INTERNATIONAL,SALZBURG,133,38,95,5286,3095,2191,-97.48392
25/03/2022 10:55,2021,1,WESTERN EUROPE-EU,AUSTRIA,2,EDINBURGH,INNSBRUCK,271,149,122,7013,0,7013,-96.13575
25/03/2022 10:55,2021,1,WESTERN EUROPE-EU,AUSTRIA,2,EDINBURGH,KLAGENFURT,82,82,0,0,0,0,0
25/03/2022 10:55,2021,1,WESTERN EUROPE-EU,AUSTRIA,2,EDINBURGH,SALZBURG,173,173,0,5690,3707,1983,-96.95958
25/03/2022 10:55,2021,1,WESTERN EUROPE-EU,AUSTRIA,2,EDINBURGH,VIENNA,7192,7145,47,17072,17072,0,-57.87254
25/03/2022 10:55,2021,1,WESTERN EUROPE-EU,AUSTRIA,2,GLASGOW,INNSBRUCK,0,0,0,286,0,286,-100
25/03/2022 10:55,2021,1,WESTERN EUROPE-EU,AUSTRIA,2,GLASGOW,VIENNA,148,0,148,0,0,0,0
25/03/2022 10:55,2021,1,WESTERN EUROPE-EU,AUSTRIA,2,LEEDS BRADFORD,SALZBURG,143,143,0,3187,3187,0,-95.51302
25/03/2022 10:55,2021,1,WESTERN EUROPE-EU,AUSTRIA,2,LEEDS BRADFORD,VIENNA,0,0,0,157,157,0,-100
25/03/2022 10:55,2021,1,WESTERN EUROPE-EU,AUSTRIA,2,LIVERPOOL (JOHN LENNON),SALZBURG,211,162,49,3039,2926,113,-93.05693
25/03/2022 10:55,2021,1,WESTERN EUROPE-EU,AUSTRIA,2,LIVERPOOL (JOHN LENNON),VIENNA,1503,1503,0,6080,6080,0,-75.27961
25/03/2022 10:55,2021,1,WESTERN EUROPE-EU,AUSTRIA,2,MANCHESTER,INNSBRUCK,1355,880,475,22646,7810,14836,-94.0166
25/03/2022 10:55,2021,1,WESTERN EUROPE-EU,AUSTRIA,2,MANCHESTER,LINZ,0,0,0,796,0,796,-100
25/03/2022 10:55,2021,1,WESTERN EUROPE-EU,AUSTRIA,2,MANCHESTER,SALZBURG,853,582,271,15796,9247,6549,-94.5999
25/03/2022 10:55,2021,1,WESTERN EUROPE-EU,AUSTRIA,2,MANCHESTER,VIENNA,12596,12596,0,15074,15074,0,-16.4389
25/03/2022 10:55,2021,1,WESTERN EUROPE-EU,AUSTRIA,2,NEWCASTLE,INNSBRUCK,130,130,0,3757,3757,0,-96.53979
25/03/2022 10:55,2021,1,WESTERN EUROPE-EU,AUSTRIA,2,NEWCASTLE,SALZBURG,0,0,0,3091,3091,0,-100
25/03/2022 10:55,2021,1,WESTERN EUROPE-EU,AUSTRIA,2,OXFORD (KIDLINGTON),GRAZ,50,50,0,58,58,0,-13.7931
25/03/2022 10:55,2021,1,WESTERN EUROPE-EU,AUSTRIA,2,TEESSIDE INTERNATIONAL AIRPORT,GRAZ,54,0,54,0,0,0,0
25/03/2022 10:55,2021,1,WESTERN EUROPE-EU,AUSTRIA,2,TEESSIDE INTERNATIONAL AIRPORT,VIENNA,56,0,56,0,0,0,0
25/03/2022 10:55,2021,1,WESTERN EUROPE-EU,BELGIUM,1,GATWICK,BRUSSELS,0,0,0,251,251,0,-100
25/03/2022 10:55,2021,1,WESTERN EUROPE-EU,BELGIUM,1,HEATHROW,BRUSSELS,118397,118397,0,153830,153830,0,-23.03387
25/03/2022 10:55,2021,1,WESTERN EUROPE-EU,BELGIUM,1,LONDON CITY,ANTWERP,0,0,0,9163,9163,0,-100
25/03/2022 10:55,2021,1,WESTERN EUROPE-EU,BELGIUM,1,LONDON CITY,BRUSSELS,0,0,0,26,26,0,-100
25/03/2022 10:55,2021,1,WESTERN EUROPE-EU,BELGIUM,1,LUTON,LIEGE,309,0,309,0,0,0,0
25/03/2022 10:55,2021,1,WESTERN EUROPE-EU,BELGIUM,1,STANSTED,BRUSSELS,161,161,0,0,0,0,0
25/03/2022 10:55,2021,1,WESTERN EUROPE-EU,BELGIUM,1,STANSTED,CHARLEROI,52,0,52,128,128,0,-59.375
25/03/2022 10:55,2021,1,WESTERN EUROPE-EU,BELGIUM,2,ABERDEEN,BRUSSELS,0,0,0,1379,1379,0,-100
25/03/2022 10:55,2021,1,WESTERN EUROPE-EU,BELGIUM,2,BELFAST INTERNATIONAL,BRUSSELS,0,0,0,52,0,52,-100
25/03/2022 10:55,2021,1,WESTERN EUROPE-EU,BELGIUM,2,BIGGIN HILL,ANTWERP,67,0,67,0,0,0,0
25/03/2022 10:55,2021,1,WESTERN EUROPE-EU,BELGIUM,2,BIRMINGHAM,BRUSSELS,4163,4075,88,27346,27230,116,-84.77657
25/03/2022 10:55,2021,1,WESTERN EUROPE-EU,BELGIUM,2,BIRMINGHAM,LIEGE,63,0,63,47,0,47,34.04255
25/03/2022 10:55,2021,1,WESTERN EUROPE-EU,BELGIUM,2,BRISTOL,BRUSSELS,0,0,0,11649,11649,0,-100
25/03/2022 10:55,2021,1,WESTERN EUROPE-EU,BELGIUM,2,CARDIFF WALES,BRUSSELS,426,0,426,0,0,0,0
25/03/2022 10:55,2021,1,WESTERN EUROPE-EU,BELGIUM,2,EAST MIDLANDS INTERNATIONAL,BRUSSELS,0,0,0,23,23,0,-100
25/03/2022 10:55,2021,1,WESTERN EUROPE-EU,BELGIUM,2,EDINBURGH,BRUSSELS,5433,5355,78,22642,22607,35,-76.00477
25/03/2022 10:55,2021,1,WESTERN EUROPE-EU,BELGIUM,2,EDINBURGH,CHARLEROI,14913,14913,0,21941,21941,0,-32.03136
25/03/2022 10:55,2021,1,WESTERN EUROPE-EU,BELGIUM,2,GLASGOW,ANTWERP,47,0,47,0,0,0,0
25/03/2022 10:55,2021,1,WESTERN EUROPE-EU,BELGIUM,2,GLASGOW,BRUSSELS,142,0,142,0,0,0,0
25/03/2022 10:55,2021,1,WESTERN EUROPE-EU,BELGIUM,2,GLASGOW,CHARLEROI,0,0,0,1384,1384,0,-100
25/03/2022 10:55,2021,1,WESTERN EUROPE-EU,BELGIUM,2,GLASGOW,LIEGE,0,0,0,212,0,212,-100
25/03/2022 10:55,2021,1,WESTERN EUROPE-EU,BELGIUM,2,HUMBERSIDE,OSTEND,93,0,93,0,0,0,0
25/03/2022 10:55,2021,1,WESTERN EUROPE-EU,BELGIUM,2,LIVERPOOL (JOHN LENNON),BRUSSELS,0,0,0,70,0,70,-100
25/03/2022 10:55,2021,1,WESTERN EUROPE-EU,BELGIUM,2,LIVERPOOL (JOHN LENNON),LIEGE,0,0,0,104,0,104,-100
25/03/2022 10:55,2021,1,WESTERN EUROPE-EU,BELGIUM,2,LIVERPOOL (JOHN LENNON),OSTEND,40,0,40,30,0,30,33.33333
25/03/2022 10:55,2021,1,WESTERN EUROPE-EU,BELGIUM,2,MANCHESTER,BRUSSELS,40255,40255,0,49531,49118,413,-18.72767
25/03/2022 10:55,2021,1,WESTERN EUROPE-EU,BELGIUM,2,MANCHESTER,CHARLEROI,25482,25482,0,39186,39186,0,-34.97167
25/03/2022 10:55,2021,1,WESTERN EUROPE-EU,BELGIUM,2,MANCHESTER,OSTEND,1257,0,1257,922,0,922,36.33406
25/03/2022 10:55,2021,1,WESTERN EUROPE-EU,BELGIUM,2,NEWCASTLE,BRUSSELS,0,0,0,2921,2921,0,-100
25/03/2022 10:55,2021,1,WESTERN EUROPE-EU,BELGIUM,2,OXFORD (KIDLINGTON),LIEGE,49,49,0,70,70,0,-30
25/03/2022 10:55,2021,1,WESTERN EUROPE-EU,CROATIA,1,GATWICK,DUBROVNIK,26476,26476,0,17928,17292,636,47.67961
25/03/2022 10:55,2021,1,WESTERN EUROPE-EU,CROATIA,1,GATWICK,PULA,10297,5344,4953,5229,5229,0,96.92102
25/03/2022 10:55,2021,1,WESTERN EUROPE-EU,CROATIA,1,GATWICK,SPLIT,38424,35227,3197,21608,21459,149,77.82303
25/03/2022 10:55,2021,1,WESTERN EUROPE-EU,CROATIA,1,GATWICK,ZADAR,4831,2304,2527,2259,2259,0,113.85569
25/03/2022 10:55,2021,1,WESTERN EUROPE-EU,CROATIA,1,HEATHROW,DUBROVNIK,48453,48453,0,12395,12395,0,290.90762
25/03/2022 10:55,2021,1,WESTERN EUROPE-EU,CROATIA,1,HEATHROW,PULA,3781,3781,0,2023,2023,0,86.90064
25/03/2022 10:55,2021,1,WESTERN EUROPE-EU,CROATIA,1,HEATHROW,SPLIT,35733,35733,0,17742,17742,0,101.40345
25/03/2022 10:55,2021,1,WESTERN EUROPE-EU,CROATIA,1,HEATHROW,ZAGREB,40000,39968,32,43011,42916,95,-7.00053
25/03/2022 10:55,2021,1,WESTERN EUROPE-EU,CROATIA,1,LONDON CITY,SPLIT,3234,3234,0,0,0,0,0
25/03/2022 10:55,2021,1,WESTERN EUROPE-EU,CROATIA,1,LUTON,DUBROVNIK,0,0,0,1804,1804,0,-100
25/03/2022 10:55,2021,1,WESTERN EUROPE-EU,CROATIA,1,LUTON,PULA,1100,966,134,2903,2903,0,-62.10816
25/03/2022 10:55,2021,1,WESTERN EUROPE-EU,CROATIA,1,LUTON,SPLIT,30123,30123,0,36711,36711,0,-17.94557
25/03/2022 10:55,2021,1,WESTERN EUROPE-EU,CROATIA,1,LUTON,ZADAR,0,0,0,3007,3007,0,-100
25/03/2022 10:55,2021,1,WESTERN EUROPE-EU,CROATIA,1,SOUTHEND,PULA,0,0,0,1782,1782,0,-100
25/03/2022 10:55,2021,1,WESTERN EUROPE-EU,CROATIA,1,STANSTED,DUBROVNIK,12782,12782,0,3599,3599,0,255.15421
25/03/2022 10:55,2021,1,WESTERN EUROPE-EU,CROATIA,1,STANSTED,PULA,14368,14337,31,5550,5550,0,158.88288
25/03/2022 10:55,2021,1,WESTERN EUROPE-EU,CROATIA,1,STANSTED,RIJEKA,0,0,0,3222,3222,0,-100
25/03/2022 10:55,2021,1,WESTERN EUROPE-EU,CROATIA,1,STANSTED,SPLIT,7280,7280,0,6079,6079,0,19.75654
25/03/2022 10:55,2021,1,WESTERN EUROPE-EU,CROATIA,1,STANSTED,ZADAR,18060,18060,0,0,0,0,0
25/03/2022 10:55,2021,1,WESTERN EUROPE-EU,CROATIA,1,STANSTED,ZAGREB,30330,29964,366,0,0,0,0
25/03/2022 10:55,2021,1,WESTERN EUROPE-EU,CROATIA,2,ABERDEEN,ZAGREB,0,0,0,12,0,12,-100
25/03/2022 10:55,2021,1,WESTERN EUROPE-EU,CROATIA,2,BELFAST INTERNATIONAL,DUBROVNIK,0,0,0,1925,1925,0,-100
25/03/2022 10:55,2021,1,WESTERN EUROPE-EU,CROATIA,2,BELFAST INTERNATIONAL,SPLIT,4586,4586,0,2079,2079,0,120.58682
25/03/2022 10:55,2021,1,WESTERN EUROPE-EU,CROATIA,2,BIGGIN HILL,OSIJEK,3,0,3,0,0,0,0
25/03/2022 10:55,2021,1,WESTERN EUROPE-EU,CROATIA,2,BIGGIN HILL,SPLIT,0,0,0,5,0,5,-100
25/03/2022 10:55,2021,1,WESTERN EUROPE-EU,CROATIA,2,BIGGIN HILL,ZADAR,2,0,2,10,0,10,-80
25/03/2022 10:55,2021,1,WESTERN EUROPE-EU,CROATIA,2,BIRMINGHAM,DUBROVNIK,4003,4003,0,2438,2004,434,64.19196
25/03/2022 10:55,2021,1,WESTERN EUROPE-EU,CROATIA,2,BIRMINGHAM,PULA,0,0,0,1032,1032,0,-100
25/03/2022 10:55,2021,1,WESTERN EUROPE-EU,CROATIA,2,BIRMINGHAM,SPLIT,6369,6369,0,3105,3105,0,105.12077
25/03/2022 10:55,2021,1,WESTERN EUROPE-EU,CROATIA,2,BRISTOL,DUBROVNIK,6497,6497,0,3544,3544,0,83.32393
25/03/2022 10:55,2021,1,WESTERN EUROPE-EU,CROATIA,2,BRISTOL,PULA,4271,4271,0,1858,1858,0,129.87083
25/03/2022 10:55,2021,1,WESTERN EUROPE-EU,CROATIA,2,BRISTOL,SPLIT,14928,14928,0,7278,7278,0,105.11129
25/03/2022 10:55,2021,1,WESTERN EUROPE-EU,CROATIA,2,EAST MIDLANDS INTERNATIONAL,SPLIT,0,0,0,1289,1289,0,-100
25/03/2022 10:55,2021,1,WESTERN EUROPE-EU,CROATIA,2,EDINBURGH,DUBROVNIK,8307,8307,0,2546,2546,0,226.27651
25/03/2022 10:55,2021,1,WESTERN EUROPE-EU,CROATIA,2,EDINBURGH,PULA,0,0,0,39,0,39,-100
25/03/2022 10:55,2021,1,WESTERN EUROPE-EU,CROATIA,2,EDINBURGH,RIJEKA,214,0,214,0,0,0,0
25/03/2022 10:55,2021,1,WESTERN EUROPE-EU,CROATIA,2,EDINBURGH,ZADAR,3051,3051,0,0,0,0,0
25/03/2022 10:55,2021,1,WESTERN EUROPE-EU,CROATIA,2,EDINBURGH,ZAGREB,0,0,0,39,0,39,-100
25/03/2022 10:55,2021,1,WESTERN EUROPE-EU,CROATIA,2,GLASGOW,PULA,56,0,56,0,0,0,0
25/03/2022 10:55,2021,1,WESTERN EUROPE-EU,CROATIA,2,GLASGOW,SPLIT,4236,4236,0,2155,2155,0,96.56613
25/03/2022 10:55,2021,1,WESTERN EUROPE-EU,CROATIA,2,LEEDS BRADFORD,DUBROVNIK,6528,6528,0,0,0,0,0
25/03/2022 10:55,2021,1,WESTERN EUROPE-EU,CROATIA,2,LEEDS BRADFORD,PULA,0,0,0,1023,1023,0,-100
25/03/2022 10:55,2021,1,WESTERN EUROPE-EU,CROATIA,2,LEEDS BRADFORD,SPLIT,2760,2760,0,1274,1274,0,116.6405
25/03/2022 10:55,2021,1,WESTERN EUROPE-EU,CROATIA,2,LIVERPOOL (JOHN LENNON),PULA,0,0,0,1688,1688,0,-100
25/03/2022 10:55,2021,1,WESTERN EUROPE-EU,CROATIA,2,MANCHESTER,DUBROVNIK,21294,21294,0,10109,9188,921,110.64398
25/03/2022 10:55,2021,1,WESTERN EUROPE-EU,CROATIA,2,MANCHESTER,PULA,4580,0,4580,2966,2966,0,54.41672
25/03/2022 10:55,2021,1,WESTERN EUROPE-EU,CROATIA,2,MANCHESTER,SPLIT,28412,22717,5695,8125,8125,0,249.68615
25/03/2022 10:55,2021,1,WESTERN EUROPE-EU,CROATIA,2,MANCHESTER,ZADAR,7103,7103,0,0,0,0,0
25/03/2022 10:55,2021,1,WESTERN EUROPE-EU,CROATIA,2,MANCHESTER,ZAGREB,1454,1454,0,0,0,0,0
25/03/2022 10:55,2021,1,WESTERN EUROPE-EU,CROATIA,2,NEWCASTLE,DUBROVNIK,3280,3280,0,1570,1570,0,108.9172
25/03/2022 10:55,2021,1,WESTERN EUROPE-EU,CYPRUS,1,GATWICK,LARNACA,50461,39016,11445,40921,37484,3437,23.31321
25/03/2022 10:55,2021,1,WESTERN EUROPE-EU,CYPRUS,1,GATWICK,PAPHOS,77575,55143,22432,65254,51910,13344,18.8816
25/03/2022 10:55,2021,1,WESTERN EUROPE-EU,CYPRUS,1,HEATHROW,LARNACA,181107,181002,105,110679,110302,377,63.63267
25/03/2022 10:55,2021,1,WESTERN EUROPE-EU,CYPRUS,1,HEATHROW,PAPHOS,32767,32767,0,19000,19000,0,72.45789
25/03/2022 10:55,2021,1,WESTERN EUROPE-EU,CYPRUS,1,LUTON,LARNACA,41985,41985,0,49367,49367,0,-14.95331
25/03/2022 10:55,2021,1,WESTERN EUROPE-EU,CYPRUS,1,LUTON,PAPHOS,20544,20544,0,27776,27255,521,-26.03687
25/03/2022 10:55,2021,1,WESTERN EUROPE-EU,CYPRUS,1,STANSTED,LARNACA,23531,19397,4134,9484,9384,100,148.11261
25/03/2022 10:55,2021,1,WESTERN EUROPE-EU,CYPRUS,1,STANSTED,PAPHOS,87947,78958,8989,64492,63976,516,36.36885
25/03/2022 10:55,2021,1,WESTERN EUROPE-EU,CYPRUS,2,ABERDEEN,LARNACA,123,0,123,120,0,120,2.5
25/03/2022 10:55,2021,1,WESTERN EUROPE-EU,CYPRUS,2,BIGGIN HILL,LARNACA,20,0,20,20,0,20,0
25/03/2022 10:55,2021,1,WESTERN EUROPE-EU,CYPRUS,2,BIGGIN HILL,PAPHOS,10,0,10,4,0,4,150
25/03/2022 10:55,2021,1,WESTERN EUROPE-EU,CYPRUS,2,BIRMINGHAM,LARNACA,31699,18244,13455,7663,4991,2672,313.66306
25/03/2022 10:55,2021,1,WESTERN EUROPE-EU,CYPRUS,2,BIRMINGHAM,PAPHOS,30934,14518,16416,17001,14420,2581,81.954
25/03/2022 10:55,2021,1,WESTERN EUROPE-EU,CYPRUS,2,BOURNEMOUTH,PAPHOS,9053,6678,2375,3745,2747,998,141.73565
25/03/2022 10:55,2021,1,WESTERN EUROPE-EU,CYPRUS,2,BRISTOL,LARNACA,18373,12173,6200,13217,12391,826,39.01037
25/03/2022 10:55,2021,1,WESTERN EUROPE-EU,CYPRUS,2,BRISTOL,PAPHOS,24094,14896,9198,19090,16305,2785,26.21268
25/03/2022 10:55,2021,1,WESTERN EUROPE-EU,CYPRUS,2,CARDIFF WALES,LARNACA,2785,0,2785,60,0,60,4541.66667
25/03/2022 10:55,2021,1,WESTERN EUROPE-EU,CYPRUS,2,CARDIFF WALES,PAPHOS,0,0,0,1030,0,1030,-100
25/03/2022 10:55,2021,1,WESTERN EUROPE-EU,CYPRUS,2,DONCASTER SHEFFIELD,LARNACA,4799,4799,0,908,908,0,428.52423
25/03/2022 10:55,2021,1,WESTERN EUROPE-EU,CYPRUS,2,DONCASTER SHEFFIELD,PAPHOS,6075,0,6075,1155,0,1155,425.97403
25/03/2022 10:55,2021,1,WESTERN EUROPE-EU,CYPRUS,2,EAST MIDLANDS INTERNATIONAL,LARNACA,11611,7793,3818,3062,2715,347,279.1966
25/03/2022 10:55,2021,1,WESTERN EUROPE-EU,CYPRUS,2,EAST MIDLANDS INTERNATIONAL,PAPHOS,13590,6161,7429,7758,5109,2649,75.17401
25/03/2022 10:55,2021,1,WESTERN EUROPE-EU,CYPRUS,2,EDINBURGH,LARNACA,2666,2588,78,2662,2662,0,0.15026
25/03/2022 10:55,2021,1,WESTERN EUROPE-EU,CYPRUS,2,EDINBURGH,PAPHOS,14605,14605,0,16932,16742,190,-13.74321
25/03/2022 10:55,2021,1,WESTERN EUROPE-EU,CYPRUS,2,EXETER,PAPHOS,3265,0,3265,0,0,0,0
25/03/2022 10:55,2021,1,WESTERN EUROPE-EU,CYPRUS,2,GLASGOW,LARNACA,5184,3000,2184,1222,1222,0,324.22259
25/03/2022 10:55,2021,1,WESTERN EUROPE-EU,CYPRUS,2,GLASGOW,PAPHOS,8108,5808,2300,8805,7425,1380,-7.91596
25/03/2022 10:55,2021,1,WESTERN EUROPE-EU,CYPRUS,2,GUERNSEY,PAPHOS,9,0,9,0,0,0,0
25/03/2022 10:55,2021,1,WESTERN EUROPE-EU,CYPRUS,2,LEEDS BRADFORD,LARNACA,14292,14292,0,4126,4126,0,246.38875
25/03/2022 10:55,2021,1,WESTERN EUROPE-EU,CYPRUS,2,LEEDS BRADFORD,PAPHOS,4590,4590,0,7564,7564,0,-39.31782
25/03/2022 10:55,2021,1,WESTERN EUROPE-EU,CYPRUS,2,LIVERPOOL (JOHN LENNON),LARNACA,6111,6111,0,10431,10431,0,-41.41501
25/03/2022 10:55,2021,1,WESTERN EUROPE-EU,CYPRUS,2,LIVERPOOL (JOHN LENNON),PAPHOS,7510,7510,0,12273,12273,0,-38.80877
25/03/2022 10:55,2021,1,WESTERN EUROPE-EU,CYPRUS,2,MANCHESTER,LARNACA,41256,22189,19067,15651,11417,4234,163.59977
25/03/2022 10:55,2021,1,WESTERN EUROPE-EU,CYPRUS,2,MANCHESTER,PAPHOS,88277,59111,29166,69126,53597,15529,27.70448
25/03/2022 10:55,2021,1,WESTERN EUROPE-EU,CYPRUS,2,NEWCASTLE,LARNACA,14027,14027,0,4283,4283,0,227.50409
25/03/2022 10:55,2021,1,WESTERN EUROPE-EU,CYPRUS,2,NEWCASTLE,PAPHOS,14881,14881,0,9522,9522,0,56.28019
25/03/2022 10:55,2021,1,WESTERN EUROPE-EU,DENMARK,1,GATWICK,AARHUS (TIRSTRUP),0,0,0,3913,3913,0,-100
25/03/2022 10:55,2021,1,WESTERN EUROPE-EU,DENMARK,1,GATWICK,COPENHAGEN,51967,51967,0,150414,150414,0,-65.45069
25/03/2022 10:55,2021,1,WESTERN EUROPE-EU,DENMARK,1,GATWICK,ROSKILDE,119,0,119,0,0,0,0
25/03/2022 10:55,2021,1,WESTERN EUROPE-EU,DENMARK,1,HEATHROW,BILLUND,0,0,0,21729,21729,0,-100
25/03/2022 10:55,2021,1,WESTERN EUROPE-EU,DENMARK,1,HEATHROW,COPENHAGEN,215517,215517,0,224022,224022,0,-3.7965
25/03/2022 10:55,2021,1,WESTERN EUROPE-EU,DENMARK,1,LONDON CITY,BILLUND,0,0,0,3758,3758,0,-100
25/03/2022 10:55,2021,1,WESTERN EUROPE-EU,DENMARK,1,LUTON,COPENHAGEN,354,0,354,29315,29315,0,-98.79243
25/03/2022 10:55,2021,1,WESTERN EUROPE-EU,DENMARK,1,STANSTED,AALBORG,8026,8026,0,8866,8866,0,-9.4744
25/03/2022 10:55,2021,1,WESTERN EUROPE-EU,DENMARK,1,STANSTED,AARHUS (TIRSTRUP),16316,16316,0,23180,23180,0,-29.61173
25/03/2022 10:55,2021,1,WESTERN EUROPE-EU,DENMARK,1,STANSTED,BILLUND,47023,47023,0,45104,45104,0,4.25461
25/03/2022 10:55,2021,1,WESTERN EUROPE-EU,DENMARK,1,STANSTED,COPENHAGEN,79524,79484,40,106755,106245,510,-25.50794
25/03/2022 10:55,2021,1,WESTERN EUROPE-EU,DENMARK,2,ABERDEEN,BILLUND,704,41,663,0,0,0,0
25/03/2022 10:55,2021,1,WESTERN EUROPE-EU,DENMARK,2,ABERDEEN,COPENHAGEN,1121,1121,0,4073,4073,0,-72.47729
25/03/2022 10:55,2021,1,WESTERN EUROPE-EU,DENMARK,2,ABERDEEN,ESBJERG,2103,2024,79,4127,4127,0,-49.04289
25/03/2022 10:55,2021,1,WESTERN EUROPE-EU,DENMARK,2,BELFAST INTERNATIONAL,AALBORG,0,0,0,66,0,66,-100
25/03/2022 10:55,2021,1,WESTERN EUROPE-EU,DENMARK,2,BELFAST INTERNATIONAL,AARHUS (TIRSTRUP),69,0,69,0,0,0,0
25/03/2022 10:55,2021,1,WESTERN EUROPE-EU,DENMARK,2,BELFAST INTERNATIONAL,BILLUND,1,0,1,0,0,0,0
25/03/2022 10:55,2021,1,WESTERN EUROPE-EU,DENMARK,2,BELFAST INTERNATIONAL,COPENHAGEN,33,0,33,0,0,0,0
25/03/2022 10:55,2021,1,WESTERN EUROPE-EU,DENMARK,2,BIGGIN HILL,AARHUS (TIRSTRUP),10,0,10,0,0,0,0
25/03/2022 10:55,2021,1,WESTERN EUROPE-EU,DENMARK,2,BIGGIN HILL,COPENHAGEN,9,0,9,0,0,0,0
25/03/2022 10:55,2021,1,WESTERN EUROPE-EU,DENMARK,2,BIRMINGHAM,COPENHAGEN,131,28,103,14287,14287,0,-99.08308
25/03/2022 10:55,2021,1,WESTERN EUROPE-EU,DENMARK,2,BRISTOL,COPENHAGEN,0,0,0,11517,11517,0,-100
25/03/2022 10:55,2021,1,WESTERN EUROPE-EU,DENMARK,2,CARDIFF WALES,COPENHAGEN,27,0,27,0,0,0,0
25/03/2022 10:55,2021,1,WESTERN EUROPE-EU,DENMARK,2,EAST MIDLANDS INTERNATIONAL,COPENHAGEN,200,200,0,0,0,0,0
25/03/2022 10:55,2021,1,WESTERN EUROPE-EU,DENMARK,2,EDINBURGH,BILLUND,2265,1975,290,1413,1413,0,60.29724
25/03/2022 10:55,2021,1,WESTERN EUROPE-EU,DENMARK,2,EDINBURGH,COPENHAGEN,29850,29419,431,36098,36098,0,-17.30844
25/03/2022 10:55,2021,1,WESTERN EUROPE-EU,DENMARK,2,GLASGOW,BILLUND,86,0,86,0,0,0,0
25/03/2022 10:55,2021,1,WESTERN EUROPE-EU,DENMARK,2,GLASGOW,COPENHAGEN,4167,0,4167,2077,0,2077,100.6259
25/03/2022 10:55,2021,1,WESTERN EUROPE-EU,DENMARK,2,GLASGOW,KARUP,92,0,92,0,0,0,0
25/03/2022 10:55,2021,1,WESTERN EUROPE-EU,DENMARK,2,GLASGOW,ROSKILDE,51,0,51,0,0,0,0
25/03/2022 10:55,2021,1,WESTERN EUROPE-EU,DENMARK,2,GUERNSEY,COPENHAGEN,116,116,0,0,0,0,0
25/03/2022 10:55,2021,1,WESTERN EUROPE-EU,DENMARK,2,HUMBERSIDE,BILLUND,906,0,906,0,0,0,0
25/03/2022 10:55,2021,1,WESTERN EUROPE-EU,DENMARK,2,LIVERPOOL (JOHN LENNON),BILLUND,0,0,0,54,0,54,-100
25/03/2022 10:55,2021,1,WESTERN EUROPE-EU,DENMARK,2,LIVERPOOL (JOHN LENNON),COPENHAGEN,2940,2940,0,5851,5851,0,-49.75218
25/03/2022 10:55,2021,1,WESTERN EUROPE-EU,DENMARK,2,LIVERPOOL (JOHN LENNON),KARUP,0,0,0,131,0,131,-100
25/03/2022 10:55,2021,1,WESTERN EUROPE-EU,DENMARK,2,LIVERPOOL (JOHN LENNON),ROSKILDE,0,0,0,55,0,55,-100
25/03/2022 10:55,2021,1,WESTERN EUROPE-EU,DENMARK,2,MANCHESTER,AARHUS (TIRSTRUP),0,0,0,229,229,0,-100
25/03/2022 10:55,2021,1,WESTERN EUROPE-EU,DENMARK,2,MANCHESTER,BILLUND,4356,4155,201,13623,12997,626,-68.02466
25/03/2022 10:55,2021,1,WESTERN EUROPE-EU,DENMARK,2,MANCHESTER,COPENHAGEN,69923,69923,0,73544,73544,0,-4.92358
25/03/2022 10:55,2021,1,WESTERN EUROPE-EU,DENMARK,2,MANCHESTER,ESBJERG,35,0,35,0,0,0,0
25/03/2022 10:55,2021,1,WESTERN EUROPE-EU,DENMARK,2,MANCHESTER,ROSKILDE,20,0,20,0,0,0,0
25/03/2022 10:55,2021,1,WESTERN EUROPE-EU,DENMARK,2,NEWCASTLE,COPENHAGEN,674,649,25,0,0,0,0
25/03/2022 10:55,2021,1,WESTERN EUROPE-EU,DENMARK,2,NORWICH,BILLUND,52,0,52,13,0,13,300
25/03/2022 10:55,2021,1,WESTERN EUROPE-EU,DENMARK,2,TEESSIDE INTERNATIONAL AIRPORT,ESBJERG,405,0,405,0,0,0,0
25/03/2022 10:55,2021,1,WESTERN EUROPE-EU,FINLAND,1,GATWICK,ENONTEKIO,2988,0,2988,656,394,262,355.4878
25/03/2022 10:55,2021,1,WESTERN EUROPE-EU,FINLAND,1,GATWICK,HELSINKI,6275,6275,0,41358,41358,0,-84.8276
25/03/2022 10:55,2021,1,WESTERN EUROPE-EU,FINLAND,1,GATWICK,IVALO,6423,0,6423,4138,4138,0,55.21991
25/03/2022 10:55,2021,1,WESTERN EUROPE-EU,FINLAND,1,GATWICK,KITTILA,10576,407,10169,6778,1847,4931,56.03423
25/03/2022 10:55,2021,1,WESTERN EUROPE-EU,FINLAND,1,GATWICK,KUUSAMO,4000,0,4000,2269,0,2269,76.28911
25/03/2022 10:55,2021,1,WESTERN EUROPE-EU,FINLAND,1,GATWICK,ROVANIEMI,16893,6118,10775,15559,15404,155,8.57382
25/03/2022 10:55,2021,1,WESTERN EUROPE-EU,FINLAND,1,HEATHROW,HELSINKI,141684,141684,0,220640,220640,0,-35.78499
25/03/2022 10:55,2021,1,WESTERN EUROPE-EU,FINLAND,1,HEATHROW,KITTILA,2007,0,2007,0,0,0,0
25/03/2022 10:55,2021,1,WESTERN EUROPE-EU,FINLAND,1,LUTON,IVALO,803,0,803,0,0,0,0
25/03/2022 10:55,2021,1,WESTERN EUROPE-EU,FINLAND,1,STANSTED,ENONTEKIO,1926,0,1926,0,0,0,0
25/03/2022 10:55,2021,1,WESTERN EUROPE-EU,FINLAND,1,STANSTED,HELSINKI,15326,15326,0,0,0,0,0
25/03/2022 10:55,2021,1,WESTERN EUROPE-EU,FINLAND,1,STANSTED,IVALO,2160,0,2160,0,0,0,0
25/03/2022 10:55,2021,1,WESTERN EUROPE-EU,FINLAND,1,STANSTED,KITTILA,240,0,240,0,0,0,0
25/03/2022 10:55,2021,1,WESTERN EUROPE-EU,FINLAND,1,STANSTED,KUUSAMO,2397,0,2397,0,0,0,0
25/03/2022 10:55,2021,1,WESTERN EUROPE-EU,FINLAND,1,STANSTED,ROVANIEMI,166,0,166,0,0,0,0
25/03/2022 10:55,2021,1,WESTERN EUROPE-EU,FINLAND,1,STANSTED,TAMPERE,2317,2317,0,0,0,0,0
25/03/2022 10:55,2021,1,WESTERN EUROPE-EU,FINLAND,2,ABERDEEN,ENONTEKIO,718,0,718,246,0,246,191.86992
25/03/2022 10:55,2021,1,WESTERN EUROPE-EU,FINLAND,2,BELFAST INTERNATIONAL,ENONTEKIO,1436,0,1436,0,0,0,0
25/03/2022 10:55,2021,1,WESTERN EUROPE-EU,FINLAND,2,BELFAST INTERNATIONAL,HELSINKI,0,0,0,30,0,30,-100
25/03/2022 10:55,2021,1,WESTERN EUROPE-EU,FINLAND,2,BELFAST INTERNATIONAL,MARIEHAMN,56,0,56,0,0,0,0
25/03/2022 10:55,2021,1,WESTERN EUROPE-EU,FINLAND,2,BIGGIN HILL,HELSINKI,13,0,13,0,0,0,0
25/03/2022 10:55,2021,1,WESTERN EUROPE-EU,FINLAND,2,BIRMINGHAM,ENONTEKIO,1883,0,1883,448,0,448,320.3125
25/03/2022 10:55,2021,1,WESTERN EUROPE-EU,FINLAND,2,BIRMINGHAM,IVALO,4231,0,4231,0,0,0,0
25/03/2022 10:55,2021,1,WESTERN EUROPE-EU,FINLAND,2,BIRMINGHAM,KITTILA,2826,0,2826,0,0,0,0
25/03/2022 10:55,2021,1,WESTERN EUROPE-EU,FINLAND,2,BIRMINGHAM,KUUSAMO,1074,0,1074,2365,0,2365,-54.58774
25/03/2022 10:55,2021,1,WESTERN EUROPE-EU,FINLAND,2,BIRMINGHAM,ROVANIEMI,2363,0,2363,0,0,0,0
25/03/2022 10:55,2021,1,WESTERN EUROPE-EU,FINLAND,2,BOURNEMOUTH,ENONTEKIO,0,0,0,182,0,182,-100
25/03/2022 10:55,2021,1,WESTERN EUROPE-EU,FINLAND,2,BOURNEMOUTH,IVALO,428,0,428,0,0,0,0
25/03/2022 10:55,2021,1,WESTERN EUROPE-EU,FINLAND,2,BRISTOL,ENONTEKIO,1382,0,1382,315,0,315,338.73016
25/03/2022 10:55,2021,1,WESTERN EUROPE-EU,FINLAND,2,BRISTOL,IVALO,1547,0,1547,0,0,0,0
25/03/2022 10:55,2021,1,WESTERN EUROPE-EU,FINLAND,2,BRISTOL,KITTILA,5332,6,5326,2807,0,2807,89.95369
25/03/2022 10:55,2021,1,WESTERN EUROPE-EU,FINLAND,2,BRISTOL,ROVANIEMI,2369,0,2369,0,0,0,0
25/03/2022 10:55,2021,1,WESTERN EUROPE-EU,FINLAND,2,CARDIFF WALES,ENONTEKIO,342,0,342,0,0,0,0
25/03/2022 10:55,2021,1,WESTERN EUROPE-EU,FINLAND,2,CARDIFF WALES,HELSINKI,0,0,0,117,0,117,-100
25/03/2022 10:55,2021,1,WESTERN EUROPE-EU,FINLAND,2,CARDIFF WALES,IVALO,363,0,363,0,0,0,0
25/03/2022 10:55,2021,1,WESTERN EUROPE-EU,FINLAND,2,CARDIFF WALES,PORI,36,0,36,0,0,0,0
25/03/2022 10:55,2021,1,WESTERN EUROPE-EU,FINLAND,2,CARDIFF WALES,TURKU,37,0,37,0,0,0,0
25/03/2022 10:55,2021,1,WESTERN EUROPE-EU,FINLAND,2,DONCASTER SHEFFIELD,ENONTEKIO,318,0,318,333,0,333,-4.5045
25/03/2022 10:55,2021,1,WESTERN EUROPE-EU,FINLAND,2,DONCASTER SHEFFIELD,KITTILA,2724,0,2724,0,0,0,0
25/03/2022 10:55,2021,1,WESTERN EUROPE-EU,FINLAND,2,EAST MIDLANDS INTERNATIONAL,ENONTEKIO,704,0,704,304,0,304,131.57895
25/03/2022 10:55,2021,1,WESTERN EUROPE-EU,FINLAND,2,EAST MIDLANDS INTERNATIONAL,KITTILA,2718,0,2718,139,139,0,1855.39568
25/03/2022 10:55,2021,1,WESTERN EUROPE-EU,FINLAND,2,EAST MIDLANDS INTERNATIONAL,KUUSAMO,0,0,0,173,173,0,-100
25/03/2022 10:55,2021,1,WESTERN EUROPE-EU,FINLAND,2,EAST MIDLANDS INTERNATIONAL,ROVANIEMI,180,0,180,0,0,0,0
25/03/2022 10:55,2021,1,WESTERN EUROPE-EU,FINLAND,2,EDINBURGH,ENONTEKIO,738,0,738,0,0,0,0
25/03/2022 10:55,2021,1,WESTERN EUROPE-EU,FINLAND,2,EDINBURGH,HELSINKI,9948,9948,0,6335,6273,62,57.03236
25/03/2022 10:55,2021,1,WESTERN EUROPE-EU,FINLAND,2,EDINBURGH,IVALO,388,0,388,0,0,0,0
25/03/2022 10:55,2021,1,WESTERN EUROPE-EU,FINLAND,2,EDINBURGH,KITTILA,2231,0,2231,0,0,0,0
25/03/2022 10:55,2021,1,WESTERN EUROPE-EU,FINLAND,2,EXETER,ENONTEKIO,0,0,0,125,0,125,-100
25/03/2022 10:55,2021,1,WESTERN EUROPE-EU,FINLAND,2,GLASGOW,ENONTEKIO,1442,0,1442,0,0,0,0
25/03/2022 10:55,2021,1,WESTERN EUROPE-EU,FINLAND,2,GLASGOW,IVALO,392,0,392,0,0,0,0
25/03/2022 10:55,2021,1,WESTERN EUROPE-EU,FINLAND,2,GLASGOW,KITTILA,342,0,342,0,0,0,0
25/03/2022 10:55,2021,1,WESTERN EUROPE-EU,FINLAND,2,HUMBERSIDE,ENONTEKIO,735,0,735,158,0,158,365.18987
25/03/2022 10:55,2021,1,WESTERN EUROPE-EU,FINLAND,2,LEEDS BRADFORD,ENONTEKIO,174,0,174,282,0,282,-38.29787
25/03/2022 10:55,2021,1,WESTERN EUROPE-EU,FINLAND,2,LEEDS BRADFORD,IVALO,2076,0,2076,0,0,0,0
25/03/2022 10:55,2021,1,WESTERN EUROPE-EU,FINLAND,2,LIVERPOOL (JOHN LENNON),ENONTEKIO,360,0,360,0,0,0,0
25/03/2022 10:55,2021,1,WESTERN EUROPE-EU,FINLAND,2,LIVERPOOL (JOHN LENNON),IVALO,383,0,383,0,0,0,0
25/03/2022 10:55,2021,1,WESTERN EUROPE-EU,FINLAND,2,MANCHESTER,ENONTEKIO,3179,0,3179,446,328,118,612.78027
25/03/2022 10:55,2021,1,WESTERN EUROPE-EU,FINLAND,2,MANCHESTER,HELSINKI,21085,21085,0,35220,35220,0,-40.13345
25/03/2022 10:55,2021,1,WESTERN EUROPE-EU,FINLAND,2,MANCHESTER,IVALO,10423,0,10423,0,0,0,0
25/03/2022 10:55,2021,1,WESTERN EUROPE-EU,FINLAND,2,MANCHESTER,KITTILA,11958,0,11958,3522,0,3522,239.523
25/03/2022 10:55,2021,1,WESTERN EUROPE-EU,FINLAND,2,MANCHESTER,KUUSAMO,5102,0,5102,2475,0,2475,106.14141
25/03/2022 10:55,2021,1,WESTERN EUROPE-EU,FINLAND,2,MANCHESTER,ROVANIEMI,5778,0,5778,517,517,0,1017.60155
25/03/2022 10:55,2021,1,WESTERN EUROPE-EU,FINLAND,2,NEWCASTLE,ENONTEKIO,364,364,0,311,311,0,17.0418
25/03/2022 10:55,2021,1,WESTERN EUROPE-EU,FINLAND,2,NEWCASTLE,IVALO,758,397,361,0,0,0,0
25/03/2022 10:55,2021,1,WESTERN EUROPE-EU,FINLAND,2,NEWCASTLE,KITTILA,324,324,0,0,0,0,0
25/03/2022 10:55,2021,1,WESTERN EUROPE-EU,FINLAND,2,NEWCASTLE,ROVANIEMI,2397,2397,0,0,0,0,0
25/03/2022 10:55,2021,1,WESTERN EUROPE-EU,FINLAND,2,NORWICH,ENONTEKIO,0,0,0,338,0,338,-100
25/03/2022 10:55,2021,1,WESTERN EUROPE-EU,FINLAND,2,TEESSIDE INTERNATIONAL AIRPORT,ENONTEKIO,342,0,342,0,0,0,0
25/03/2022 10:55,2021,1,WESTERN EUROPE-EU,FRANCE,1,GATWICK,BIARRITZ,0,0,0,1366,1366,0,-100
25/03/2022 10:55,2021,1,WESTERN EUROPE-EU,FRANCE,1,GATWICK,BORDEAUX,25799,25799,0,54464,54399,65,-52.6311
25/03/2022 10:55,2021,1,WESTERN EUROPE-EU,FRANCE,1,GATWICK,CHAMBERY,1102,0,1102,29567,138,29429,-96.27287
25/03/2022 10:55,2021,1,WESTERN EUROPE-EU,FRANCE,1,GATWICK,CLERMONT FERRAND,0,0,0,100,0,100,-100
25/03/2022 10:55,2021,1,WESTERN EUROPE-EU,FRANCE,1,GATWICK,FIGARI,1204,1204,0,1201,1201,0,0.24979
25/03/2022 10:55,2021,1,WESTERN EUROPE-EU,FRANCE,1,GATWICK,GRENOBLE,1726,1308,418,55406,21436,33970,-96.88481
25/03/2022 10:55,2021,1,WESTERN EUROPE-EU,FRANCE,1,GATWICK,LA ROCHELLE,0,0,0,1919,1919,0,-100
25/03/2022 10:55,2021,1,WESTERN EUROPE-EU,FRANCE,1,GATWICK,LYON,24234,23890,344,73496,55768,17728,-67.02678
25/03/2022 10:55,2021,1,WESTERN EUROPE-EU,FRANCE,1,GATWICK,LYON(BRON),8,0,8,0,0,0,0
25/03/2022 10:55,2021,1,WESTERN EUROPE-EU,FRANCE,1,GATWICK,MARSEILLE,16632,16632,0,31177,31177,0,-46.65298
25/03/2022 10:55,2021,1,WESTERN EUROPE-EU,FRANCE,1,GATWICK,MONTPELLIER,17788,17788,0,22696,22696,0,-21.62496
25/03/2022 10:55,2021,1,WESTERN EUROPE-EU,FRANCE,1,GATWICK,NANTES,23635,23635,0,33759,33759,0,-29.98904
25/03/2022 10:55,2021,1,WESTERN EUROPE-EU,FRANCE,1,GATWICK,NICE,60569,60565,4,103629,103629,0,-41.55208
25/03/2022 10:55,2021,1,WESTERN EUROPE-EU,FRANCE,1,GATWICK,PARIS (CHARLES DE GAULLE),40486,40486,0,131329,131242,87,-69.17208
25/03/2022 10:55,2021,1,WESTERN EUROPE-EU,FRANCE,1,GATWICK,PARIS (LE BOURGET),2,0,2,0,0,0,0
25/03/2022 10:55,2021,1,WESTERN EUROPE-EU,FRANCE,1,GATWICK,PARIS (ORLY),10468,10468,0,5693,5693,0,83.87493
25/03/2022 10:55,2021,1,WESTERN EUROPE-EU,FRANCE,1,GATWICK,PAU,92,0,92,83,0,83,10.84337
25/03/2022 10:55,2021,1,WESTERN EUROPE-EU,FRANCE,1,GATWICK,RENNES,0,0,0,197,0,197,-100
25/03/2022 10:55,2021,1,WESTERN EUROPE-EU,FRANCE,1,GATWICK,TOULOUSE (BLAGNAC),15731,15491,240,56211,48427,7784,-72.01437
25/03/2022 10:55,2021,1,WESTERN EUROPE-EU,FRANCE,1,HEATHROW,BASTIA,183,183,0,1043,1043,0,-82.45446
25/03/2022 10:55,2021,1,WESTERN EUROPE-EU,FRANCE,1,HEATHROW,BORDEAUX,14475,14475,0,6256,6256,0,131.37788
25/03/2022 10:55,2021,1,WESTERN EUROPE-EU,FRANCE,1,HEATHROW,CHATEAUROUX DEOLS,0,0,0,58,58,0,-100
25/03/2022 10:55,2021,1,WESTERN EUROPE-EU,FRANCE,1,HEATHROW,FIGARI,2721,2721,0,842,842,0,223.15914
25/03/2022 10:55,2021,1,WESTERN EUROPE-EU,FRANCE,1,HEATHROW,GRENOBLE,1138,1138,0,3985,3985,0,-71.44291
25/03/2022 10:55,2021,1,WESTERN EUROPE-EU,FRANCE,1,HEATHROW,LYON,37022,37022,0,66724,66650,74,-44.51472
25/03/2022 10:55,2021,1,WESTERN EUROPE-EU,FRANCE,1,HEATHROW,MARSEILLE,51798,51798,0,74557,74255,302,-30.52564
25/03/2022 10:55,2021,1,WESTERN EUROPE-EU,FRANCE,1,HEATHROW,MONTPELLIER,124,124,0,0,0,0,0
25/03/2022 10:55,2021,1,WESTERN EUROPE-EU,FRANCE,1,HEATHROW,NICE,197925,197403,522,161082,161082,0,22.8722
25/03/2022 10:55,2021,1,WESTERN EUROPE-EU,FRANCE,1,HEATHROW,PARIS (CHARLES DE GAULLE),342089,341998,91,375868,375777,91,-8.98693
25/03/2022 10:55,2021,1,WESTERN EUROPE-EU,FRANCE,1,HEATHROW,PARIS (LE BOURGET),0,0,0,116,0,116,-100
25/03/2022 10:55,2021,1,WESTERN EUROPE-EU,FRANCE,1,HEATHROW,PARIS (ORLY),0,0,0,36,36,0,-100
25/03/2022 10:55,2021,1,WESTERN EUROPE-EU,FRANCE,1,HEATHROW,TOULOUSE (BLAGNAC),38750,38750,0,71521,71521,0,-45.82011
25/03/2022 10:55,2021,1,WESTERN EUROPE-EU,FRANCE,1,LONDON CITY,BERGERAC,2617,2617,0,1262,1262,0,107.36926
25/03/2022 10:55,2021,1,WESTERN EUROPE-EU,FRANCE,1,LONDON CITY,CHAMBERY,0,0,0,2402,2402,0,-100
25/03/2022 10:55,2021,1,WESTERN EUROPE-EU,FRANCE,1,LONDON CITY,GRENOBLE,0,0,0,26,26,0,-100
25/03/2022 10:55,2021,1,WESTERN EUROPE-EU,FRANCE,1,LONDON CITY,NICE,15457,15457,0,2823,2823,0,447.53808
25/03/2022 10:55,2021,1,WESTERN EUROPE-EU,FRANCE,1,LUTON,BEZIERS,7720,7720,0,9115,9115,0,-15.30444
25/03/2022 10:55,2021,1,WESTERN EUROPE-EU,FRANCE,1,LUTON,BIARRITZ,0,0,0,457,457,0,-100
25/03/2022 10:55,2021,1,WESTERN EUROPE-EU,FRANCE,1,LUTON,BORDEAUX,631,631,0,13438,13438,0,-95.30436
25/03/2022 10:55,2021,1,WESTERN EUROPE-EU,FRANCE,1,LUTON,GRENOBLE,1215,1215,0,10152,10152,0,-88.03191
25/03/2022 10:55,2021,1,WESTERN EUROPE-EU,FRANCE,1,LUTON,LYON,4731,4731,0,26436,26436,0,-82.10395
25/03/2022 10:55,2021,1,WESTERN EUROPE-EU,FRANCE,1,LUTON,MARSEILLE,64,64,0,5940,5940,0,-98.92256
25/03/2022 10:55,2021,1,WESTERN EUROPE-EU,FRANCE,1,LUTON,MONTPELLIER,859,859,0,918,918,0,-6.42702
25/03/2022 10:55,2021,1,WESTERN EUROPE-EU,FRANCE,1,LUTON,NANTES,0,0,0,8325,8325,0,-100
25/03/2022 10:55,2021,1,WESTERN EUROPE-EU,FRANCE,1,LUTON,NICE,8596,8596,0,20500,20500,0,-58.06829
25/03/2022 10:55,2021,1,WESTERN EUROPE-EU,FRANCE,1,LUTON,NIMES,0,0,0,1861,1861,0,-100
25/03/2022 10:55,2021,1,WESTERN EUROPE-EU,FRANCE,1,LUTON,PARIS (CHARLES DE GAULLE),21425,21425,0,74617,74617,0,-71.2867
25/03/2022 10:55,2021,1,WESTERN EUROPE-EU,FRANCE,1,LUTON,TOULOUSE (BLAGNAC),160,0,160,0,0,0,0
25/03/2022 10:55,2021,1,WESTERN EUROPE-EU,FRANCE,1,SOUTHEND,BERGERAC,0,0,0,978,978,0,-100
25/03/2022 10:55,2021,1,WESTERN EUROPE-EU,FRANCE,1,SOUTHEND,BREST,3979,3979,0,5441,5441,0,-26.87006
25/03/2022 10:55,2021,1,WESTERN EUROPE-EU,FRANCE,1,SOUTHEND,CAEN,0,0,0,1361,1361,0,-100
25/03/2022 10:55,2021,1,WESTERN EUROPE-EU,FRANCE,1,SOUTHEND,MARSEILLE,0,0,0,1401,1401,0,-100
25/03/2022 10:55,2021,1,WESTERN EUROPE-EU,FRANCE,1,SOUTHEND,PARIS (CHARLES DE GAULLE),0,0,0,8529,8529,0,-100
25/03/2022 10:55,2021,1,WESTERN EUROPE-EU,FRANCE,1,SOUTHEND,RENNES,0,0,0,5490,5490,0,-100
25/03/2022 10:55,2021,1,WESTERN EUROPE-EU,FRANCE,1,STANSTED,BERGERAC,18668,18668,0,19694,19694,0,-5.20971
25/03/2022 10:55,2021,1,WESTERN EUROPE-EU,FRANCE,1,STANSTED,BEZIERS,4980,4980,0,3301,3301,0,50.86337
25/03/2022 10:55,2021,1,WESTERN EUROPE-EU,FRANCE,1,STANSTED,BIARRITZ,28375,28375,0,21935,21935,0,29.35947
25/03/2022 10:55,2021,1,WESTERN EUROPE-EU,FRANCE,1,STANSTED,BORDEAUX,26971,26935,36,28880,28880,0,-6.61011
25/03/2022 10:55,2021,1,WESTERN EUROPE-EU,FRANCE,1,STANSTED,BRIVE-LA-GAILLARDE,3814,3814,0,2782,2782,0,37.09561
25/03/2022 10:55,2021,1,WESTERN EUROPE-EU,FRANCE,1,STANSTED,CARCASSONNE,13232,13232,0,17277,17277,0,-23.41263
25/03/2022 10:55,2021,1,WESTERN EUROPE-EU,FRANCE,1,STANSTED,CHAMBERY,193,0,193,10487,3145,7342,-98.15963
25/03/2022 10:55,2021,1,WESTERN EUROPE-EU,FRANCE,1,STANSTED,DINARD,0,0,0,14816,14816,0,-100
25/03/2022 10:55,2021,1,WESTERN EUROPE-EU,FRANCE,1,STANSTED,DOLE,93,93,0,1560,1560,0,-94.03846
25/03/2022 10:55,2021,1,WESTERN EUROPE-EU,FRANCE,1,STANSTED,GRENOBLE,643,643,0,27248,26424,824,-97.64019
25/03/2022 10:55,2021,1,WESTERN EUROPE-EU,FRANCE,1,STANSTED,LA ROCHELLE,11081,11081,0,10572,10572,0,4.8146
25/03/2022 10:55,2021,1,WESTERN EUROPE-EU,FRANCE,1,STANSTED,LIMOGES,21381,21381,0,22499,22499,0,-4.96911
25/03/2022 10:55,2021,1,WESTERN EUROPE-EU,FRANCE,1,STANSTED,LYON,112,0,112,8179,8008,171,-98.63064
25/03/2022 10:55,2021,1,WESTERN EUROPE-EU,FRANCE,1,STANSTED,MARSEILLE,54236,54236,0,33290,33290,0,62.9198
25/03/2022 10:55,2021,1,WESTERN EUROPE-EU,FRANCE,1,STANSTED,NANTES,11851,11851,0,33448,33448,0,-64.56888
25/03/2022 10:55,2021,1,WESTERN EUROPE-EU,FRANCE,1,STANSTED,NICE,3634,3634,0,32099,32086,13,-88.67878
25/03/2022 10:55,2021,1,WESTERN EUROPE-EU,FRANCE,1,STANSTED,NIMES,6185,6185,0,6049,6049,0,2.24831
25/03/2022 10:55,2021,1,WESTERN EUROPE-EU,FRANCE,1,STANSTED,PARIS (CHARLES DE GAULLE),0,0,0,9693,9687,6,-100
25/03/2022 10:55,2021,1,WESTERN EUROPE-EU,FRANCE,1,STANSTED,PERPIGNAN,6254,6254,0,5455,5455,0,14.64711
25/03/2022 10:55,2021,1,WESTERN EUROPE-EU,FRANCE,1,STANSTED,POITIERS,11226,11226,0,12539,12539,0,-10.47133
25/03/2022 10:55,2021,1,WESTERN EUROPE-EU,FRANCE,1,STANSTED,RODEZ,1708,1708,0,0,0,0,0
25/03/2022 10:55,2021,1,WESTERN EUROPE-EU,FRANCE,1,STANSTED,TARBES-LOURDES INTERNATIONAL,8111,8111,0,11986,11986,0,-32.32938
25/03/2022 10:55,2021,1,WESTERN EUROPE-EU,FRANCE,1,STANSTED,TOULOUSE (BLAGNAC),37072,37072,0,48147,48036,111,-23.00247
25/03/2022 10:55,2021,1,WESTERN EUROPE-EU,FRANCE,1,STANSTED,TOURS,2820,2820,0,9866,9866,0,-71.41699
25/03/2022 10:55,2021,1,WESTERN EUROPE-EU,FRANCE,2,ABERDEEN,PARIS (CHARLES DE GAULLE),0,0,0,16165,16165,0,-100
25/03/2022 10:55,2021,1,WESTERN EUROPE-EU,FRANCE,2,ABERDEEN,ROUEN,0,0,0,51,0,51,-100
25/03/2022 10:55,2021,1,WESTERN EUROPE-EU,FRANCE,2,BELFAST CITY (GEORGE BEST),CANNES,0,0,0,2,0,2,-100
25/03/2022 10:55,2021,1,WESTERN EUROPE-EU,FRANCE,2,BELFAST CITY (GEORGE BEST),PARIS (CHARLES DE GAULLE),0,0,0,80,80,0,-100
25/03/2022 10:55,2021,1,WESTERN EUROPE-EU,FRANCE,2,BELFAST INTERNATIONAL,BORDEAUX,0,0,0,950,950,0,-100
25/03/2022 10:55,2021,1,WESTERN EUROPE-EU,FRANCE,2,BELFAST INTERNATIONAL,BRIVE-LA-GAILLARDE,0,0,0,10,0,10,-100
25/03/2022 10:55,2021,1,WESTERN EUROPE-EU,FRANCE,2,BELFAST INTERNATIONAL,CANNES,0,0,0,10,0,10,-100
25/03/2022 10:55,2021,1,WESTERN EUROPE-EU,FRANCE,2,BELFAST INTERNATIONAL,CLERMONT FERRAND,98,0,98,378,0,378,-74.07407
25/03/2022 10:55,2021,1,WESTERN EUROPE-EU,FRANCE,2,BELFAST INTERNATIONAL,LYON,646,646,0,2754,2754,0,-76.54321
25/03/2022 10:55,2021,1,WESTERN EUROPE-EU,FRANCE,2,BELFAST INTERNATIONAL,NICE,0,0,0,1039,1039,0,-100
25/03/2022 10:55,2021,1,WESTERN EUROPE-EU,FRANCE,2,BELFAST INTERNATIONAL,PARIS (CHARLES DE GAULLE),7041,7041,0,16450,16450,0,-57.19757
25/03/2022 10:55,2021,1,WESTERN EUROPE-EU,FRANCE,2,BELFAST INTERNATIONAL,PARIS (ORLY),288,288,0,0,0,0,0
25/03/2022 10:55,2021,1,WESTERN EUROPE-EU,FRANCE,2,BELFAST INTERNATIONAL,TOULOUSE (BLAGNAC),0,0,0,103,0,103,-100
25/03/2022 10:55,2021,1,WESTERN EUROPE-EU,FRANCE,2,BIGGIN HILL,AVIGNON,0,0,0,6,0,6,-100
25/03/2022 10:55,2021,1,WESTERN EUROPE-EU,FRANCE,2,BIGGIN HILL,BERGERAC,77,0,77,0,0,0,0
25/03/2022 10:55,2021,1,WESTERN EUROPE-EU,FRANCE,2,BIGGIN HILL,BEZIERS,2,0,2,0,0,0,0
25/03/2022 10:55,2021,1,WESTERN EUROPE-EU,FRANCE,2,BIGGIN HILL,CAEN,2,0,2,0,0,0,0
25/03/2022 10:55,2021,1,WESTERN EUROPE-EU,FRANCE,2,BIGGIN HILL,CANNES,21,0,21,0,0,0,0
25/03/2022 10:55,2021,1,WESTERN EUROPE-EU,FRANCE,2,BIGGIN HILL,CHAMBERY,0,0,0,24,0,24,-100
25/03/2022 10:55,2021,1,WESTERN EUROPE-EU,FRANCE,2,BIGGIN HILL,DEAUVILLE,5,0,5,5,0,5,0
25/03/2022 10:55,2021,1,WESTERN EUROPE-EU,FRANCE,2,BIGGIN HILL,FIGARI,0,0,0,15,0,15,-100
25/03/2022 10:55,2021,1,WESTERN EUROPE-EU,FRANCE,2,BIGGIN HILL,GRENOBLE,0,0,0,26,0,26,-100
25/03/2022 10:55,2021,1,WESTERN EUROPE-EU,FRANCE,2,BIGGIN HILL,LYON,4,0,4,0,0,0,0
25/03/2022 10:55,2021,1,WESTERN EUROPE-EU,FRANCE,2,BIGGIN HILL,NICE,138,0,138,96,0,96,43.75
25/03/2022 10:55,2021,1,WESTERN EUROPE-EU,FRANCE,2,BIGGIN HILL,PARIS (CHARLES DE GAULLE),6,0,6,9,0,9,-33.33333
25/03/2022 10:55,2021,1,WESTERN EUROPE-EU,FRANCE,2,BIGGIN HILL,PARIS (LE BOURGET),23,0,23,12,0,12,91.66667
25/03/2022 10:55,2021,1,WESTERN EUROPE-EU,FRANCE,2,BIGGIN HILL,TOULON / HYERES,4,0,4,11,0,11,-63.63636
25/03/2022 10:55,2021,1,WESTERN EUROPE-EU,FRANCE,2,BIGGIN HILL,TOULOUSE (BLAGNAC),0,0,0,80,0,80,-100
25/03/2022 10:55,2021,1,WESTERN EUROPE-EU,FRANCE,2,BIRMINGHAM,BERGERAC,0,0,0,807,807,0,-100
25/03/2022 10:55,2021,1,WESTERN EUROPE-EU,FRANCE,2,BIRMINGHAM,BIARRITZ,0,0,0,46,0,46,-100
25/03/2022 10:55,2021,1,WESTERN EUROPE-EU,FRANCE,2,BIRMINGHAM,BORDEAUX,0,0,0,80,0,80,-100
25/03/2022 10:55,2021,1,WESTERN EUROPE-EU,FRANCE,2,BIRMINGHAM,CAEN,92,0,92,0,0,0,0
25/03/2022 10:55,2021,1,WESTERN EUROPE-EU,FRANCE,2,BIRMINGHAM,CHAMBERY,243,0,243,8191,1538,6653,-97.03333
25/03/2022 10:55,2021,1,WESTERN EUROPE-EU,FRANCE,2,BIRMINGHAM,CLERMONT FERRAND,86,0,86,0,0,0,0
25/03/2022 10:55,2021,1,WESTERN EUROPE-EU,FRANCE,2,BIRMINGHAM,DINARD,0,0,0,116,116,0,-100
25/03/2022 10:55,2021,1,WESTERN EUROPE-EU,FRANCE,2,BIRMINGHAM,GRENOBLE,180,180,0,10642,10376,266,-98.30859
25/03/2022 10:55,2021,1,WESTERN EUROPE-EU,FRANCE,2,BIRMINGHAM,LYON,0,0,0,2363,1673,690,-100
25/03/2022 10:55,2021,1,WESTERN EUROPE-EU,FRANCE,2,BIRMINGHAM,MARSEILLE,87,0,87,0,0,0,0
25/03/2022 10:55,2021,1,WESTERN EUROPE-EU,FRANCE,2,BIRMINGHAM,NANTES,0,0,0,87,87,0,-100
25/03/2022 10:55,2021,1,WESTERN EUROPE-EU,FRANCE,2,BIRMINGHAM,NICE,161,0,161,0,0,0,0
25/03/2022 10:55,2021,1,WESTERN EUROPE-EU,FRANCE,2,BIRMINGHAM,PARIS (CHARLES DE GAULLE),54949,54949,0,81121,81121,0,-32.26292
25/03/2022 10:55,2021,1,WESTERN EUROPE-EU,FRANCE,2,BIRMINGHAM,PARIS (ORLY),2251,2251,0,0,0,0,0
25/03/2022 10:55,2021,1,WESTERN EUROPE-EU,FRANCE,2,BIRMINGHAM,PAU,0,0,0,86,0,86,-100
25/03/2022 10:55,2021,1,WESTERN EUROPE-EU,FRANCE,2,BIRMINGHAM,PERPIGNAN,3983,3983,0,2746,2746,0,45.04734
25/03/2022 10:55,2021,1,WESTERN EUROPE-EU,FRANCE,2,BIRMINGHAM,TOULOUSE (BLAGNAC),0,0,0,5068,0,5068,-100
25/03/2022 10:55,2021,1,WESTERN EUROPE-EU,FRANCE,2,BRISTOL,BERGERAC,5593,5593,0,3007,3007,0,85.99933
25/03/2022 10:55,2021,1,WESTERN EUROPE-EU,FRANCE,2,BRISTOL,BEZIERS,6083,6083,0,3563,3563,0,70.72692
25/03/2022 10:55,2021,1,WESTERN EUROPE-EU,FRANCE,2,BRISTOL,BIARRITZ,0,0,0,1184,1184,0,-100
25/03/2022 10:55,2021,1,WESTERN EUROPE-EU,FRANCE,2,BRISTOL,BORDEAUX,3329,3233,96,10327,10239,88,-67.76411
25/03/2022 10:55,2021,1,WESTERN EUROPE-EU,FRANCE,2,BRISTOL,BREST,0,0,0,167,167,0,-100
25/03/2022 10:55,2021,1,WESTERN EUROPE-EU,FRANCE,2,BRISTOL,BRIVE-LA-GAILLARDE,0,0,0,71,0,71,-100
25/03/2022 10:55,2021,1,WESTERN EUROPE-EU,FRANCE,2,BRISTOL,CHAMBERY,422,311,111,6813,0,6813,-93.80596
25/03/2022 10:55,2021,1,WESTERN EUROPE-EU,FRANCE,2,BRISTOL,CLERMONT FERRAND,0,0,0,86,0,86,-100
25/03/2022 10:55,2021,1,WESTERN EUROPE-EU,FRANCE,2,BRISTOL,FIGARI,0,0,0,57,0,57,-100
25/03/2022 10:55,2021,1,WESTERN EUROPE-EU,FRANCE,2,BRISTOL,GRENOBLE,1061,1061,0,12754,12331,423,-91.68104
25/03/2022 10:55,2021,1,WESTERN EUROPE-EU,FRANCE,2,BRISTOL,LA ROCHELLE,83,0,83,0,0,0,0
25/03/2022 10:55,2021,1,WESTERN EUROPE-EU,FRANCE,2,BRISTOL,LIMOGES,5691,5691,0,4156,4156,0,36.93455
25/03/2022 10:55,2021,1,WESTERN EUROPE-EU,FRANCE,2,BRISTOL,LYON,1072,1072,0,5894,5368,526,-81.81201
25/03/2022 10:55,2021,1,WESTERN EUROPE-EU,FRANCE,2,BRISTOL,MARSEILLE,0,0,0,1351,1251,100,-100
25/03/2022 10:55,2021,1,WESTERN EUROPE-EU,FRANCE,2,BRISTOL,MONTPELLIER,90,0,90,0,0,0,0
25/03/2022 10:55,2021,1,WESTERN EUROPE-EU,FRANCE,2,BRISTOL,NICE,10938,10938,0,12034,12034,0,-9.10753
25/03/2022 10:55,2021,1,WESTERN EUROPE-EU,FRANCE,2,BRISTOL,PARIS (CHARLES DE GAULLE),18202,18202,0,53493,53457,36,-65.97312
25/03/2022 10:55,2021,1,WESTERN EUROPE-EU,FRANCE,2,BRISTOL,PARIS (ORLY),10065,10065,0,366,366,0,2650
25/03/2022 10:55,2021,1,WESTERN EUROPE-EU,FRANCE,2,BRISTOL,TOULOUSE (BLAGNAC),7842,7842,0,20121,16712,3409,-61.02579
25/03/2022 10:55,2021,1,WESTERN EUROPE-EU,FRANCE,2,BRISTOL,VILLACOUBLAY,0,0,0,51,0,51,-100
25/03/2022 10:55,2021,1,WESTERN EUROPE-EU,FRANCE,2,CARDIFF WALES,BORDEAUX,0,0,0,1202,0,1202,-100
25/03/2022 10:55,2021,1,WESTERN EUROPE-EU,FRANCE,2,CARDIFF WALES,CARCASSONNE,0,0,0,80,80,0,-100
25/03/2022 10:55,2021,1,WESTERN EUROPE-EU,FRANCE,2,CARDIFF WALES,CHAMBERY,0,0,0,698,698,0,-100
25/03/2022 10:55,2021,1,WESTERN EUROPE-EU,FRANCE,2,CARDIFF WALES,GRENOBLE,0,0,0,587,0,587,-100
25/03/2022 10:55,2021,1,WESTERN EUROPE-EU,FRANCE,2,CARDIFF WALES,LORIENT,72,0,72,0,0,0,0
25/03/2022 10:55,2021,1,WESTERN EUROPE-EU,FRANCE,2,CARDIFF WALES,LYON,82,0,82,1837,0,1837,-95.5362
25/03/2022 10:55,2021,1,WESTERN EUROPE-EU,FRANCE,2,CARDIFF WALES,MARSEILLE,0,0,0,332,0,332,-100
25/03/2022 10:55,2021,1,WESTERN EUROPE-EU,FRANCE,2,CARDIFF WALES,NANTES,0,0,0,683,0,683,-100
25/03/2022 10:55,2021,1,WESTERN EUROPE-EU,FRANCE,2,CARDIFF WALES,NICE,98,0,98,0,0,0,0
25/03/2022 10:55,2021,1,WESTERN EUROPE-EU,FRANCE,2,CARDIFF WALES,PARIS (CHARLES DE GAULLE),42,0,42,10033,8401,1632,-99.58138
25/03/2022 10:55,2021,1,WESTERN EUROPE-EU,FRANCE,2,CARDIFF WALES,PARIS (LE BOURGET),215,0,215,183,71,112,17.48634
25/03/2022 10:55,2021,1,WESTERN EUROPE-EU,FRANCE,2,CARDIFF WALES,PARIS (ORLY),819,819,0,253,0,253,223.71542
25/03/2022 10:55,2021,1,WESTERN EUROPE-EU,FRANCE,2,CARDIFF WALES,PERPIGNAN,86,0,86,0,0,0,0
25/03/2022 10:55,2021,1,WESTERN EUROPE-EU,FRANCE,2,CARDIFF WALES,SAINT BRIEUC (ARMOR),94,0,94,0,0,0,0
25/03/2022 10:55,2021,1,WESTERN EUROPE-EU,FRANCE,2,CARDIFF WALES,TOULON / HYERES,0,0,0,365,0,365,-100
25/03/2022 10:55,2021,1,WESTERN EUROPE-EU,FRANCE,2,CARDIFF WALES,TOULOUSE (BLAGNAC),98,0,98,1671,0,1671,-94.13525
25/03/2022 10:55,2021,1,WESTERN EUROPE-EU,FRANCE,2,DONCASTER SHEFFIELD,BORDEAUX,99,99,0,0,0,0,0
25/03/2022 10:55,2021,1,WESTERN EUROPE-EU,FRANCE,2,DONCASTER SHEFFIELD,CHAMBERY,0,0,0,147,119,28,-100
25/03/2022 10:55,2021,1,WESTERN EUROPE-EU,FRANCE,2,DONCASTER SHEFFIELD,NICE,3,0,3,0,0,0,0
25/03/2022 10:55,2021,1,WESTERN EUROPE-EU,FRANCE,2,DONCASTER SHEFFIELD,PERPIGNAN,295,0,295,0,0,0,0
25/03/2022 10:55,2021,1,WESTERN EUROPE-EU,FRANCE,2,DONCASTER SHEFFIELD,TOULOUSE (BLAGNAC),430,0,430,0,0,0,0
25/03/2022 10:55,2021,1,WESTERN EUROPE-EU,FRANCE,2,DUNDEE,NICE,1,0,1,0,0,0,0
25/03/2022 10:55,2021,1,WESTERN EUROPE-EU,FRANCE,2,DUNDEE,PARIS (LE BOURGET),6,0,6,0,0,0,0
25/03/2022 10:55,2021,1,WESTERN EUROPE-EU,FRANCE,2,EAST MIDLANDS INTERNATIONAL,BEAUVAIS,112,112,0,0,0,0,0
25/03/2022 10:55,2021,1,WESTERN EUROPE-EU,FRANCE,2,EAST MIDLANDS INTERNATIONAL,BERGERAC,4448,4448,0,3202,3202,0,38.91318
25/03/2022 10:55,2021,1,WESTERN EUROPE-EU,FRANCE,2,EAST MIDLANDS INTERNATIONAL,BORDEAUX,81,81,0,0,0,0,0
25/03/2022 10:55,2021,1,WESTERN EUROPE-EU,FRANCE,2,EAST MIDLANDS INTERNATIONAL,BRIVE-LA-GAILLARDE,0,0,0,88,0,88,-100
25/03/2022 10:55,2021,1,WESTERN EUROPE-EU,FRANCE,2,EAST MIDLANDS INTERNATIONAL,CARCASSONNE,2570,2570,0,2839,2839,0,-9.47517
25/03/2022 10:55,2021,1,WESTERN EUROPE-EU,FRANCE,2,EAST MIDLANDS INTERNATIONAL,CHAMBERY,0,0,0,3482,0,3482,-100
25/03/2022 10:55,2021,1,WESTERN EUROPE-EU,FRANCE,2,EAST MIDLANDS INTERNATIONAL,DINARD,0,0,0,2853,2853,0,-100
25/03/2022 10:55,2021,1,WESTERN EUROPE-EU,FRANCE,2,EAST MIDLANDS INTERNATIONAL,GRENOBLE,0,0,0,955,955,0,-100
25/03/2022 10:55,2021,1,WESTERN EUROPE-EU,FRANCE,2,EAST MIDLANDS INTERNATIONAL,LIMOGES,9659,9659,0,10284,10284,0,-6.0774
25/03/2022 10:55,2021,1,WESTERN EUROPE-EU,FRANCE,2,EAST MIDLANDS INTERNATIONAL,PAU,0,0,0,138,0,138,-100
25/03/2022 10:55,2021,1,WESTERN EUROPE-EU,FRANCE,2,EAST MIDLANDS INTERNATIONAL,PERPIGNAN,8,8,0,0,0,0,0
25/03/2022 10:55,2021,1,WESTERN EUROPE-EU,FRANCE,2,EAST MIDLANDS INTERNATIONAL,TOULOUSE (BLAGNAC),149,0,149,0,0,0,0
25/03/2022 10:55,2021,1,WESTERN EUROPE-EU,FRANCE,2,EDINBURGH,BEAUVAIS,3662,3662,0,0,0,0,0
25/03/2022 10:55,2021,1,WESTERN EUROPE-EU,FRANCE,2,EDINBURGH,BEZIERS,1959,1959,0,2766,2766,0,-29.1757
25/03/2022 10:55,2021,1,WESTERN EUROPE-EU,FRANCE,2,EDINBURGH,BORDEAUX,6879,6879,0,5415,3628,1787,27.03601
25/03/2022 10:55,2021,1,WESTERN EUROPE-EU,FRANCE,2,EDINBURGH,CAEN,0,0,0,133,0,133,-100
25/03/2022 10:55,2021,1,WESTERN EUROPE-EU,FRANCE,2,EDINBURGH,CARCASSONNE,1293,1293,0,2210,2210,0,-41.49321
25/03/2022 10:55,2021,1,WESTERN EUROPE-EU,FRANCE,2,EDINBURGH,CHAMBERY,64,0,64,3727,0,3727,-98.2828
25/03/2022 10:55,2021,1,WESTERN EUROPE-EU,FRANCE,2,EDINBURGH,GRENOBLE,235,235,0,4480,3752,728,-94.75446
25/03/2022 10:55,2021,1,WESTERN EUROPE-EU,FRANCE,2,EDINBURGH,LA ROCHELLE,0,0,0,92,0,92,-100
25/03/2022 10:55,2021,1,WESTERN EUROPE-EU,FRANCE,2,EDINBURGH,LYON,727,657,70,6834,4799,2035,-89.36201
25/03/2022 10:55,2021,1,WESTERN EUROPE-EU,FRANCE,2,EDINBURGH,MARSEILLE,8568,8568,0,11179,10509,670,-23.35629
25/03/2022 10:55,2021,1,WESTERN EUROPE-EU,FRANCE,2,EDINBURGH,NANTES,2963,2963,0,12260,11304,956,-75.83197
25/03/2022 10:55,2021,1,WESTERN EUROPE-EU,FRANCE,2,EDINBURGH,NICE,4737,4737,0,5419,5419,0,-12.58535
25/03/2022 10:55,2021,1,WESTERN EUROPE-EU,FRANCE,2,EDINBURGH,PARIS (CHARLES DE GAULLE),61679,61679,0,98981,96567,2414,-37.68602
25/03/2022 10:55,2021,1,WESTERN EUROPE-EU,FRANCE,2,EDINBURGH,PARIS (LE BOURGET),187,0,187,208,0,208,-10.09615
25/03/2022 10:55,2021,1,WESTERN EUROPE-EU,FRANCE,2,EDINBURGH,PARIS (ORLY),2084,2084,0,453,0,453,360.04415
25/03/2022 10:55,2021,1,WESTERN EUROPE-EU,FRANCE,2,EDINBURGH,ST ETIENNE,0,0,0,41,0,41,-100
25/03/2022 10:55,2021,1,WESTERN EUROPE-EU,FRANCE,2,EDINBURGH,TOULOUSE (BLAGNAC),5776,5776,0,14228,10740,3488,-59.40399
25/03/2022 10:55,2021,1,WESTERN EUROPE-EU,FRANCE,2,EXETER,CHAMBERY,0,0,0,4267,893,3374,-100
25/03/2022 10:55,2021,1,WESTERN EUROPE-EU,FRANCE,2,EXETER,LYON,82,0,82,0,0,0,0
25/03/2022 10:55,2021,1,WESTERN EUROPE-EU,FRANCE,2,EXETER,MONTPELLIER,46,0,46,0,0,0,0
25/03/2022 10:55,2021,1,WESTERN EUROPE-EU,FRANCE,2,EXETER,PARIS (CHARLES DE GAULLE),0,0,0,10353,10353,0,-100
25/03/2022 10:55,2021,1,WESTERN EUROPE-EU,FRANCE,2,EXETER,TOULOUSE (BLAGNAC),0,0,0,99,0,99,-100
25/03/2022 10:55,2021,1,WESTERN EUROPE-EU,FRANCE,2,GLASGOW,BORDEAUX,0,0,0,572,572,0,-100
25/03/2022 10:55,2021,1,WESTERN EUROPE-EU,FRANCE,2,GLASGOW,CAEN,0,0,0,131,0,131,-100
25/03/2022 10:55,2021,1,WESTERN EUROPE-EU,FRANCE,2,GLASGOW,CHAMBERY,0,0,0,3816,0,3816,-100
25/03/2022 10:55,2021,1,WESTERN EUROPE-EU,FRANCE,2,GLASGOW,GRENOBLE,0,0,0,3674,3674,0,-100
25/03/2022 10:55,2021,1,WESTERN EUROPE-EU,FRANCE,2,GLASGOW,LA ROCHELLE,94,0,94,0,0,0,0
25/03/2022 10:55,2021,1,WESTERN EUROPE-EU,FRANCE,2,GLASGOW,LILLE,0,0,0,192,0,192,-100
25/03/2022 10:55,2021,1,WESTERN EUROPE-EU,FRANCE,2,GLASGOW,LYON,545,0,545,488,0,488,11.68033
25/03/2022 10:55,2021,1,WESTERN EUROPE-EU,FRANCE,2,GLASGOW,MONTPELLIER,88,0,88,0,0,0,0
25/03/2022 10:55,2021,1,WESTERN EUROPE-EU,FRANCE,2,GLASGOW,PARIS (CHARLES DE GAULLE),8140,8140,0,22671,22623,48,-64.0951
25/03/2022 10:55,2021,1,WESTERN EUROPE-EU,FRANCE,2,GLASGOW,PARIS (ORLY),1537,1537,0,0,0,0,0
25/03/2022 10:55,2021,1,WESTERN EUROPE-EU,FRANCE,2,GUERNSEY,BORDEAUX,123,123,0,0,0,0,0
25/03/2022 10:55,2021,1,WESTERN EUROPE-EU,FRANCE,2,GUERNSEY,GRENOBLE,0,0,0,935,935,0,-100
25/03/2022 10:55,2021,1,WESTERN EUROPE-EU,FRANCE,2,GUERNSEY,NICE,2,0,2,0,0,0,0
25/03/2022 10:55,2021,1,WESTERN EUROPE-EU,FRANCE,2,HUMBERSIDE,NICE,30,0,30,0,0,0,0
25/03/2022 10:55,2021,1,WESTERN EUROPE-EU,FRANCE,2,HUMBERSIDE,PERPIGNAN,106,0,106,70,0,70,51.42857
25/03/2022 10:55,2021,1,WESTERN EUROPE-EU,FRANCE,2,HUMBERSIDE,TOULOUSE (BLAGNAC),34,0,34,0,0,0,0
25/03/2022 10:55,2021,1,WESTERN EUROPE-EU,FRANCE,2,JERSEY,BASTIA,132,132,0,0,0,0,0
25/03/2022 10:55,2021,1,WESTERN EUROPE-EU,FRANCE,2,JERSEY,BREST,0,0,0,31,0,31,-100
25/03/2022 10:55,2021,1,WESTERN EUROPE-EU,FRANCE,2,JERSEY,CAEN,34,0,34,0,0,0,0
25/03/2022 10:55,2021,1,WESTERN EUROPE-EU,FRANCE,2,JERSEY,DINARD,0,0,0,34,0,34,-100
25/03/2022 10:55,2021,1,WESTERN EUROPE-EU,FRANCE,2,JERSEY,GRENOBLE,0,0,0,130,0,130,-100
25/03/2022 10:55,2021,1,WESTERN EUROPE-EU,FRANCE,2,JERSEY,NANTES,35,0,35,0,0,0,0
25/03/2022 10:55,2021,1,WESTERN EUROPE-EU,FRANCE,2,JERSEY,PARIS (CHARLES DE GAULLE),0,0,0,148,0,148,-100
25/03/2022 10:55,2021,1,WESTERN EUROPE-EU,FRANCE,2,JERSEY,RENNES,901,0,901,163,31,132,452.76074
25/03/2022 10:55,2021,1,WESTERN EUROPE-EU,FRANCE,2,LEEDS BRADFORD,BERGERAC,0,0,0,731,731,0,-100
25/03/2022 10:55,2021,1,WESTERN EUROPE-EU,FRANCE,2,LEEDS BRADFORD,GRENOBLE,0,0,0,2675,2675,0,-100
25/03/2022 10:55,2021,1,WESTERN EUROPE-EU,FRANCE,2,LEEDS BRADFORD,LIMOGES,3787,3787,0,3243,3243,0,16.77459
25/03/2022 10:55,2021,1,WESTERN EUROPE-EU,FRANCE,2,LEEDS BRADFORD,NICE,0,0,0,191,191,0,-100
25/03/2022 10:55,2021,1,WESTERN EUROPE-EU,FRANCE,2,LEEDS BRADFORD,PARIS (CHARLES DE GAULLE),2478,2478,0,10037,10037,0,-75.31135
25/03/2022 10:55,2021,1,WESTERN EUROPE-EU,FRANCE,2,LEEDS BRADFORD,PERPIGNAN,70,70,0,0,0,0,0
25/03/2022 10:55,2021,1,WESTERN EUROPE-EU,FRANCE,2,LIVERPOOL (JOHN LENNON),BEAUVAIS,1619,1619,0,0,0,0,0
25/03/2022 10:55,2021,1,WESTERN EUROPE-EU,FRANCE,2,LIVERPOOL (JOHN LENNON),BERGERAC,6066,6066,0,3696,3696,0,64.12338
25/03/2022 10:55,2021,1,WESTERN EUROPE-EU,FRANCE,2,LIVERPOOL (JOHN LENNON),BORDEAUX,0,0,0,2038,2038,0,-100
25/03/2022 10:55,2021,1,WESTERN EUROPE-EU,FRANCE,2,LIVERPOOL (JOHN LENNON),GRENOBLE,274,274,0,2022,2022,0,-86.44906
25/03/2022 10:55,2021,1,WESTERN EUROPE-EU,FRANCE,2,LIVERPOOL (JOHN LENNON),NICE,4085,4085,0,15903,15903,0,-74.31302
25/03/2022 10:55,2021,1,WESTERN EUROPE-EU,FRANCE,2,LIVERPOOL (JOHN LENNON),PARIS (CHARLES DE GAULLE),0,0,0,13783,13783,0,-100
25/03/2022 10:55,2021,1,WESTERN EUROPE-EU,FRANCE,2,LIVERPOOL (JOHN LENNON),PERPIGNAN,1911,0,1911,377,0,377,406.89655
25/03/2022 10:55,2021,1,WESTERN EUROPE-EU,FRANCE,2,LIVERPOOL (JOHN LENNON),TOULOUSE (BLAGNAC),110,0,110,13,13,0,746.15385
25/03/2022 10:55,2021,1,WESTERN EUROPE-EU,FRANCE,2,MANCHESTER,BASTIA,0,0,0,621,621,0,-100
25/03/2022 10:55,2021,1,WESTERN EUROPE-EU,FRANCE,2,MANCHESTER,BEAUVAIS,5950,5950,0,2929,2929,0,103.141
25/03/2022 10:55,2021,1,WESTERN EUROPE-EU,FRANCE,2,MANCHESTER,BERGERAC,0,0,0,553,553,0,-100
25/03/2022 10:55,2021,1,WESTERN EUROPE-EU,FRANCE,2,MANCHESTER,BEZIERS,5325,5325,0,3252,3252,0,63.74539
25/03/2022 10:55,2021,1,WESTERN EUROPE-EU,FRANCE,2,MANCHESTER,BORDEAUX,8649,8649,0,17030,17030,0,-49.21315
25/03/2022 10:55,2021,1,WESTERN EUROPE-EU,FRANCE,2,MANCHESTER,CARCASSONNE,9761,9761,0,11717,11717,0,-16.69369
25/03/2022 10:55,2021,1,WESTERN EUROPE-EU,FRANCE,2,MANCHESTER,CHAMBERY,503,270,233,17890,2117,15773,-97.18837
25/03/2022 10:55,2021,1,WESTERN EUROPE-EU,FRANCE,2,MANCHESTER,GRENOBLE,451,451,0,17642,17485,157,-97.4436
25/03/2022 10:55,2021,1,WESTERN EUROPE-EU,FRANCE,2,MANCHESTER,LA ROCHELLE,108,0,108,1148,804,344,-90.59233
25/03/2022 10:55,2021,1,WESTERN EUROPE-EU,FRANCE,2,MANCHESTER,LIMOGES,12154,12154,0,13166,13166,0,-7.68647
25/03/2022 10:55,2021,1,WESTERN EUROPE-EU,FRANCE,2,MANCHESTER,LYON,973,973,0,12240,10857,1383,-92.05065
25/03/2022 10:55,2021,1,WESTERN EUROPE-EU,FRANCE,2,MANCHESTER,MARSEILLE,10251,10251,0,10290,10057,233,-0.37901
25/03/2022 10:55,2021,1,WESTERN EUROPE-EU,FRANCE,2,MANCHESTER,MENDE,104,104,0,0,0,0,0
25/03/2022 10:55,2021,1,WESTERN EUROPE-EU,FRANCE,2,MANCHESTER,NANTES,9970,9970,0,10449,10449,0,-4.58417
25/03/2022 10:55,2021,1,WESTERN EUROPE-EU,FRANCE,2,MANCHESTER,NICE,6588,6588,0,8999,8999,0,-26.79187
25/03/2022 10:55,2021,1,WESTERN EUROPE-EU,FRANCE,2,MANCHESTER,PARIS (CHARLES DE GAULLE),147060,145821,1239,172088,171985,103,-14.54372
25/03/2022 10:55,2021,1,WESTERN EUROPE-EU,FRANCE,2,MANCHESTER,PARIS (LE BOURGET),195,0,195,50,0,50,290
25/03/2022 10:55,2021,1,WESTERN EUROPE-EU,FRANCE,2,MANCHESTER,PERPIGNAN,148,0,148,79,0,79,87.34177
25/03/2022 10:55,2021,1,WESTERN EUROPE-EU,FRANCE,2,MANCHESTER,RODEZ,0,0,0,455,455,0,-100
25/03/2022 10:55,2021,1,WESTERN EUROPE-EU,FRANCE,2,MANCHESTER,TOULON / HYERES,0,0,0,91,0,91,-100
25/03/2022 10:55,2021,1,WESTERN EUROPE-EU,FRANCE,2,MANCHESTER,TOULOUSE (BLAGNAC),0,0,0,7396,0,7396,-100
25/03/2022 10:55,2021,1,WESTERN EUROPE-EU,FRANCE,2,NEWCASTLE,CHAMBERY,0,0,0,178,0,178,-100
25/03/2022 10:55,2021,1,WESTERN EUROPE-EU,FRANCE,2,NEWCASTLE,GRENOBLE,0,0,0,3796,3796,0,-100
25/03/2022 10:55,2021,1,WESTERN EUROPE-EU,FRANCE,2,NEWCASTLE,LYON,0,0,0,136,0,136,-100
25/03/2022 10:55,2021,1,WESTERN EUROPE-EU,FRANCE,2,NEWCASTLE,NICE,0,0,0,1236,1236,0,-100
25/03/2022 10:55,2021,1,WESTERN EUROPE-EU,FRANCE,2,NEWCASTLE,PARIS (CHARLES DE GAULLE),20334,20334,0,35834,35746,88,-43.25501
25/03/2022 10:55,2021,1,WESTERN EUROPE-EU,FRANCE,2,NEWCASTLE,PARIS (ORLY),953,953,0,0,0,0,0
25/03/2022 10:55,2021,1,WESTERN EUROPE-EU,FRANCE,2,NEWCASTLE,PERPIGNAN,84,0,84,0,0,0,0
25/03/2022 10:55,2021,1,WESTERN EUROPE-EU,FRANCE,2,NEWCASTLE,TOULOUSE (BLAGNAC),124,0,124,38,0,38,226.31579
25/03/2022 10:55,2021,1,WESTERN EUROPE-EU,FRANCE,2,OXFORD (KIDLINGTON),MARSEILLE,44,44,0,0,0,0,0
25/03/2022 10:55,2021,1,WESTERN EUROPE-EU,FRANCE,2,OXFORD (KIDLINGTON),NICE,50,50,0,0,0,0,0
25/03/2022 10:55,2021,1,WESTERN EUROPE-EU,FRANCE,2,SOUTHAMPTON,BERGERAC,1641,1641,0,948,948,0,73.10127
25/03/2022 10:55,2021,1,WESTERN EUROPE-EU,FRANCE,2,SOUTHAMPTON,CHAMBERY,0,0,0,1925,1925,0,-100
25/03/2022 10:55,2021,1,WESTERN EUROPE-EU,FRANCE,2,SOUTHAMPTON,LIMOGES,0,0,0,107,107,0,-100
25/03/2022 10:55,2021,1,WESTERN EUROPE-EU,FRANCE,2,SOUTHAMPTON,PARIS (CHARLES DE GAULLE),0,0,0,12165,12165,0,-100
25/03/2022 10:55,2021,1,WESTERN EUROPE-EU,FRANCE,2,SOUTHAMPTON,TOULOUSE (BLAGNAC),0,0,0,15,0,15,-100
25/03/2022 10:55,2021,1,WESTERN EUROPE-EU,GERMANY,1,GATWICK,BERLIN (TEGEL),0,0,0,75616,75616,0,-100
25/03/2022 10:55,2021,1,WESTERN EUROPE-EU,GERMANY,1,GATWICK,BERLIN BRANDENBURG,55992,55992,0,38638,38638,0,44.91433
25/03/2022 10:55,2021,1,WESTERN EUROPE-EU,GERMANY,1,GATWICK,BRAUNSCHWEIG,83,0,83,0,0,0,0
25/03/2022 10:55,2021,1,WESTERN EUROPE-EU,GERMANY,1,GATWICK,COLOGNE BONN,0,0,0,9218,8463,755,-100
25/03/2022 10:55,2021,1,WESTERN EUROPE-EU,GERMANY,1,GATWICK,DUSSELDORF,0,0,0,36272,36272,0,-100
25/03/2022 10:55,2021,1,WESTERN EUROPE-EU,GERMANY,1,GATWICK,FRANKFURT MAIN,573,0,573,100,0,100,473
25/03/2022 10:55,2021,1,WESTERN EUROPE-EU,GERMANY,1,GATWICK,FRIEDRICHSHAFEN,161,161,0,14622,6940,7682,-98.89892
25/03/2022 10:55,2021,1,WESTERN EUROPE-EU,GERMANY,1,GATWICK,HAMBURG,6979,6979,0,33445,33369,76,-79.1329
25/03/2022 10:55,2021,1,WESTERN EUROPE-EU,GERMANY,1,GATWICK,HANOVER,0,0,0,384,0,384,-100
25/03/2022 10:55,2021,1,WESTERN EUROPE-EU,GERMANY,1,GATWICK,LEIPZIG,0,0,0,61,0,61,-100
25/03/2022 10:55,2021,1,WESTERN EUROPE-EU,GERMANY,1,GATWICK,MUNICH,16927,16882,45,50403,50177,226,-66.41668
25/03/2022 10:55,2021,1,WESTERN EUROPE-EU,GERMANY,1,GATWICK,NUREMBERG,0,0,0,1091,1091,0,-100
25/03/2022 10:55,2021,1,WESTERN EUROPE-EU,GERMANY,1,GATWICK,STUTTGART,0,0,0,19079,19079,0,-100
25/03/2022 10:55,2021,1,WESTERN EUROPE-EU,GERMANY,1,HEATHROW,BERLIN (TEGEL),0,0,0,201180,201180,0,-100
25/03/2022 10:55,2021,1,WESTERN EUROPE-EU,GERMANY,1,HEATHROW,BERLIN BRANDENBURG,115625,115258,367,9721,9721,0,1089.43524
25/03/2022 10:55,2021,1,WESTERN EUROPE-EU,GERMANY,1,HEATHROW,COLOGNE BONN,13264,13264,0,44332,44332,0,-70.0803
25/03/2022 10:55,2021,1,WESTERN EUROPE-EU,GERMANY,1,HEATHROW,DUSSELDORF,85072,85072,0,193992,193992,0,-56.14665
25/03/2022 10:55,2021,1,WESTERN EUROPE-EU,GERMANY,1,HEATHROW,FRANKFURT MAIN,314745,314647,98,412506,412426,80,-23.69929
25/03/2022 10:55,2021,1,WESTERN EUROPE-EU,GERMANY,1,HEATHROW,FRIEDRICHSHAFEN,0,0,0,273,0,273,-100
25/03/2022 10:55,2021,1,WESTERN EUROPE-EU,GERMANY,1,HEATHROW,HAMBURG,75620,75602,18,167148,167080,68,-54.75866
25/03/2022 10:55,2021,1,WESTERN EUROPE-EU,GERMANY,1,HEATHROW,HANOVER,9208,9208,0,37896,37896,0,-75.70192
25/03/2022 10:55,2021,1,WESTERN EUROPE-EU,GERMANY,1,HEATHROW,MUNICH,201723,201654,69,316687,316253,434,-36.30209
25/03/2022 10:55,2021,1,WESTERN EUROPE-EU,GERMANY,1,HEATHROW,STUTTGART,36557,36557,0,89367,89367,0,-59.0934
25/03/2022 10:55,2021,1,WESTERN EUROPE-EU,GERMANY,1,LONDON CITY,BERLIN (TEGEL),0,0,0,32838,32838,0,-100
25/03/2022 10:55,2021,1,WESTERN EUROPE-EU,GERMANY,1,LONDON CITY,BERLIN BRANDENBURG,25771,25771,0,0,0,0,0
25/03/2022 10:55,2021,1,WESTERN EUROPE-EU,GERMANY,1,LONDON CITY,DUSSELDORF,22385,22385,0,20069,20069,0,11.54019
25/03/2022 10:55,2021,1,WESTERN EUROPE-EU,GERMANY,1,LONDON CITY,FRANKFURT MAIN,39643,39643,0,47026,47026,0,-15.69983
25/03/2022 10:55,2021,1,WESTERN EUROPE-EU,GERMANY,1,LONDON CITY,MUNICH,0,0,0,20450,20400,50,-100
25/03/2022 10:55,2021,1,WESTERN EUROPE-EU,GERMANY,1,LUTON,BERLIN BRANDENBURG,7140,7140,0,29010,29010,0,-75.3878
25/03/2022 10:55,2021,1,WESTERN EUROPE-EU,GERMANY,1,LUTON,DORTMUND,0,0,0,18017,18017,0,-100
25/03/2022 10:55,2021,1,WESTERN EUROPE-EU,GERMANY,1,LUTON,MUNICH,0,0,0,11997,11997,0,-100
25/03/2022 10:55,2021,1,WESTERN EUROPE-EU,GERMANY,1,LUTON,NIEDERRHEIN,119,0,119,0,0,0,0
25/03/2022 10:55,2021,1,WESTERN EUROPE-EU,GERMANY,1,LUTON,NUREMBERG,245,245,0,0,0,0,0
25/03/2022 10:55,2021,1,WESTERN EUROPE-EU,GERMANY,1,LUTON,STUTTGART,97,97,0,0,0,0,0
25/03/2022 10:55,2021,1,WESTERN EUROPE-EU,GERMANY,1,STANSTED,BERLIN (TEGEL),0,0,0,932,930,2,-100
25/03/2022 10:55,2021,1,WESTERN EUROPE-EU,GERMANY,1,STANSTED,BERLIN BRANDENBURG,100741,100741,0,139325,139148,177,-27.69352
25/03/2022 10:55,2021,1,WESTERN EUROPE-EU,GERMANY,1,STANSTED,BREMEN,13253,13253,0,45176,45176,0,-70.66363
25/03/2022 10:55,2021,1,WESTERN EUROPE-EU,GERMANY,1,STANSTED,COLOGNE BONN,71380,71380,0,77504,77423,81,-7.90153
25/03/2022 10:55,2021,1,WESTERN EUROPE-EU,GERMANY,1,STANSTED,DORTMUND,6979,6979,0,36167,36167,0,-80.7034
25/03/2022 10:55,2021,1,WESTERN EUROPE-EU,GERMANY,1,STANSTED,DRESDEN,949,949,0,14338,14338,0,-93.38122
25/03/2022 10:55,2021,1,WESTERN EUROPE-EU,GERMANY,1,STANSTED,DUSSELDORF,0,0,0,8713,8713,0,-100
25/03/2022 10:55,2021,1,WESTERN EUROPE-EU,GERMANY,1,STANSTED,FRANKFURT MAIN,58155,58155,0,87804,87804,0,-33.76725
25/03/2022 10:55,2021,1,WESTERN EUROPE-EU,GERMANY,1,STANSTED,FRIEDRICHSHAFEN,0,0,0,2022,2022,0,-100
25/03/2022 10:55,2021,1,WESTERN EUROPE-EU,GERMANY,1,STANSTED,HAMBURG,43650,43650,0,34409,34409,0,26.85635
25/03/2022 10:55,2021,1,WESTERN EUROPE-EU,GERMANY,1,STANSTED,HANOVER,0,0,0,1002,0,1002,-100
25/03/2022 10:55,2021,1,WESTERN EUROPE-EU,GERMANY,1,STANSTED,KARLSRUHE/BADEN BADEN,14785,14785,0,33799,33799,0,-56.2561
25/03/2022 10:55,2021,1,WESTERN EUROPE-EU,GERMANY,1,STANSTED,LEIPZIG,0,0,0,747,0,747,-100
25/03/2022 10:55,2021,1,WESTERN EUROPE-EU,GERMANY,1,STANSTED,MEMMINGEN ALLGAU,15974,15974,0,25137,25137,0,-36.45224
25/03/2022 10:55,2021,1,WESTERN EUROPE-EU,GERMANY,1,STANSTED,MUNICH,0,0,0,12605,12499,106,-100
25/03/2022 10:55,2021,1,WESTERN EUROPE-EU,GERMANY,1,STANSTED,NUREMBERG,11250,11250,0,33622,33622,0,-66.53977
25/03/2022 10:55,2021,1,WESTERN EUROPE-EU,GERMANY,2,BELFAST INTERNATIONAL,MEMMINGEN ALLGAU,0,0,0,155,0,155,-100
25/03/2022 10:55,2021,1,WESTERN EUROPE-EU,GERMANY,2,BIGGIN HILL,BERLIN BRANDENBURG,5,0,5,2,0,2,150
25/03/2022 10:55,2021,1,WESTERN EUROPE-EU,GERMANY,2,BIGGIN HILL,BREMEN,4,0,4,0,0,0,0
25/03/2022 10:55,2021,1,WESTERN EUROPE-EU,GERMANY,2,BIGGIN HILL,COLOGNE BONN,4,0,4,0,0,0,0
25/03/2022 10:55,2021,1,WESTERN EUROPE-EU,GERMANY,2,BIGGIN HILL,DORTMUND,4,0,4,0,0,0,0
25/03/2022 10:55,2021,1,WESTERN EUROPE-EU,GERMANY,2,BIGGIN HILL,DUSSELDORF,8,0,8,0,0,0,0
25/03/2022 10:55,2021,1,WESTERN EUROPE-EU,GERMANY,2,BIGGIN HILL,FRANKFURT MAIN,12,0,12,0,0,0,0
25/03/2022 10:55,2021,1,WESTERN EUROPE-EU,GERMANY,2,BIGGIN HILL,HAMBURG,6,0,6,0,0,0,0
25/03/2022 10:55,2021,1,WESTERN EUROPE-EU,GERMANY,2,BIGGIN HILL,MUNICH,84,0,84,10,0,10,740
25/03/2022 10:55,2021,1,WESTERN EUROPE-EU,GERMANY,2,BIGGIN HILL,MUNSTER-OSNABRUCK,7,0,7,0,0,0,0
25/03/2022 10:55,2021,1,WESTERN EUROPE-EU,GERMANY,2,BIGGIN HILL,NUREMBERG,0,0,0,1,0,1,-100
25/03/2022 10:55,2021,1,WESTERN EUROPE-EU,GERMANY,2,BIGGIN HILL,STUTTGART,0,0,0,2,0,2,-100
25/03/2022 10:55,2021,1,WESTERN EUROPE-EU,GERMANY,2,BIRMINGHAM,BERLIN (TEGEL),0,0,0,1823,1823,0,-100
25/03/2022 10:55,2021,1,WESTERN EUROPE-EU,GERMANY,2,BIRMINGHAM,BERLIN BRANDENBURG,931,931,0,0,0,0,0
25/03/2022 10:55,2021,1,WESTERN EUROPE-EU,GERMANY,2,BIRMINGHAM,DUSSELDORF,14906,14875,31,67170,67170,0,-77.80855
25/03/2022 10:55,2021,1,WESTERN EUROPE-EU,GERMANY,2,BIRMINGHAM,FRANKFURT MAIN,51589,51589,0,82923,82923,0,-37.78686
25/03/2022 10:55,2021,1,WESTERN EUROPE-EU,GERMANY,2,BIRMINGHAM,FRIEDRICHSHAFEN,0,0,0,178,178,0,-100
25/03/2022 10:55,2021,1,WESTERN EUROPE-EU,GERMANY,2,BIRMINGHAM,HANOVER,0,0,0,575,0,575,-100
25/03/2022 10:55,2021,1,WESTERN EUROPE-EU,GERMANY,2,BIRMINGHAM,MUNICH,14362,14362,0,43705,43705,0,-67.13877
25/03/2022 10:55,2021,1,WESTERN EUROPE-EU,GERMANY,2,BIRMINGHAM,STUTTGART,0,0,0,8452,8452,0,-100
25/03/2022 10:55,2021,1,WESTERN EUROPE-EU,GERMANY,2,BRISTOL,BERLIN BRANDENBURG,7887,7887,0,23762,23762,0,-66.80835
25/03/2022 10:55,2021,1,WESTERN EUROPE-EU,GERMANY,2,BRISTOL,COLOGNE BONN,2905,2905,0,15964,15964,0,-81.80281
25/03/2022 10:55,2021,1,WESTERN EUROPE-EU,GERMANY,2,BRISTOL,FRANKFURT MAIN,13274,13274,0,0,0,0,0
25/03/2022 10:55,2021,1,WESTERN EUROPE-EU,GERMANY,2,CARDIFF WALES,DUSSELDORF,0,0,0,91,91,0,-100
25/03/2022 10:55,2021,1,WESTERN EUROPE-EU,GERMANY,2,CARDIFF WALES,KARLSRUHE/BADEN BADEN,36,0,36,0,0,0,0
25/03/2022 10:55,2021,1,WESTERN EUROPE-EU,GERMANY,2,DONCASTER SHEFFIELD,KARLSRUHE/BADEN BADEN,0,0,0,22,0,22,-100
25/03/2022 10:55,2021,1,WESTERN EUROPE-EU,GERMANY,2,DUNDEE,MUNSTER-OSNABRUCK,0,0,0,25,0,25,-100
25/03/2022 10:55,2021,1,WESTERN EUROPE-EU,GERMANY,2,EAST MIDLANDS INTERNATIONAL,BERLIN BRANDENBURG,9693,9693,0,15176,15176,0,-36.12941
25/03/2022 10:55,2021,1,WESTERN EUROPE-EU,GERMANY,2,EDINBURGH,BERLIN (TEGEL),0,0,0,20726,20726,0,-100
25/03/2022 10:55,2021,1,WESTERN EUROPE-EU,GERMANY,2,EDINBURGH,BERLIN BRANDENBURG,25432,25432,0,34641,34641,0,-26.58411
25/03/2022 10:55,2021,1,WESTERN EUROPE-EU,GERMANY,2,EDINBURGH,COLOGNE BONN,0,0,0,5776,5776,0,-100
25/03/2022 10:55,2021,1,WESTERN EUROPE-EU,GERMANY,2,EDINBURGH,DUSSELDORF,6303,5964,339,2893,2893,0,117.87072
25/03/2022 10:55,2021,1,WESTERN EUROPE-EU,GERMANY,2,EDINBURGH,FRANKFURT MAIN,41850,41327,523,35546,35546,0,17.73477
25/03/2022 10:55,2021,1,WESTERN EUROPE-EU,GERMANY,2,EDINBURGH,HAMBURG,10076,10076,0,18864,18864,0,-46.58609
25/03/2022 10:55,2021,1,WESTERN EUROPE-EU,GERMANY,2,EDINBURGH,KARLSRUHE/BADEN BADEN,0,0,0,4605,4605,0,-100
25/03/2022 10:55,2021,1,WESTERN EUROPE-EU,GERMANY,2,EDINBURGH,MEMMINGEN ALLGAU,0,0,0,2798,2798,0,-100
25/03/2022 10:55,2021,1,WESTERN EUROPE-EU,GERMANY,2,EDINBURGH,MUNICH,757,757,0,30434,30434,0,-97.51265
25/03/2022 10:55,2021,1,WESTERN EUROPE-EU,GERMANY,2,EDINBURGH,NIEDERRHEIN,0,0,0,6007,6007,0,-100
25/03/2022 10:55,2021,1,WESTERN EUROPE-EU,GERMANY,2,EXETER,HANOVER,0,0,0,312,0,312,-100
25/03/2022 10:55,2021,1,WESTERN EUROPE-EU,GERMANY,2,GLASGOW,BERLIN BRANDENBURG,0,0,0,11744,11744,0,-100
25/03/2022 10:55,2021,1,WESTERN EUROPE-EU,GERMANY,2,GLASGOW,COLOGNE BONN,294,0,294,539,225,314,-45.45455
25/03/2022 10:55,2021,1,WESTERN EUROPE-EU,GERMANY,2,GLASGOW,DUSSELDORF,0,0,0,1195,1195,0,-100
25/03/2022 10:55,2021,1,WESTERN EUROPE-EU,GERMANY,2,GLASGOW,FRANKFURT MAIN,20436,20436,0,16251,16238,13,25.75226
25/03/2022 10:55,2021,1,WESTERN EUROPE-EU,GERMANY,2,LEEDS BRADFORD,BERLIN BRANDENBURG,672,672,0,0,0,0,0
25/03/2022 10:55,2021,1,WESTERN EUROPE-EU,GERMANY,2,LEEDS BRADFORD,COLOGNE BONN,338,338,0,0,0,0,0
25/03/2022 10:55,2021,1,WESTERN EUROPE-EU,GERMANY,2,LIVERPOOL (JOHN LENNON),BERLIN BRANDENBURG,0,0,0,10470,10470,0,-100
25/03/2022 10:55,2021,1,WESTERN EUROPE-EU,GERMANY,2,LIVERPOOL (JOHN LENNON),BRAUNSCHWEIG,0,0,0,70,0,70,-100
25/03/2022 10:55,2021,1,WESTERN EUROPE-EU,GERMANY,2,MANCHESTER,BERLIN (TEGEL),0,0,0,37364,37364,0,-100
25/03/2022 10:55,2021,1,WESTERN EUROPE-EU,GERMANY,2,MANCHESTER,BERLIN BRANDENBURG,46972,46972,0,58792,58792,0,-20.10478
25/03/2022 10:55,2021,1,WESTERN EUROPE-EU,GERMANY,2,MANCHESTER,COLOGNE BONN,18071,18071,0,29527,29389,138,-38.79839
25/03/2022 10:55,2021,1,WESTERN EUROPE-EU,GERMANY,2,MANCHESTER,DORTMUND,202,0,202,0,0,0,0
25/03/2022 10:55,2021,1,WESTERN EUROPE-EU,GERMANY,2,MANCHESTER,DUSSELDORF,19326,19326,0,74486,74486,0,-74.05418
25/03/2022 10:55,2021,1,WESTERN EUROPE-EU,GERMANY,2,MANCHESTER,EGELSBACH,40,40,0,0,0,0,0
25/03/2022 10:55,2021,1,WESTERN EUROPE-EU,GERMANY,2,MANCHESTER,FRANKFURT MAIN,98600,98600,0,129064,129064,0,-23.60379
25/03/2022 10:55,2021,1,WESTERN EUROPE-EU,GERMANY,2,MANCHESTER,HAMBURG,8674,8674,0,29471,29471,0,-70.56768
25/03/2022 10:55,2021,1,WESTERN EUROPE-EU,GERMANY,2,MANCHESTER,HANOVER,0,0,0,5640,4362,1278,-100
25/03/2022 10:55,2021,1,WESTERN EUROPE-EU,GERMANY,2,MANCHESTER,LEIPZIG,362,0,362,201,0,201,80.0995
25/03/2022 10:55,2021,1,WESTERN EUROPE-EU,GERMANY,2,MANCHESTER,MUNICH,44117,44117,0,80591,80453,138,-45.25816
25/03/2022 10:55,2021,1,WESTERN EUROPE-EU,GERMANY,2,MANCHESTER,PADERBORN,63,0,63,0,0,0,0
25/03/2022 10:55,2021,1,WESTERN EUROPE-EU,GERMANY,2,MANCHESTER,STUTTGART,4,0,4,0,0,0,0
25/03/2022 10:55,2021,1,WESTERN EUROPE-EU,GERMANY,2,NEWCASTLE,BERLIN BRANDENBURG,827,827,0,0,0,0,0
25/03/2022 10:55,2021,1,WESTERN EUROPE-EU,GERMANY,2,NEWCASTLE,COLOGNE BONN,141,141,0,0,0,0,0
25/03/2022 10:55,2021,1,WESTERN EUROPE-EU,GERMANY,2,NEWCASTLE,DUSSELDORF,2255,2255,0,9547,9547,0,-76.38001
25/03/2022 10:55,2021,1,WESTERN EUROPE-EU,GERMANY,2,NEWCASTLE,FRANKFURT MAIN,10040,10040,0,0,0,0,0
25/03/2022 10:55,2021,1,WESTERN EUROPE-EU,GERMANY,2,NEWCASTLE,MUNICH,0,0,0,4981,4889,92,-100
25/03/2022 10:55,2021,1,WESTERN EUROPE-EU,GERMANY,2,NORWICH,PADERBORN,0,0,0,90,0,90,-100
25/03/2022 10:55,2021,1,WESTERN EUROPE-EU,GERMANY,2,OXFORD (KIDLINGTON),COLOGNE BONN,0,0,0,130,130,0,-100
25/03/2022 10:55,2021,1,WESTERN EUROPE-EU,GERMANY,2,SOUTHAMPTON,BERLIN BRANDENBURG,867,867,0,0,0,0,0
25/03/2022 10:55,2021,1,WESTERN EUROPE-EU,GERMANY,2,SUMBURGH,NUREMBERG,0,0,0,1,0,1,-100
25/03/2022 10:55,2021,1,WESTERN EUROPE-EU,GIBRALTAR,1,GATWICK,GIBRALTAR,73207,73207,0,45779,45779,0,59.91393
25/03/2022 10:55,2021,1,WESTERN EUROPE-EU,GIBRALTAR,1,HEATHROW,GIBRALTAR,102770,102770,0,87632,87216,416,17.27451
25/03/2022 10:55,2021,1,WESTERN EUROPE-EU,GIBRALTAR,1,LONDON CITY,GIBRALTAR,3078,3078,0,0,0,0,0
25/03/2022 10:55,2021,1,WESTERN EUROPE-EU,GIBRALTAR,1,LUTON,GIBRALTAR,11255,11255,0,6979,6979,0,61.26952
25/03/2022 10:55,2021,1,WESTERN EUROPE-EU,GIBRALTAR,1,SOUTHEND,GIBRALTAR,0,0,0,70,70,0,-100
25/03/2022 10:55,2021,1,WESTERN EUROPE-EU,GIBRALTAR,1,STANSTED,GIBRALTAR,149,0,149,69,0,69,115.94203
25/03/2022 10:55,2021,1,WESTERN EUROPE-EU,GIBRALTAR,2,ABERDEEN,GIBRALTAR,76,0,76,0,0,0,0
25/03/2022 10:55,2021,1,WESTERN EUROPE-EU,GIBRALTAR,2,BIGGIN HILL,GIBRALTAR,28,0,28,0,0,0,0
25/03/2022 10:55,2021,1,WESTERN EUROPE-EU,GIBRALTAR,2,BIRMINGHAM,GIBRALTAR,2420,2420,0,0,0,0,0
25/03/2022 10:55,2021,1,WESTERN EUROPE-EU,GIBRALTAR,2,BRISTOL,GIBRALTAR,18827,18827,0,17325,17325,0,8.66955
25/03/2022 10:55,2021,1,WESTERN EUROPE-EU,GIBRALTAR,2,EDINBURGH,GIBRALTAR,8538,8538,0,0,0,0,0
25/03/2022 10:55,2021,1,WESTERN EUROPE-EU,GIBRALTAR,2,GLASGOW,GIBRALTAR,0,0,0,107,0,107,-100
25/03/2022 10:55,2021,1,WESTERN EUROPE-EU,GIBRALTAR,2,MANCHESTER,GIBRALTAR,38516,38516,0,24796,24796,0,55.33151
25/03/2022 10:55,2021,1,WESTERN EUROPE-EU,GIBRALTAR,2,SOUTHAMPTON,GIBRALTAR,1845,1845,0,0,0,0,0
25/03/2022 10:55,2021,1,WESTERN EUROPE-EU,GREECE,1,GATWICK,ATHENS,54955,54955,0,71482,71298,184,-23.12051
25/03/2022 10:55,2021,1,WESTERN EUROPE-EU,GREECE,1,GATWICK,CHANIA,35984,28476,7508,24641,22923,1718,46.03303
25/03/2022 10:55,2021,1,WESTERN EUROPE-EU,GREECE,1,GATWICK,CORFU,63193,48751,14442,66369,53363,13006,-4.78537
25/03/2022 10:55,2021,1,WESTERN EUROPE-EU,GREECE,1,GATWICK,HERAKLION,61598,39804,21794,42156,34183,7973,46.11918
25/03/2022 10:55,2021,1,WESTERN EUROPE-EU,GREECE,1,GATWICK,KALAMATA,13061,8789,4272,8868,8868,0,47.28236
25/03/2022 10:55,2021,1,WESTERN EUROPE-EU,GREECE,1,GATWICK,KAVALA,1591,0,1591,0,0,0,0
25/03/2022 10:55,2021,1,WESTERN EUROPE-EU,GREECE,1,GATWICK,KEFALLINIA,31098,26787,4311,33321,31236,2085,-6.67147
25/03/2022 10:55,2021,1,WESTERN EUROPE-EU,GREECE,1,GATWICK,KOS,37017,11469,25548,38849,12818,26031,-4.71569
25/03/2022 10:55,2021,1,WESTERN EUROPE-EU,GREECE,1,GATWICK,LEMNOS,1908,0,1908,2677,568,2109,-28.72619
25/03/2022 10:55,2021,1,WESTERN EUROPE-EU,GREECE,1,GATWICK,MIKONOS,23721,23721,0,24901,24901,0,-4.73877
25/03/2022 10:55,2021,1,WESTERN EUROPE-EU,GREECE,1,GATWICK,NEA ANCHIALOS,3104,3104,0,1346,1346,0,130.60921
25/03/2022 10:55,2021,1,WESTERN EUROPE-EU,GREECE,1,GATWICK,PREVEZA,27770,18630,9140,21565,18201,3364,28.77348
25/03/2022 10:55,2021,1,WESTERN EUROPE-EU,GREECE,1,GATWICK,RHODES,67837,37939,29898,85078,52445,32633,-20.26493
25/03/2022 10:55,2021,1,WESTERN EUROPE-EU,GREECE,1,GATWICK,SALONIKA,29939,27427,2512,45398,42260,3138,-34.05216
25/03/2022 10:55,2021,1,WESTERN EUROPE-EU,GREECE,1,GATWICK,SAMOS,1452,0,1452,0,0,0,0
25/03/2022 10:55,2021,1,WESTERN EUROPE-EU,GREECE,1,GATWICK,SKIATHOS,7736,0,7736,3890,0,3890,98.86889
25/03/2022 10:55,2021,1,WESTERN EUROPE-EU,GREECE,1,GATWICK,THIRA (SANTORINI),25739,23524,2215,21912,20165,1747,17.46532
25/03/2022 10:55,2021,1,WESTERN EUROPE-EU,GREECE,1,GATWICK,VOLOS NEA ANCHILOS,0,0,0,2310,2310,0,-100
25/03/2022 10:55,2021,1,WESTERN EUROPE-EU,GREECE,1,GATWICK,ZAKINTHOS,34065,19957,14108,26953,21672,5281,26.38667
25/03/2022 10:55,2021,1,WESTERN EUROPE-EU,GREECE,1,HEATHROW,ATHENS,369812,369717,95,287138,286550,588,28.79243
25/03/2022 10:55,2021,1,WESTERN EUROPE-EU,GREECE,1,HEATHROW,CHANIA,28938,28938,0,14944,14944,0,93.64293
25/03/2022 10:55,2021,1,WESTERN EUROPE-EU,GREECE,1,HEATHROW,CORFU,66134,66134,0,48748,48748,0,35.66505
25/03/2022 10:55,2021,1,WESTERN EUROPE-EU,GREECE,1,HEATHROW,HERAKLION,36239,36239,0,14178,14178,0,155.60023
25/03/2022 10:55,2021,1,WESTERN EUROPE-EU,GREECE,1,HEATHROW,KALAMATA,14715,14715,0,7519,7519,0,95.70422
25/03/2022 10:55,2021,1,WESTERN EUROPE-EU,GREECE,1,HEATHROW,KEFALLINIA,12855,12855,0,6921,6921,0,85.73906
25/03/2022 10:55,2021,1,WESTERN EUROPE-EU,GREECE,1,HEATHROW,KOS,17827,17827,0,12066,12066,0,47.74573
25/03/2022 10:55,2021,1,WESTERN EUROPE-EU,GREECE,1,HEATHROW,MIKONOS,43499,43499,0,16929,16929,0,156.94961
25/03/2022 10:55,2021,1,WESTERN EUROPE-EU,GREECE,1,HEATHROW,PREVEZA,21061,18413,2648,13479,10542,2937,56.25046
25/03/2022 10:55,2021,1,WESTERN EUROPE-EU,GREECE,1,HEATHROW,RHODES,22834,22834,0,15907,15907,0,43.54687
25/03/2022 10:55,2021,1,WESTERN EUROPE-EU,GREECE,1,HEATHROW,SALONIKA,48107,48107,0,18494,18437,57,160.1222
25/03/2022 10:55,2021,1,WESTERN EUROPE-EU,GREECE,1,HEATHROW,THIRA (SANTORINI),40531,40531,0,18300,18300,0,121.48087
25/03/2022 10:55,2021,1,WESTERN EUROPE-EU,GREECE,1,HEATHROW,ZAKINTHOS,7387,7387,0,4939,4939,0,49.56469
25/03/2022 10:55,2021,1,WESTERN EUROPE-EU,GREECE,1,LONDON CITY,MIKONOS,9047,9047,0,0,0,0,0
25/03/2022 10:55,2021,1,WESTERN EUROPE-EU,GREECE,1,LONDON CITY,SKIATHOS,3844,3844,0,0,0,0,0
25/03/2022 10:55,2021,1,WESTERN EUROPE-EU,GREECE,1,LUTON,ATHENS,61182,61182,0,85034,85034,0,-28.04996
25/03/2022 10:55,2021,1,WESTERN EUROPE-EU,GREECE,1,LUTON,CORFU,21790,21790,0,33854,33854,0,-35.63538
25/03/2022 10:55,2021,1,WESTERN EUROPE-EU,GREECE,1,LUTON,HERAKLION,18926,18926,0,20911,20911,0,-9.49261
25/03/2022 10:55,2021,1,WESTERN EUROPE-EU,GREECE,1,LUTON,MIKONOS,5871,5871,0,4038,4038,0,45.39376
25/03/2022 10:55,2021,1,WESTERN EUROPE-EU,GREECE,1,LUTON,RHODES,17734,10283,7451,18651,18651,0,-4.91663
25/03/2022 10:55,2021,1,WESTERN EUROPE-EU,GREECE,1,LUTON,SALONIKA,15356,15356,0,21954,21951,3,-30.05375
25/03/2022 10:55,2021,1,WESTERN EUROPE-EU,GREECE,1,LUTON,THIRA (SANTORINI),7627,7627,0,16584,16584,0,-54.00989
25/03/2022 10:55,2021,1,WESTERN EUROPE-EU,GREECE,1,LUTON,ZAKINTHOS,10282,10282,0,7591,7591,0,35.44987
25/03/2022 10:55,2021,1,WESTERN EUROPE-EU,GREECE,1,SOUTHEND,CORFU,11009,11009,0,6334,6334,0,73.80802
25/03/2022 10:55,2021,1,WESTERN EUROPE-EU,GREECE,1,SOUTHEND,KAVALA,42,42,0,0,0,0,0
25/03/2022 10:55,2021,1,WESTERN EUROPE-EU,GREECE,1,STANSTED,ATHENS,70981,70981,0,52337,51315,1022,35.62298
25/03/2022 10:55,2021,1,WESTERN EUROPE-EU,GREECE,1,STANSTED,CHANIA,28056,28056,0,9528,9528,0,194.45844
25/03/2022 10:55,2021,1,WESTERN EUROPE-EU,GREECE,1,STANSTED,CORFU,23513,23513,0,22690,19765,2925,3.62715
25/03/2022 10:55,2021,1,WESTERN EUROPE-EU,GREECE,1,STANSTED,HERAKLION,22732,16584,6148,12902,11129,1773,76.18974
25/03/2022 10:55,2021,1,WESTERN EUROPE-EU,GREECE,1,STANSTED,KALAMATA,3464,3464,0,2221,2221,0,55.96578
25/03/2022 10:55,2021,1,WESTERN EUROPE-EU,GREECE,1,STANSTED,KEFALLINIA,15974,13604,2370,12070,12033,37,32.34466
25/03/2022 10:55,2021,1,WESTERN EUROPE-EU,GREECE,1,STANSTED,KOS,10653,10653,0,15413,15413,0,-30.88302
25/03/2022 10:55,2021,1,WESTERN EUROPE-EU,GREECE,1,STANSTED,MYTILINI,4053,2003,2050,0,0,0,0
25/03/2022 10:55,2021,1,WESTERN EUROPE-EU,GREECE,1,STANSTED,PREVEZA,10142,10142,0,0,0,0,0
25/03/2022 10:55,2021,1,WESTERN EUROPE-EU,GREECE,1,STANSTED,RHODES,52360,43210,9150,24569,17515,7054,113.11409
25/03/2022 10:55,2021,1,WESTERN EUROPE-EU,GREECE,1,STANSTED,SALONIKA,51777,51765,12,40861,40861,0,26.71496
25/03/2022 10:55,2021,1,WESTERN EUROPE-EU,GREECE,1,STANSTED,SKIATHOS,5296,5296,0,5443,5443,0,-2.70072
25/03/2022 10:55,2021,1,WESTERN EUROPE-EU,GREECE,1,STANSTED,THIRA (SANTORINI),12103,12103,0,461,461,0,2525.37961
25/03/2022 10:55,2021,1,WESTERN EUROPE-EU,GREECE,1,STANSTED,ZAKINTHOS,19105,17359,1746,9719,9719,0,96.57372
25/03/2022 10:55,2021,1,WESTERN EUROPE-EU,GREECE,2,BELFAST INTERNATIONAL,CORFU,5329,5329,0,0,0,0,0
25/03/2022 10:55,2021,1,WESTERN EUROPE-EU,GREECE,2,BELFAST INTERNATIONAL,HERAKLION,2628,2628,0,0,0,0,0
25/03/2022 10:55,2021,1,WESTERN EUROPE-EU,GREECE,2,BELFAST INTERNATIONAL,RHODES,1753,1753,0,0,0,0,0
25/03/2022 10:55,2021,1,WESTERN EUROPE-EU,GREECE,2,BIGGIN HILL,ATHENS,79,0,79,52,0,52,51.92308
25/03/2022 10:55,2021,1,WESTERN EUROPE-EU,GREECE,2,BIGGIN HILL,CHANIA,2,0,2,0,0,0,0
25/03/2022 10:55,2021,1,WESTERN EUROPE-EU,GREECE,2,BIGGIN HILL,CORFU,9,0,9,0,0,0,0
25/03/2022 10:55,2021,1,WESTERN EUROPE-EU,GREECE,2,BIGGIN HILL,KEFALLINIA,12,0,12,0,0,0,0
25/03/2022 10:55,2021,1,WESTERN EUROPE-EU,GREECE,2,BIGGIN HILL,MIKONOS,0,0,0,4,0,4,-100
25/03/2022 10:55,2021,1,WESTERN EUROPE-EU,GREECE,2,BIGGIN HILL,PREVEZA,0,0,0,6,0,6,-100
25/03/2022 10:55,2021,1,WESTERN EUROPE-EU,GREECE,2,BIGGIN HILL,SALONIKA,2,0,2,16,0,16,-87.5
25/03/2022 10:55,2021,1,WESTERN EUROPE-EU,GREECE,2,BIRMINGHAM,ATHENS,314,0,314,148,0,148,112.16216
25/03/2022 10:55,2021,1,WESTERN EUROPE-EU,GREECE,2,BIRMINGHAM,CHANIA,9110,7642,1468,7973,7973,0,14.26063
25/03/2022 10:55,2021,1,WESTERN EUROPE-EU,GREECE,2,BIRMINGHAM,CORFU,32031,24937,7094,30618,20811,9807,4.61493
25/03/2022 10:55,2021,1,WESTERN EUROPE-EU,GREECE,2,BIRMINGHAM,HERAKLION,23912,14343,9569,14865,10136,4729,60.86108
25/03/2022 10:55,2021,1,WESTERN EUROPE-EU,GREECE,2,BIRMINGHAM,KALAMATA,1661,1661,0,0,0,0,0
25/03/2022 10:55,2021,1,WESTERN EUROPE-EU,GREECE,2,BIRMINGHAM,KEFALLINIA,8134,4293,3841,3265,384,2881,149.12711
25/03/2022 10:55,2021,1,WESTERN EUROPE-EU,GREECE,2,BIRMINGHAM,KOS,17828,8535,9293,24159,13758,10401,-26.20555
25/03/2022 10:55,2021,1,WESTERN EUROPE-EU,GREECE,2,BIRMINGHAM,MIKONOS,2,0,2,0,0,0,0
25/03/2022 10:55,2021,1,WESTERN EUROPE-EU,GREECE,2,BIRMINGHAM,PREVEZA,2949,2949,0,0,0,0,0
25/03/2022 10:55,2021,1,WESTERN EUROPE-EU,GREECE,2,BIRMINGHAM,RHODES,31923,17845,14078,35073,15790,19283,-8.98127
25/03/2022 10:55,2021,1,WESTERN EUROPE-EU,GREECE,2,BIRMINGHAM,SALONIKA,3954,2168,1786,3235,0,3235,22.22566
25/03/2022 10:55,2021,1,WESTERN EUROPE-EU,GREECE,2,BIRMINGHAM,SKIATHOS,8328,2724,5604,7477,4746,2731,11.38157
25/03/2022 10:55,2021,1,WESTERN EUROPE-EU,GREECE,2,BIRMINGHAM,THIRA (SANTORINI),5129,3621,1508,0,0,0,0
25/03/2022 10:55,2021,1,WESTERN EUROPE-EU,GREECE,2,BIRMINGHAM,ZAKINTHOS,22090,7289,14801,15479,8615,6864,42.70948
25/03/2022 10:55,2021,1,WESTERN EUROPE-EU,GREECE,2,BOURNEMOUTH,CORFU,5900,0,5900,2568,0,2568,129.75078
25/03/2022 10:55,2021,1,WESTERN EUROPE-EU,GREECE,2,BOURNEMOUTH,RHODES,4050,0,4050,0,0,0,0
25/03/2022 10:55,2021,1,WESTERN EUROPE-EU,GREECE,2,BRISTOL,ATHENS,5710,5710,0,16839,16839,0,-66.09062
25/03/2022 10:55,2021,1,WESTERN EUROPE-EU,GREECE,2,BRISTOL,CHANIA,6314,6314,0,5602,5602,0,12.70975
25/03/2022 10:55,2021,1,WESTERN EUROPE-EU,GREECE,2,BRISTOL,CORFU,20153,13334,6819,19579,13263,6316,2.93171
25/03/2022 10:55,2021,1,WESTERN EUROPE-EU,GREECE,2,BRISTOL,HERAKLION,16560,12600,3960,10225,5960,4265,61.95599
25/03/2022 10:55,2021,1,WESTERN EUROPE-EU,GREECE,2,BRISTOL,KEFALLINIA,8278,6387,1891,10125,7347,2778,-18.24198
25/03/2022 10:55,2021,1,WESTERN EUROPE-EU,GREECE,2,BRISTOL,KOS,17131,8614,8517,8285,0,8285,106.77127
25/03/2022 10:55,2021,1,WESTERN EUROPE-EU,GREECE,2,BRISTOL,MIKONOS,1565,1565,0,0,0,0,0
25/03/2022 10:55,2021,1,WESTERN EUROPE-EU,GREECE,2,BRISTOL,PREVEZA,5052,5052,0,0,0,0,0
25/03/2022 10:55,2021,1,WESTERN EUROPE-EU,GREECE,2,BRISTOL,RHODES,12010,9895,2115,16536,8499,8037,-27.37059
25/03/2022 10:55,2021,1,WESTERN EUROPE-EU,GREECE,2,BRISTOL,SKIATHOS,3360,2053,1307,0,0,0,0
25/03/2022 10:55,2021,1,WESTERN EUROPE-EU,GREECE,2,BRISTOL,THIRA (SANTORINI),2488,2488,0,0,0,0,0
25/03/2022 10:55,2021,1,WESTERN EUROPE-EU,GREECE,2,BRISTOL,ZAKINTHOS,13744,8357,5387,9669,5275,4394,42.145
25/03/2022 10:55,2021,1,WESTERN EUROPE-EU,GREECE,2,CARDIFF WALES,CORFU,1386,0,1386,2933,0,2933,-52.74463
25/03/2022 10:55,2021,1,WESTERN EUROPE-EU,GREECE,2,CARDIFF WALES,KOS,1164,0,1164,4787,0,4787,-75.68414
25/03/2022 10:55,2021,1,WESTERN EUROPE-EU,GREECE,2,CARDIFF WALES,PATRAS,24,0,24,0,0,0,0
25/03/2022 10:55,2021,1,WESTERN EUROPE-EU,GREECE,2,CARDIFF WALES,RHODES,6826,0,6826,6552,0,6552,4.18193
25/03/2022 10:55,2021,1,WESTERN EUROPE-EU,GREECE,2,CARDIFF WALES,ZAKINTHOS,0,0,0,1660,0,1660,-100
25/03/2022 10:55,2021,1,WESTERN EUROPE-EU,GREECE,2,DONCASTER SHEFFIELD,CORFU,6083,0,6083,5461,0,5461,11.38986
25/03/2022 10:55,2021,1,WESTERN EUROPE-EU,GREECE,2,DONCASTER SHEFFIELD,HERAKLION,2526,0,2526,0,0,0,0
25/03/2022 10:55,2021,1,WESTERN EUROPE-EU,GREECE,2,DONCASTER SHEFFIELD,KOS,0,0,0,4139,0,4139,-100
25/03/2022 10:55,2021,1,WESTERN EUROPE-EU,GREECE,2,DONCASTER SHEFFIELD,PREVEZA,7,0,7,0,0,0,0
25/03/2022 10:55,2021,1,WESTERN EUROPE-EU,GREECE,2,DONCASTER SHEFFIELD,RHODES,8380,0,8380,4207,0,4207,99.19182
25/03/2022 10:55,2021,1,WESTERN EUROPE-EU,GREECE,2,DONCASTER SHEFFIELD,SKIATHOS,6,0,6,0,0,0,0
25/03/2022 10:55,2021,1,WESTERN EUROPE-EU,GREECE,2,DONCASTER SHEFFIELD,ZAKINTHOS,4888,0,4888,1717,0,1717,184.68259
25/03/2022 10:55,2021,1,WESTERN EUROPE-EU,GREECE,2,EAST MIDLANDS INTERNATIONAL,ATHENS,0,0,0,110,0,110,-100
25/03/2022 10:55,2021,1,WESTERN EUROPE-EU,GREECE,2,EAST MIDLANDS INTERNATIONAL,CHANIA,3730,3730,0,3442,3442,0,8.36723
25/03/2022 10:55,2021,1,WESTERN EUROPE-EU,GREECE,2,EAST MIDLANDS INTERNATIONAL,CORFU,12762,12762,0,21303,17464,3839,-40.09294
25/03/2022 10:55,2021,1,WESTERN EUROPE-EU,GREECE,2,EAST MIDLANDS INTERNATIONAL,HERAKLION,10961,5311,5650,8385,6363,2022,30.72153
25/03/2022 10:55,2021,1,WESTERN EUROPE-EU,GREECE,2,EAST MIDLANDS INTERNATIONAL,KEFALLINIA,1128,1128,0,2795,2795,0,-59.64222
25/03/2022 10:55,2021,1,WESTERN EUROPE-EU,GREECE,2,EAST MIDLANDS INTERNATIONAL,KOS,11406,2925,8481,13933,5390,8543,-18.1368
25/03/2022 10:55,2021,1,WESTERN EUROPE-EU,GREECE,2,EAST MIDLANDS INTERNATIONAL,RHODES,20966,12836,8130,30531,23372,7159,-31.32881
25/03/2022 10:55,2021,1,WESTERN EUROPE-EU,GREECE,2,EAST MIDLANDS INTERNATIONAL,SKIATHOS,2311,1166,1145,0,0,0,0
25/03/2022 10:55,2021,1,WESTERN EUROPE-EU,GREECE,2,EAST MIDLANDS INTERNATIONAL,ZAKINTHOS,9262,5320,3942,9054,7285,1769,2.29733
25/03/2022 10:55,2021,1,WESTERN EUROPE-EU,GREECE,2,EDINBURGH,ATHENS,15457,15457,0,18636,18636,0,-17.05838
25/03/2022 10:55,2021,1,WESTERN EUROPE-EU,GREECE,2,EDINBURGH,CORFU,8642,8642,0,4623,4623,0,86.93489
25/03/2022 10:55,2021,1,WESTERN EUROPE-EU,GREECE,2,EDINBURGH,HERAKLION,9658,9658,0,7871,7871,0,22.7036
25/03/2022 10:55,2021,1,WESTERN EUROPE-EU,GREECE,2,EDINBURGH,KOS,807,807,0,0,0,0,0
25/03/2022 10:55,2021,1,WESTERN EUROPE-EU,GREECE,2,EDINBURGH,RHODES,3301,3301,0,3600,3600,0,-8.30556
25/03/2022 10:55,2021,1,WESTERN EUROPE-EU,GREECE,2,EXETER,CORFU,0,0,0,2903,0,2903,-100
25/03/2022 10:55,2021,1,WESTERN EUROPE-EU,GREECE,2,EXETER,HERAKLION,0,0,0,1306,0,1306,-100
25/03/2022 10:55,2021,1,WESTERN EUROPE-EU,GREECE,2,EXETER,RHODES,925,0,925,0,0,0,0
25/03/2022 10:55,2021,1,WESTERN EUROPE-EU,GREECE,2,EXETER,ZAKINTHOS,0,0,0,1415,0,1415,-100
25/03/2022 10:55,2021,1,WESTERN EUROPE-EU,GREECE,2,GLASGOW,ATHENS,0,0,0,153,153,0,-100
25/03/2022 10:55,2021,1,WESTERN EUROPE-EU,GREECE,2,GLASGOW,CORFU,1414,1414,0,6061,4236,1825,-76.67052
25/03/2022 10:55,2021,1,WESTERN EUROPE-EU,GREECE,2,GLASGOW,HERAKLION,4211,4211,0,6794,6794,0,-38.01884
25/03/2022 10:55,2021,1,WESTERN EUROPE-EU,GREECE,2,GLASGOW,KEFALLINIA,1029,1029,0,1963,1963,0,-47.58023
25/03/2022 10:55,2021,1,WESTERN EUROPE-EU,GREECE,2,GLASGOW,KOS,5451,5451,0,4326,4326,0,26.00555
25/03/2022 10:55,2021,1,WESTERN EUROPE-EU,GREECE,2,GLASGOW,RHODES,7109,4576,2533,8264,5872,2392,-13.97628
25/03/2022 10:55,2021,1,WESTERN EUROPE-EU,GREECE,2,GLASGOW,ZAKINTHOS,3037,1923,1114,4133,2309,1824,-26.51827
25/03/2022 10:55,2021,1,WESTERN EUROPE-EU,GREECE,2,LEEDS BRADFORD,CHANIA,5822,5822,0,2486,2486,0,134.19147
25/03/2022 10:55,2021,1,WESTERN EUROPE-EU,GREECE,2,LEEDS BRADFORD,CORFU,5904,5904,0,12752,12752,0,-53.70138
25/03/2022 10:55,2021,1,WESTERN EUROPE-EU,GREECE,2,LEEDS BRADFORD,HERAKLION,15403,15403,0,9626,9626,0,60.01454
25/03/2022 10:55,2021,1,WESTERN EUROPE-EU,GREECE,2,LEEDS BRADFORD,KEFALLINIA,3661,3661,0,6401,6401,0,-42.80581
25/03/2022 10:55,2021,1,WESTERN EUROPE-EU,GREECE,2,LEEDS BRADFORD,KOS,9108,9108,0,10261,10261,0,-11.23672
25/03/2022 10:55,2021,1,WESTERN EUROPE-EU,GREECE,2,LEEDS BRADFORD,RHODES,9335,9335,0,7803,7803,0,19.63347
25/03/2022 10:55,2021,1,WESTERN EUROPE-EU,GREECE,2,LEEDS BRADFORD,SKIATHOS,1157,1157,0,0,0,0,0
25/03/2022 10:55,2021,1,WESTERN EUROPE-EU,GREECE,2,LEEDS BRADFORD,THIRA (SANTORINI),731,731,0,0,0,0,0
25/03/2022 10:55,2021,1,WESTERN EUROPE-EU,GREECE,2,LEEDS BRADFORD,ZAKINTHOS,6680,6680,0,8576,8576,0,-22.10821
25/03/2022 10:55,2021,1,WESTERN EUROPE-EU,GREECE,2,LIVERPOOL (JOHN LENNON),ATHENS,95,95,0,69,69,0,37.68116
25/03/2022 10:55,2021,1,WESTERN EUROPE-EU,GREECE,2,LIVERPOOL (JOHN LENNON),CORFU,6253,6253,0,5661,5661,0,10.45752
25/03/2022 10:55,2021,1,WESTERN EUROPE-EU,GREECE,2,LIVERPOOL (JOHN LENNON),KOS,2880,2880,0,0,0,0,0
25/03/2022 10:55,2021,1,WESTERN EUROPE-EU,GREECE,2,LIVERPOOL (JOHN LENNON),RHODES,7166,7166,0,9350,9350,0,-23.35829
25/03/2022 10:55,2021,1,WESTERN EUROPE-EU,GREECE,2,LIVERPOOL (JOHN LENNON),ZAKINTHOS,3012,3012,0,4356,4356,0,-30.85399
25/03/2022 10:55,2021,1,WESTERN EUROPE-EU,GREECE,2,MANCHESTER,ATHENS,33462,33462,0,40021,39768,253,-16.3889
25/03/2022 10:55,2021,1,WESTERN EUROPE-EU,GREECE,2,MANCHESTER,CHANIA,23603,17479,6124,11606,9825,1781,103.36895
25/03/2022 10:55,2021,1,WESTERN EUROPE-EU,GREECE,2,MANCHESTER,CORFU,55538,40492,15046,66161,52433,13728,-16.05629
25/03/2022 10:55,2021,1,WESTERN EUROPE-EU,GREECE,2,MANCHESTER,HERAKLION,55533,33843,21690,37492,27756,9736,48.1196
25/03/2022 10:55,2021,1,WESTERN EUROPE-EU,GREECE,2,MANCHESTER,KALAMATA,2682,2682,0,5748,5748,0,-53.34029
25/03/2022 10:55,2021,1,WESTERN EUROPE-EU,GREECE,2,MANCHESTER,KAVALA,1521,0,1521,0,0,0,0
25/03/2022 10:55,2021,1,WESTERN EUROPE-EU,GREECE,2,MANCHESTER,KEFALLINIA,21662,16029,5633,19657,16703,2954,10.19993
25/03/2022 10:55,2021,1,WESTERN EUROPE-EU,GREECE,2,MANCHESTER,KOS,41653,24291,17362,44566,23003,21563,-6.53637
25/03/2022 10:55,2021,1,WESTERN EUROPE-EU,GREECE,2,MANCHESTER,MIKONOS,9033,9033,0,5241,5241,0,72.3526
25/03/2022 10:55,2021,1,WESTERN EUROPE-EU,GREECE,2,MANCHESTER,MYTILINI,2579,2579,0,0,0,0,0
25/03/2022 10:55,2021,1,WESTERN EUROPE-EU,GREECE,2,MANCHESTER,PREVEZA,12925,10616,2309,8583,8583,0,50.58837
25/03/2022 10:55,2021,1,WESTERN EUROPE-EU,GREECE,2,MANCHESTER,RHODES,65056,35541,29515,58736,35093,23643,10.76001
25/03/2022 10:55,2021,1,WESTERN EUROPE-EU,GREECE,2,MANCHESTER,SALONIKA,30584,28704,1880,32128,32128,0,-4.80578
25/03/2022 10:55,2021,1,WESTERN EUROPE-EU,GREECE,2,MANCHESTER,SKIATHOS,13187,5956,7231,14425,8244,6181,-8.58232
25/03/2022 10:55,2021,1,WESTERN EUROPE-EU,GREECE,2,MANCHESTER,THIRA (SANTORINI),27906,24264,3642,11266,9520,1746,147.70105
25/03/2022 10:55,2021,1,WESTERN EUROPE-EU,GREECE,2,MANCHESTER,ZAKINTHOS,29484,13386,16098,22035,12453,9582,33.80531
25/03/2022 10:55,2021,1,WESTERN EUROPE-EU,GREECE,2,NEWCASTLE,CORFU,11435,11435,0,14323,14323,0,-20.16337
25/03/2022 10:55,2021,1,WESTERN EUROPE-EU,GREECE,2,NEWCASTLE,HERAKLION,8902,8902,0,6084,6084,0,46.31821
25/03/2022 10:55,2021,1,WESTERN EUROPE-EU,GREECE,2,NEWCASTLE,KEFALLINIA,1622,1622,0,0,0,0,0
25/03/2022 10:55,2021,1,WESTERN EUROPE-EU,GREECE,2,NEWCASTLE,KOS,4971,4971,0,9733,9733,0,-48.92633
25/03/2022 10:55,2021,1,WESTERN EUROPE-EU,GREECE,2,NEWCASTLE,RHODES,12241,12241,0,17279,17279,0,-29.15678
25/03/2022 10:55,2021,1,WESTERN EUROPE-EU,GREECE,2,NEWCASTLE,SKIATHOS,2584,2584,0,0,0,0,0
25/03/2022 10:55,2021,1,WESTERN EUROPE-EU,GREECE,2,NEWCASTLE,THIRA (SANTORINI),981,981,0,0,0,0,0
25/03/2022 10:55,2021,1,WESTERN EUROPE-EU,GREECE,2,NEWCASTLE,ZAKINTHOS,10020,10020,0,6480,6480,0,54.62963
25/03/2022 10:55,2021,1,WESTERN EUROPE-EU,GREECE,2,NORWICH,CORFU,2575,0,2575,0,0,0,0
25/03/2022 10:55,2021,1,WESTERN EUROPE-EU,GREECE,2,SOUTHAMPTON,MIKONOS,409,409,0,0,0,0,0
25/03/2022 10:55,2021,1,WESTERN EUROPE-EU,GREECE,2,TEESSIDE INTERNATIONAL AIRPORT,CORFU,2120,2120,0,0,0,0,0
25/03/2022 10:55,2021,1,WESTERN EUROPE-EU,IRISH REPUBLIC,1,GATWICK,CORK,6126,6126,0,34456,34456,0,-82.2208
25/03/2022 10:55,2021,1,WESTERN EUROPE-EU,IRISH REPUBLIC,1,GATWICK,DUBLIN,319909,319850,59,342170,342170,0,-6.50583
25/03/2022 10:55,2021,1,WESTERN EUROPE-EU,IRISH REPUBLIC,1,GATWICK,IRELAND WEST(KNOCK),2115,2115,0,13228,13228,0,-84.01119
25/03/2022 10:55,2021,1,WESTERN EUROPE-EU,IRISH REPUBLIC,1,GATWICK,SHANNON,33642,33529,113,30494,30388,106,10.32334
25/03/2022 10:55,2021,1,WESTERN EUROPE-EU,IRISH REPUBLIC,1,HEATHROW,CORK,52235,52235,0,90972,90972,0,-42.58123
25/03/2022 10:55,2021,1,WESTERN EUROPE-EU,IRISH REPUBLIC,1,HEATHROW,DUBLIN,403547,403297,250,445222,444904,318,-9.3605
25/03/2022 10:55,2021,1,WESTERN EUROPE-EU,IRISH REPUBLIC,1,HEATHROW,SHANNON,24105,24105,0,45007,45007,0,-46.44166
25/03/2022 10:55,2021,1,WESTERN EUROPE-EU,IRISH REPUBLIC,1,LONDON CITY,DUBLIN,53442,53442,0,83321,83250,71,-35.86011
25/03/2022 10:55,2021,1,WESTERN EUROPE-EU,IRISH REPUBLIC,1,LUTON,CORK,17681,17681,0,19422,19422,0,-8.96406
25/03/2022 10:55,2021,1,WESTERN EUROPE-EU,IRISH REPUBLIC,1,LUTON,DUBLIN,85110,85110,0,93827,93801,26,-9.2905
25/03/2022 10:55,2021,1,WESTERN EUROPE-EU,IRISH REPUBLIC,1,LUTON,IRELAND WEST(KNOCK),38084,38084,0,31012,31012,0,22.80408
25/03/2022 10:55,2021,1,WESTERN EUROPE-EU,IRISH REPUBLIC,1,LUTON,KERRY COUNTY,35166,35166,0,26499,26499,0,32.70689
25/03/2022 10:55,2021,1,WESTERN EUROPE-EU,IRISH REPUBLIC,1,LUTON,SHANNON,6065,6065,0,122,122,0,4871.31148
25/03/2022 10:55,2021,1,WESTERN EUROPE-EU,IRISH REPUBLIC,1,SOUTHEND,DUBLIN,0,0,0,18868,18868,0,-100
25/03/2022 10:55,2021,1,WESTERN EUROPE-EU,IRISH REPUBLIC,1,STANSTED,CORK,40658,40658,0,84135,84135,0,-51.67528
25/03/2022 10:55,2021,1,WESTERN EUROPE-EU,IRISH REPUBLIC,1,STANSTED,DUBLIN,308546,308546,0,257548,257543,5,19.80136
25/03/2022 10:55,2021,1,WESTERN EUROPE-EU,IRISH REPUBLIC,1,STANSTED,IRELAND WEST(KNOCK),36506,36506,0,39091,39091,0,-6.61278
25/03/2022 10:55,2021,1,WESTERN EUROPE-EU,IRISH REPUBLIC,1,STANSTED,KERRY COUNTY,24259,24259,0,20629,20629,0,17.59659
25/03/2022 10:55,2021,1,WESTERN EUROPE-EU,IRISH REPUBLIC,1,STANSTED,SHANNON,63554,63548,6,49428,49428,0,28.57894
25/03/2022 10:55,2021,1,WESTERN EUROPE-EU,IRISH REPUBLIC,2,ABERDEEN,CORK,203,11,192,0,0,0,0
25/03/2022 10:55,2021,1,WESTERN EUROPE-EU,IRISH REPUBLIC,2,ABERDEEN,DUBLIN,3953,3953,0,6574,6574,0,-39.86918
25/03/2022 10:55,2021,1,WESTERN EUROPE-EU,IRISH REPUBLIC,2,ABERDEEN,WATERFORD,34,0,34,0,0,0,0
25/03/2022 10:55,2021,1,WESTERN EUROPE-EU,IRISH REPUBLIC,2,BELFAST INTERNATIONAL,DUBLIN,480,330,150,146,0,146,228.76712
25/03/2022 10:55,2021,1,WESTERN EUROPE-EU,IRISH REPUBLIC,2,BELFAST INTERNATIONAL,KERRY COUNTY,0,0,0,18,0,18,-100
25/03/2022 10:55,2021,1,WESTERN EUROPE-EU,IRISH REPUBLIC,2,BIGGIN HILL,DUBLIN,6,0,6,5,0,5,20
25/03/2022 10:55,2021,1,WESTERN EUROPE-EU,IRISH REPUBLIC,2,BIGGIN HILL,IRELAND WEST(KNOCK),13,0,13,0,0,0,0
25/03/2022 10:55,2021,1,WESTERN EUROPE-EU,IRISH REPUBLIC,2,BIRMINGHAM,CORK,1898,1898,0,14998,14998,0,-87.34498
25/03/2022 10:55,2021,1,WESTERN EUROPE-EU,IRISH REPUBLIC,2,BIRMINGHAM,DUBLIN,183805,183652,153,231896,231799,97,-20.73818
25/03/2022 10:55,2021,1,WESTERN EUROPE-EU,IRISH REPUBLIC,2,BIRMINGHAM,IRELAND WEST(KNOCK),7,0,7,2155,2155,0,-99.67517
25/03/2022 10:55,2021,1,WESTERN EUROPE-EU,IRISH REPUBLIC,2,BIRMINGHAM,SHANNON,3746,3519,227,6470,6470,0,-42.10201
25/03/2022 10:55,2021,1,WESTERN EUROPE-EU,IRISH REPUBLIC,2,BOURNEMOUTH,DUBLIN,4016,4016,0,14261,14261,0,-71.83928
25/03/2022 10:55,2021,1,WESTERN EUROPE-EU,IRISH REPUBLIC,2,BRISTOL,CORK,0,0,0,6847,6847,0,-100
25/03/2022 10:55,2021,1,WESTERN EUROPE-EU,IRISH REPUBLIC,2,BRISTOL,DUBLIN,106005,105901,104,106876,106876,0,-0.81496
25/03/2022 10:55,2021,1,WESTERN EUROPE-EU,IRISH REPUBLIC,2,BRISTOL,IRELAND WEST(KNOCK),10568,10568,0,10295,10295,0,2.65177
25/03/2022 10:55,2021,1,WESTERN EUROPE-EU,IRISH REPUBLIC,2,BRISTOL,SHANNON,0,0,0,91,0,91,-100
25/03/2022 10:55,2021,1,WESTERN EUROPE-EU,IRISH REPUBLIC,2,CARDIFF WALES,CORK,0,0,0,822,822,0,-100
25/03/2022 10:55,2021,1,WESTERN EUROPE-EU,IRISH REPUBLIC,2,CARDIFF WALES,DUBLIN,7870,7003,867,17111,15701,1410,-54.00619
25/03/2022 10:55,2021,1,WESTERN EUROPE-EU,IRISH REPUBLIC,2,CARDIFF WALES,SHANNON,1044,432,612,638,349,289,63.63636
25/03/2022 10:55,2021,1,WESTERN EUROPE-EU,IRISH REPUBLIC,2,DONCASTER SHEFFIELD,CORK,0,0,0,16,0,16,-100
25/03/2022 10:55,2021,1,WESTERN EUROPE-EU,IRISH REPUBLIC,2,DUNDEE,DUBLIN,9,0,9,0,0,0,0
25/03/2022 10:55,2021,1,WESTERN EUROPE-EU,IRISH REPUBLIC,2,EAST MIDLANDS INTERNATIONAL,DUBLIN,27247,27247,0,44341,44341,0,-38.55123
25/03/2022 10:55,2021,1,WESTERN EUROPE-EU,IRISH REPUBLIC,2,EAST MIDLANDS INTERNATIONAL,IRELAND WEST(KNOCK),12100,12100,0,15970,15970,0,-24.23294
25/03/2022 10:55,2021,1,WESTERN EUROPE-EU,IRISH REPUBLIC,2,EDINBURGH,CORK,2494,2494,0,9570,9570,0,-73.93939
25/03/2022 10:55,2021,1,WESTERN EUROPE-EU,IRISH REPUBLIC,2,EDINBURGH,DUBLIN,157626,157255,371,145995,145717,278,7.96671
25/03/2022 10:55,2021,1,WESTERN EUROPE-EU,IRISH REPUBLIC,2,EDINBURGH,IRELAND WEST(KNOCK),6292,6292,0,1916,1916,0,228.39248
25/03/2022 10:55,2021,1,WESTERN EUROPE-EU,IRISH REPUBLIC,2,EDINBURGH,SHANNON,5721,5584,137,3850,3637,213,48.5974
25/03/2022 10:55,2021,1,WESTERN EUROPE-EU,IRISH REPUBLIC,2,EXETER,DUBLIN,90,0,90,3179,3179,0,-97.16892
25/03/2022 10:55,2021,1,WESTERN EUROPE-EU,IRISH REPUBLIC,2,EXETER,SHANNON,91,0,91,0,0,0,0
25/03/2022 10:55,2021,1,WESTERN EUROPE-EU,IRISH REPUBLIC,2,GLASGOW,CORK,0,0,0,3756,3756,0,-100
25/03/2022 10:55,2021,1,WESTERN EUROPE-EU,IRISH REPUBLIC,2,GLASGOW,DONEGAL,1534,1534,0,2291,2291,0,-33.04234
25/03/2022 10:55,2021,1,WESTERN EUROPE-EU,IRISH REPUBLIC,2,GLASGOW,DUBLIN,94876,94577,299,111910,111754,156,-15.22116
25/03/2022 10:55,2021,1,WESTERN EUROPE-EU,IRISH REPUBLIC,2,GLASGOW,SHANNON,45,0,45,127,0,127,-64.56693
25/03/2022 10:55,2021,1,WESTERN EUROPE-EU,IRISH REPUBLIC,2,GUERNSEY,DUBLIN,37,0,37,0,0,0,0
25/03/2022 10:55,2021,1,WESTERN EUROPE-EU,IRISH REPUBLIC,2,INVERNESS,DUBLIN,0,0,0,1145,1145,0,-100
25/03/2022 10:55,2021,1,WESTERN EUROPE-EU,IRISH REPUBLIC,2,ISLE OF MAN,DUBLIN,0,0,0,7496,7496,0,-100
25/03/2022 10:55,2021,1,WESTERN EUROPE-EU,IRISH REPUBLIC,2,JERSEY,DUBLIN,95,53,42,0,0,0,0
25/03/2022 10:55,2021,1,WESTERN EUROPE-EU,IRISH REPUBLIC,2,LEEDS BRADFORD,DUBLIN,41371,41371,0,68478,68478,0,-39.58498
25/03/2022 10:55,2021,1,WESTERN EUROPE-EU,IRISH REPUBLIC,2,LIVERPOOL (JOHN LENNON),CORK,9781,9781,0,20125,20125,0,-51.39876
25/03/2022 10:55,2021,1,WESTERN EUROPE-EU,IRISH REPUBLIC,2,LIVERPOOL (JOHN LENNON),DUBLIN,72061,71987,74,85011,85011,0,-15.23332
25/03/2022 10:55,2021,1,WESTERN EUROPE-EU,IRISH REPUBLIC,2,LIVERPOOL (JOHN LENNON),IRELAND WEST(KNOCK),29866,29866,0,25050,25050,0,19.22555
25/03/2022 10:55,2021,1,WESTERN EUROPE-EU,IRISH REPUBLIC,2,MANCHESTER,CORK,2508,2508,0,19968,19968,0,-87.4399
25/03/2022 10:55,2021,1,WESTERN EUROPE-EU,IRISH REPUBLIC,2,MANCHESTER,DUBLIN,250163,250137,26,254637,254355,282,-1.75701
25/03/2022 10:55,2021,1,WESTERN EUROPE-EU,IRISH REPUBLIC,2,MANCHESTER,IRELAND WEST(KNOCK),8219,8219,0,3601,3601,0,128.24215
25/03/2022 10:55,2021,1,WESTERN EUROPE-EU,IRISH REPUBLIC,2,MANCHESTER,KERRY COUNTY,10924,10924,0,1155,1155,0,845.80087
25/03/2022 10:55,2021,1,WESTERN EUROPE-EU,IRISH REPUBLIC,2,MANCHESTER,SHANNON,17168,17168,0,23073,23073,0,-25.59268
25/03/2022 10:55,2021,1,WESTERN EUROPE-EU,IRISH REPUBLIC,2,NEWCASTLE,DUBLIN,41775,41775,0,47607,47607,0,-12.2503
25/03/2022 10:55,2021,1,WESTERN EUROPE-EU,IRISH REPUBLIC,2,NEWQUAY,DUBLIN,56,56,0,3985,3985,0,-98.59473
25/03/2022 10:55,2021,1,WESTERN EUROPE-EU,IRISH REPUBLIC,2,SOUTHAMPTON,DUBLIN,7636,7636,0,17931,17906,25,-57.41453
25/03/2022 10:55,2021,1,WESTERN EUROPE-EU,IRISH REPUBLIC,2,TEESSIDE INTERNATIONAL AIRPORT,DUBLIN,0,0,0,81,81,0,-100
25/03/2022 10:55,2021,1,WESTERN EUROPE-EU,ITALY,1,GATWICK,ANCONA,0,0,0,3724,3724,0,-100
25/03/2022 10:55,2021,1,WESTERN EUROPE-EU,ITALY,1,GATWICK,BARI (PALESE),3747,3747,0,12883,12883,0,-70.91516
25/03/2022 10:55,2021,1,WESTERN EUROPE-EU,ITALY,1,GATWICK,BERGAMO,2536,2493,43,10695,10695,0,-76.28799
25/03/2022 10:55,2021,1,WESTERN EUROPE-EU,ITALY,1,GATWICK,BOLOGNA,140,140,0,11766,11766,0,-98.81013
25/03/2022 10:55,2021,1,WESTERN EUROPE-EU,ITALY,1,GATWICK,CAGLIARI (ELMAS),1273,1273,0,0,0,0,0
25/03/2022 10:55,2021,1,WESTERN EUROPE-EU,ITALY,1,GATWICK,CATANIA (FONTANAROSSA),22126,22126,0,35455,35455,0,-37.59413
25/03/2022 10:55,2021,1,WESTERN EUROPE-EU,ITALY,1,GATWICK,FLORENCE,21265,21265,0,26380,26380,0,-19.38969
25/03/2022 10:55,2021,1,WESTERN EUROPE-EU,ITALY,1,GATWICK,GENOA,0,0,0,7262,7262,0,-100
25/03/2022 10:55,2021,1,WESTERN EUROPE-EU,ITALY,1,GATWICK,MILAN (LINATE),16905,16905,0,51505,51505,0,-67.17794
25/03/2022 10:55,2021,1,WESTERN EUROPE-EU,ITALY,1,GATWICK,MILAN (MALPENSA),62005,61635,370,111380,111061,319,-44.33022
25/03/2022 10:55,2021,1,WESTERN EUROPE-EU,ITALY,1,GATWICK,NAPLES,26495,26495,0,60128,57960,2168,-55.93567
25/03/2022 10:55,2021,1,WESTERN EUROPE-EU,ITALY,1,GATWICK,OLBIA,11793,11623,170,15197,15197,0,-22.39916
25/03/2022 10:55,2021,1,WESTERN EUROPE-EU,ITALY,1,GATWICK,PALERMO,2886,2886,0,18837,18837,0,-84.67909
25/03/2022 10:55,2021,1,WESTERN EUROPE-EU,ITALY,1,GATWICK,PISA,17867,17867,0,33542,33542,0,-46.73245
25/03/2022 10:55,2021,1,WESTERN EUROPE-EU,ITALY,1,GATWICK,ROME (CIAMPINO),90,0,90,0,0,0,0
25/03/2022 10:55,2021,1,WESTERN EUROPE-EU,ITALY,1,GATWICK,ROME (FIUMICINO),46743,46343,400,159284,159116,168,-70.6543
25/03/2022 10:55,2021,1,WESTERN EUROPE-EU,ITALY,1,GATWICK,TURIN,4234,2350,1884,67029,56860,10169,-93.68333
25/03/2022 10:55,2021,1,WESTERN EUROPE-EU,ITALY,1,GATWICK,VENICE,18538,18538,0,106409,106409,0,-82.57854
25/03/2022 10:55,2021,1,WESTERN EUROPE-EU,ITALY,1,GATWICK,VERONA VILLAFRANCA,8990,8485,505,36050,32600,3450,-75.06241
25/03/2022 10:55,2021,1,WESTERN EUROPE-EU,ITALY,1,HEATHROW,BARI (PALESE),6406,6406,0,14289,14289,0,-55.16831
25/03/2022 10:55,2021,1,WESTERN EUROPE-EU,ITALY,1,HEATHROW,BERGAMO,11,0,11,0,0,0,0
25/03/2022 10:55,2021,1,WESTERN EUROPE-EU,ITALY,1,HEATHROW,BOLOGNA,29723,29651,72,73953,73875,78,-59.80826
25/03/2022 10:55,2021,1,WESTERN EUROPE-EU,ITALY,1,HEATHROW,BRINDISI,0,0,0,12389,12389,0,-100
25/03/2022 10:55,2021,1,WESTERN EUROPE-EU,ITALY,1,HEATHROW,CAGLIARI (ELMAS),0,0,0,11067,11067,0,-100
25/03/2022 10:55,2021,1,WESTERN EUROPE-EU,ITALY,1,HEATHROW,CATANIA (FONTANAROSSA),9651,9473,178,19360,19360,0,-50.14979
25/03/2022 10:55,2021,1,WESTERN EUROPE-EU,ITALY,1,HEATHROW,GENOA,0,0,0,910,910,0,-100
25/03/2022 10:55,2021,1,WESTERN EUROPE-EU,ITALY,1,HEATHROW,MILAN (LINATE),160191,160191,0,145055,145055,0,10.43466
25/03/2022 10:55,2021,1,WESTERN EUROPE-EU,ITALY,1,HEATHROW,MILAN (MALPENSA),41956,41275,681,76775,76775,0,-45.352
25/03/2022 10:55,2021,1,WESTERN EUROPE-EU,ITALY,1,HEATHROW,NAPLES,40833,40737,96,47050,47050,0,-13.2136
25/03/2022 10:55,2021,1,WESTERN EUROPE-EU,ITALY,1,HEATHROW,OLBIA,0,0,0,11393,11393,0,-100
25/03/2022 10:55,2021,1,WESTERN EUROPE-EU,ITALY,1,HEATHROW,PALERMO,1758,1593,165,20092,20092,0,-91.25025
25/03/2022 10:55,2021,1,WESTERN EUROPE-EU,ITALY,1,HEATHROW,PISA,32516,32516,0,56375,56375,0,-42.32195
25/03/2022 10:55,2021,1,WESTERN EUROPE-EU,ITALY,1,HEATHROW,RIMINI,88,0,88,104,104,0,-15.38462
25/03/2022 10:55,2021,1,WESTERN EUROPE-EU,ITALY,1,HEATHROW,ROME (FIUMICINO),191253,190943,310,305724,305626,98,-37.4426
25/03/2022 10:55,2021,1,WESTERN EUROPE-EU,ITALY,1,HEATHROW,TURIN,3382,3174,208,13363,13363,0,-74.69131
25/03/2022 10:55,2021,1,WESTERN EUROPE-EU,ITALY,1,HEATHROW,VENICE,68228,68228,0,74151,74151,0,-7.98775
25/03/2022 10:55,2021,1,WESTERN EUROPE-EU,ITALY,1,HEATHROW,VERONA VILLAFRANCA,1023,1023,0,17859,17859,0,-94.2718
25/03/2022 10:55,2021,1,WESTERN EUROPE-EU,ITALY,1,LONDON CITY,BOLOGNA,0,0,0,98,98,0,-100
25/03/2022 10:55,2021,1,WESTERN EUROPE-EU,ITALY,1,LONDON CITY,FLORENCE,17999,17999,0,31736,31616,120,-43.28523
25/03/2022 10:55,2021,1,WESTERN EUROPE-EU,ITALY,1,LONDON CITY,MILAN (LINATE),0,0,0,53274,53205,69,-100
25/03/2022 10:55,2021,1,WESTERN EUROPE-EU,ITALY,1,LONDON CITY,PISA,0,0,0,58,58,0,-100
25/03/2022 10:55,2021,1,WESTERN EUROPE-EU,ITALY,1,LONDON CITY,ROME (FIUMICINO),0,0,0,6011,6011,0,-100
25/03/2022 10:55,2021,1,WESTERN EUROPE-EU,ITALY,1,LUTON,ALGHERO (FERTILIA),0,0,0,7287,7287,0,-100
25/03/2022 10:55,2021,1,WESTERN EUROPE-EU,ITALY,1,LUTON,BOLOGNA,10335,10335,0,29142,29142,0,-64.53572
25/03/2022 10:55,2021,1,WESTERN EUROPE-EU,ITALY,1,LUTON,CATANIA (FONTANAROSSA),10552,10552,0,21386,21386,0,-50.65931
25/03/2022 10:55,2021,1,WESTERN EUROPE-EU,ITALY,1,LUTON,FLORENCE,0,0,0,2029,2029,0,-100
25/03/2022 10:55,2021,1,WESTERN EUROPE-EU,ITALY,1,LUTON,MILAN (MALPENSA),46496,46496,0,108728,108728,0,-57.23641
25/03/2022 10:55,2021,1,WESTERN EUROPE-EU,ITALY,1,LUTON,NAPLES,28529,28529,0,23282,23282,0,22.53672
25/03/2022 10:55,2021,1,WESTERN EUROPE-EU,ITALY,1,LUTON,OLBIA,0,0,0,5225,5225,0,-100
25/03/2022 10:55,2021,1,WESTERN EUROPE-EU,ITALY,1,LUTON,PALERMO,8269,8269,0,7429,7429,0,11.30704
25/03/2022 10:55,2021,1,WESTERN EUROPE-EU,ITALY,1,LUTON,PISA,95,95,0,6542,6542,0,-98.54784
25/03/2022 10:55,2021,1,WESTERN EUROPE-EU,ITALY,1,LUTON,RIMINI,295,0,295,0,0,0,0
25/03/2022 10:55,2021,1,WESTERN EUROPE-EU,ITALY,1,LUTON,ROME (FIUMICINO),15017,14779,238,12049,12049,0,24.63275
25/03/2022 10:55,2021,1,WESTERN EUROPE-EU,ITALY,1,LUTON,TURIN,594,594,0,2766,2766,0,-78.52495
25/03/2022 10:55,2021,1,WESTERN EUROPE-EU,ITALY,1,LUTON,VENICE,0,0,0,18097,18097,0,-100
25/03/2022 10:55,2021,1,WESTERN EUROPE-EU,ITALY,1,SOUTHEND,BERGAMO,0,0,0,5595,5595,0,-100
25/03/2022 10:55,2021,1,WESTERN EUROPE-EU,ITALY,1,SOUTHEND,TREVISO,0,0,0,6732,6732,0,-100
25/03/2022 10:55,2021,1,WESTERN EUROPE-EU,ITALY,1,SOUTHEND,TURIN,0,0,0,301,301,0,-100
25/03/2022 10:55,2021,1,WESTERN EUROPE-EU,ITALY,1,SOUTHEND,VENICE,0,0,0,1920,1920,0,-100
25/03/2022 10:55,2021,1,WESTERN EUROPE-EU,ITALY,1,SOUTHEND,VERONA VILLAFRANCA,0,0,0,259,259,0,-100
25/03/2022 10:55,2021,1,WESTERN EUROPE-EU,ITALY,1,STANSTED,ALGHERO (FERTILIA),10038,10038,0,7113,7113,0,41.12189
25/03/2022 10:55,2021,1,WESTERN EUROPE-EU,ITALY,1,STANSTED,ANCONA,25720,25720,0,30056,30056,0,-14.4264
25/03/2022 10:55,2021,1,WESTERN EUROPE-EU,ITALY,1,STANSTED,BARI (PALESE),41572,41572,0,38871,38871,0,6.94862
25/03/2022 10:55,2021,1,WESTERN EUROPE-EU,ITALY,1,STANSTED,BERGAMO,125359,125359,0,125102,125093,9,0.20543
25/03/2022 10:55,2021,1,WESTERN EUROPE-EU,ITALY,1,STANSTED,BOLOGNA,48416,48416,0,58842,58842,0,-17.71864
25/03/2022 10:55,2021,1,WESTERN EUROPE-EU,ITALY,1,STANSTED,BRINDISI,22872,22872,0,28799,28799,0,-20.58058
25/03/2022 10:55,2021,1,WESTERN EUROPE-EU,ITALY,1,STANSTED,CAGLIARI (ELMAS),16973,16973,0,40184,40184,0,-57.7618
25/03/2022 10:55,2021,1,WESTERN EUROPE-EU,ITALY,1,STANSTED,GENOA,20228,20228,0,22141,22141,0,-8.64008
25/03/2022 10:55,2021,1,WESTERN EUROPE-EU,ITALY,1,STANSTED,LAMETIA-TERME,16527,16527,0,19601,19601,0,-15.68287
25/03/2022 10:55,2021,1,WESTERN EUROPE-EU,ITALY,1,STANSTED,MILAN (MALPENSA),74845,74845,0,73680,73680,0,1.58116
25/03/2022 10:55,2021,1,WESTERN EUROPE-EU,ITALY,1,STANSTED,NAPLES,52859,52859,0,69535,69535,0,-23.98217
25/03/2022 10:55,2021,1,WESTERN EUROPE-EU,ITALY,1,STANSTED,PALERMO,44772,44772,0,42308,42308,0,5.82396
25/03/2022 10:55,2021,1,WESTERN EUROPE-EU,ITALY,1,STANSTED,PERUGIA,22837,22837,0,27189,27189,0,-16.00647
25/03/2022 10:55,2021,1,WESTERN EUROPE-EU,ITALY,1,STANSTED,PESCARA,24831,24831,0,29638,29638,0,-16.21904
25/03/2022 10:55,2021,1,WESTERN EUROPE-EU,ITALY,1,STANSTED,PISA,63039,63039,0,82582,82582,0,-23.66496
25/03/2022 10:55,2021,1,WESTERN EUROPE-EU,ITALY,1,STANSTED,RIMINI,4522,4522,0,5152,5152,0,-12.22826
25/03/2022 10:55,2021,1,WESTERN EUROPE-EU,ITALY,1,STANSTED,ROME (CIAMPINO),120411,120411,0,155550,155550,0,-22.59016
25/03/2022 10:55,2021,1,WESTERN EUROPE-EU,ITALY,1,STANSTED,ROME (FIUMICINO),542,542,0,75,0,75,622.66667
25/03/2022 10:55,2021,1,WESTERN EUROPE-EU,ITALY,1,STANSTED,TRAPANI,612,612,0,0,0,0,0
25/03/2022 10:55,2021,1,WESTERN EUROPE-EU,ITALY,1,STANSTED,TREVISO,32153,32153,0,243,243,0,13131.68724
25/03/2022 10:55,2021,1,WESTERN EUROPE-EU,ITALY,1,STANSTED,TRIESTE (RONCHI DEI LEGIONARI),13445,13445,0,19416,19416,0,-30.75299
25/03/2022 10:55,2021,1,WESTERN EUROPE-EU,ITALY,1,STANSTED,TURIN,40948,40501,447,42408,39008,3400,-3.44275
25/03/2022 10:55,2021,1,WESTERN EUROPE-EU,ITALY,1,STANSTED,VENICE,64827,64827,0,84483,84483,0,-23.26622
25/03/2022 10:55,2021,1,WESTERN EUROPE-EU,ITALY,1,STANSTED,VERONA VILLAFRANCA,15866,15866,0,17463,16849,614,-9.14505
25/03/2022 10:55,2021,1,WESTERN EUROPE-EU,ITALY,2,ABERDEEN,CATANIA (FONTANAROSSA),40,0,40,0,0,0,0
25/03/2022 10:55,2021,1,WESTERN EUROPE-EU,ITALY,2,BELFAST CITY (GEORGE BEST),BERGAMO,605,605,0,0,0,0,0
25/03/2022 10:55,2021,1,WESTERN EUROPE-EU,ITALY,2,BELFAST INTERNATIONAL,BERGAMO,1064,1064,0,6442,6442,0,-83.48339
25/03/2022 10:55,2021,1,WESTERN EUROPE-EU,ITALY,2,BELFAST INTERNATIONAL,PARMA,268,0,268,0,0,0,0
25/03/2022 10:55,2021,1,WESTERN EUROPE-EU,ITALY,2,BELFAST INTERNATIONAL,RIMINI,0,0,0,78,0,78,-100
25/03/2022 10:55,2021,1,WESTERN EUROPE-EU,ITALY,2,BELFAST INTERNATIONAL,TREVISO,43,43,0,0,0,0,0
25/03/2022 10:55,2021,1,WESTERN EUROPE-EU,ITALY,2,BELFAST INTERNATIONAL,VENICE,43,43,0,1835,1757,78,-97.65668
25/03/2022 10:55,2021,1,WESTERN EUROPE-EU,ITALY,2,BELFAST INTERNATIONAL,VERONA VILLAFRANCA,0,0,0,3002,0,3002,-100
25/03/2022 10:55,2021,1,WESTERN EUROPE-EU,ITALY,2,BIGGIN HILL,ALBENGA,12,0,12,0,0,0,0
25/03/2022 10:55,2021,1,WESTERN EUROPE-EU,ITALY,2,BIGGIN HILL,BARI (PALESE),4,0,4,0,0,0,0
25/03/2022 10:55,2021,1,WESTERN EUROPE-EU,ITALY,2,BIGGIN HILL,BERGAMO,95,0,95,0,0,0,0
25/03/2022 10:55,2021,1,WESTERN EUROPE-EU,ITALY,2,BIGGIN HILL,BRINDISI,0,0,0,13,0,13,-100
25/03/2022 10:55,2021,1,WESTERN EUROPE-EU,ITALY,2,BIGGIN HILL,CAGLIARI (ELMAS),0,0,0,17,0,17,-100
25/03/2022 10:55,2021,1,WESTERN EUROPE-EU,ITALY,2,BIGGIN HILL,CATANIA (FONTANAROSSA),9,0,9,6,0,6,50
25/03/2022 10:55,2021,1,WESTERN EUROPE-EU,ITALY,2,BIGGIN HILL,CUNEO,0,0,0,4,0,4,-100
25/03/2022 10:55,2021,1,WESTERN EUROPE-EU,ITALY,2,BIGGIN HILL,FLORENCE,22,0,22,3,0,3,633.33333
25/03/2022 10:55,2021,1,WESTERN EUROPE-EU,ITALY,2,BIGGIN HILL,GENOA,9,0,9,14,0,14,-35.71429
25/03/2022 10:55,2021,1,WESTERN EUROPE-EU,ITALY,2,BIGGIN HILL,MILAN (LINATE),16,0,16,31,0,31,-48.3871
25/03/2022 10:55,2021,1,WESTERN EUROPE-EU,ITALY,2,BIGGIN HILL,MILAN (MALPENSA),11,0,11,0,0,0,0
25/03/2022 10:55,2021,1,WESTERN EUROPE-EU,ITALY,2,BIGGIN HILL,NAPLES,21,0,21,113,0,113,-81.41593
25/03/2022 10:55,2021,1,WESTERN EUROPE-EU,ITALY,2,BIGGIN HILL,OLBIA,13,0,13,19,0,19,-31.57895
25/03/2022 10:55,2021,1,WESTERN EUROPE-EU,ITALY,2,BIGGIN HILL,PERUGIA,10,0,10,15,0,15,-33.33333
25/03/2022 10:55,2021,1,WESTERN EUROPE-EU,ITALY,2,BIGGIN HILL,PISA,0,0,0,2,0,2,-100
25/03/2022 10:55,2021,1,WESTERN EUROPE-EU,ITALY,2,BIGGIN HILL,ROME (CIAMPINO),25,0,25,4,0,4,525
25/03/2022 10:55,2021,1,WESTERN EUROPE-EU,ITALY,2,BIGGIN HILL,ROME (FIUMICINO),0,0,0,68,0,68,-100
25/03/2022 10:55,2021,1,WESTERN EUROPE-EU,ITALY,2,BIGGIN HILL,VENICE,7,0,7,5,0,5,40
25/03/2022 10:55,2021,1,WESTERN EUROPE-EU,ITALY,2,BIGGIN HILL,VERONA VILLAFRANCA,2,0,2,0,0,0,0
25/03/2022 10:55,2021,1,WESTERN EUROPE-EU,ITALY,2,BIRMINGHAM,BERGAMO,4248,4248,0,0,0,0,0
25/03/2022 10:55,2021,1,WESTERN EUROPE-EU,ITALY,2,BIRMINGHAM,BOLOGNA,756,0,756,335,0,335,125.67164
25/03/2022 10:55,2021,1,WESTERN EUROPE-EU,ITALY,2,BIRMINGHAM,MILAN (MALPENSA),568,0,568,1766,1766,0,-67.83692
25/03/2022 10:55,2021,1,WESTERN EUROPE-EU,ITALY,2,BIRMINGHAM,NAPLES,200,0,200,0,0,0,0
25/03/2022 10:55,2021,1,WESTERN EUROPE-EU,ITALY,2,BIRMINGHAM,ROME (FIUMICINO),121,0,121,12268,12268,0,-99.01369
25/03/2022 10:55,2021,1,WESTERN EUROPE-EU,ITALY,2,BIRMINGHAM,TURIN,943,468,475,9282,4989,4293,-89.84055
25/03/2022 10:55,2021,1,WESTERN EUROPE-EU,ITALY,2,BIRMINGHAM,VENICE,0,0,0,1510,1510,0,-100
25/03/2022 10:55,2021,1,WESTERN EUROPE-EU,ITALY,2,BIRMINGHAM,VERONA VILLAFRANCA,8793,8625,168,15407,11183,4224,-42.92854
25/03/2022 10:55,2021,1,WESTERN EUROPE-EU,ITALY,2,BRISTOL,BERGAMO,9262,9262,0,14376,14376,0,-35.57318
25/03/2022 10:55,2021,1,WESTERN EUROPE-EU,ITALY,2,BRISTOL,BOLOGNA,0,0,0,3947,3947,0,-100
25/03/2022 10:55,2021,1,WESTERN EUROPE-EU,ITALY,2,BRISTOL,CATANIA (FONTANAROSSA),1479,1479,0,8843,8843,0,-83.27491
25/03/2022 10:55,2021,1,WESTERN EUROPE-EU,ITALY,2,BRISTOL,MILAN (MALPENSA),6664,6664,0,18057,18057,0,-63.09464
25/03/2022 10:55,2021,1,WESTERN EUROPE-EU,ITALY,2,BRISTOL,NAPLES,3676,3676,0,8758,8758,0,-58.02695
25/03/2022 10:55,2021,1,WESTERN EUROPE-EU,ITALY,2,BRISTOL,OLBIA,1082,1082,0,4507,4507,0,-75.9929
25/03/2022 10:55,2021,1,WESTERN EUROPE-EU,ITALY,2,BRISTOL,PARMA,88,0,88,0,0,0,0
25/03/2022 10:55,2021,1,WESTERN EUROPE-EU,ITALY,2,BRISTOL,PISA,3380,3380,0,9032,9032,0,-62.5775
25/03/2022 10:55,2021,1,WESTERN EUROPE-EU,ITALY,2,BRISTOL,ROME (FIUMICINO),5074,5074,0,21434,21434,0,-76.32733
25/03/2022 10:55,2021,1,WESTERN EUROPE-EU,ITALY,2,BRISTOL,TREVISO,2742,2742,0,115,115,0,2284.34783
25/03/2022 10:55,2021,1,WESTERN EUROPE-EU,ITALY,2,BRISTOL,TURIN,885,764,121,8234,4840,3394,-89.25188
25/03/2022 10:55,2021,1,WESTERN EUROPE-EU,ITALY,2,BRISTOL,VENICE,991,991,0,32602,32602,0,-96.96031
25/03/2022 10:55,2021,1,WESTERN EUROPE-EU,ITALY,2,BRISTOL,VERONA VILLAFRANCA,400,0,400,3343,0,3343,-88.0347
25/03/2022 10:55,2021,1,WESTERN EUROPE-EU,ITALY,2,CARDIFF WALES,BOLOGNA,51,51,0,37,37,0,37.83784
25/03/2022 10:55,2021,1,WESTERN EUROPE-EU,ITALY,2,CARDIFF WALES,PARMA,307,221,86,299,299,0,2.67559
25/03/2022 10:55,2021,1,WESTERN EUROPE-EU,ITALY,2,CARDIFF WALES,ROME (FIUMICINO),236,0,236,91,91,0,159.34066
25/03/2022 10:55,2021,1,WESTERN EUROPE-EU,ITALY,2,CARDIFF WALES,TREVISO,138,44,94,0,0,0,0
25/03/2022 10:55,2021,1,WESTERN EUROPE-EU,ITALY,2,CARDIFF WALES,VENICE,274,224,50,298,175,123,-8.05369
25/03/2022 10:55,2021,1,WESTERN EUROPE-EU,ITALY,2,EAST MIDLANDS INTERNATIONAL,BERGAMO,10484,10484,0,17497,17497,0,-40.08116
25/03/2022 10:55,2021,1,WESTERN EUROPE-EU,ITALY,2,EAST MIDLANDS INTERNATIONAL,PISA,2557,2557,0,7360,7360,0,-65.25815
25/03/2022 10:55,2021,1,WESTERN EUROPE-EU,ITALY,2,EAST MIDLANDS INTERNATIONAL,ROME (CIAMPINO),2552,2552,0,7131,7131,0,-64.21259
25/03/2022 10:55,2021,1,WESTERN EUROPE-EU,ITALY,2,EAST MIDLANDS INTERNATIONAL,TREVISO,4501,4501,0,5094,5094,0,-11.64115
25/03/2022 10:55,2021,1,WESTERN EUROPE-EU,ITALY,2,EAST MIDLANDS INTERNATIONAL,VENICE,0,0,0,6881,6881,0,-100
25/03/2022 10:55,2021,1,WESTERN EUROPE-EU,ITALY,2,EDINBURGH,BERGAMO,27317,27317,0,37175,37175,0,-26.51782
25/03/2022 10:55,2021,1,WESTERN EUROPE-EU,ITALY,2,EDINBURGH,BOLOGNA,2888,2888,0,11460,11460,0,-74.7993
25/03/2022 10:55,2021,1,WESTERN EUROPE-EU,ITALY,2,EDINBURGH,MILAN (MALPENSA),1251,1251,0,24695,24616,79,-94.9342
25/03/2022 10:55,2021,1,WESTERN EUROPE-EU,ITALY,2,EDINBURGH,NAPLES,5247,5247,0,7994,7994,0,-34.36327
25/03/2022 10:55,2021,1,WESTERN EUROPE-EU,ITALY,2,EDINBURGH,PALERMO,1794,1794,0,0,0,0,0
25/03/2022 10:55,2021,1,WESTERN EUROPE-EU,ITALY,2,EDINBURGH,PARMA,353,0,353,0,0,0,0
25/03/2022 10:55,2021,1,WESTERN EUROPE-EU,ITALY,2,EDINBURGH,PISA,5264,5264,0,5691,5576,115,-7.50308
25/03/2022 10:55,2021,1,WESTERN EUROPE-EU,ITALY,2,EDINBURGH,ROME (CIAMPINO),14134,14044,90,26971,26971,0,-47.59557
25/03/2022 10:55,2021,1,WESTERN EUROPE-EU,ITALY,2,EDINBURGH,ROME (FIUMICINO),0,0,0,1529,622,907,-100
25/03/2022 10:55,2021,1,WESTERN EUROPE-EU,ITALY,2,EDINBURGH,TREVISO,6087,5998,89,5294,5294,0,14.97922
25/03/2022 10:55,2021,1,WESTERN EUROPE-EU,ITALY,2,EDINBURGH,TURIN,379,379,0,3337,3198,139,-88.64249
25/03/2022 10:55,2021,1,WESTERN EUROPE-EU,ITALY,2,EDINBURGH,VENICE,1124,960,164,18612,18612,0,-93.96089
25/03/2022 10:55,2021,1,WESTERN EUROPE-EU,ITALY,2,EDINBURGH,VERONA VILLAFRANCA,0,0,0,4265,2533,1732,-100
25/03/2022 10:55,2021,1,WESTERN EUROPE-EU,ITALY,2,FARNBOROUGH,PERUGIA,1,0,1,0,0,0,0
25/03/2022 10:55,2021,1,WESTERN EUROPE-EU,ITALY,2,GLASGOW,BOLOGNA,68,0,68,0,0,0,0
25/03/2022 10:55,2021,1,WESTERN EUROPE-EU,ITALY,2,GLASGOW,MILAN (MALPENSA),0,0,0,192,0,192,-100
25/03/2022 10:55,2021,1,WESTERN EUROPE-EU,ITALY,2,GLASGOW,PARMA,172,0,172,0,0,0,0
25/03/2022 10:55,2021,1,WESTERN EUROPE-EU,ITALY,2,GLASGOW,PISA,0,0,0,9,0,9,-100
25/03/2022 10:55,2021,1,WESTERN EUROPE-EU,ITALY,2,GLASGOW,ROME (FIUMICINO),59,0,59,10015,9640,375,-99.41088
25/03/2022 10:55,2021,1,WESTERN EUROPE-EU,ITALY,2,GLASGOW,TURIN,64,0,64,3528,0,3528,-98.18594
25/03/2022 10:55,2021,1,WESTERN EUROPE-EU,ITALY,2,GLASGOW,VENICE,260,0,260,4835,4835,0,-94.62254
25/03/2022 10:55,2021,1,WESTERN EUROPE-EU,ITALY,2,GUERNSEY,BERGAMO,2,0,2,0,0,0,0
25/03/2022 10:55,2021,1,WESTERN EUROPE-EU,ITALY,2,GUERNSEY,BOLOGNA,2,0,2,0,0,0,0
25/03/2022 10:55,2021,1,WESTERN EUROPE-EU,ITALY,2,LEEDS BRADFORD,NAPLES,0,0,0,2085,2085,0,-100
25/03/2022 10:55,2021,1,WESTERN EUROPE-EU,ITALY,2,LEEDS BRADFORD,PISA,2336,2336,0,5255,5255,0,-55.5471
25/03/2022 10:55,2021,1,WESTERN EUROPE-EU,ITALY,2,LEEDS BRADFORD,ROME (FIUMICINO),0,0,0,4868,4868,0,-100
25/03/2022 10:55,2021,1,WESTERN EUROPE-EU,ITALY,2,LIVERPOOL (JOHN LENNON),BARI (PALESE),2116,2116,0,6888,6888,0,-69.27991
25/03/2022 10:55,2021,1,WESTERN EUROPE-EU,ITALY,2,LIVERPOOL (JOHN LENNON),BERGAMO,1840,1537,303,244,0,244,654.09836
25/03/2022 10:55,2021,1,WESTERN EUROPE-EU,ITALY,2,LIVERPOOL (JOHN LENNON),MILAN (MALPENSA),557,0,557,0,0,0,0
25/03/2022 10:55,2021,1,WESTERN EUROPE-EU,ITALY,2,LIVERPOOL (JOHN LENNON),NAPLES,0,0,0,1635,1635,0,-100
25/03/2022 10:55,2021,1,WESTERN EUROPE-EU,ITALY,2,LIVERPOOL (JOHN LENNON),PALERMO,0,0,0,5669,5669,0,-100
25/03/2022 10:55,2021,1,WESTERN EUROPE-EU,ITALY,2,LIVERPOOL (JOHN LENNON),ROME (FIUMICINO),5014,5014,0,0,0,0,0
25/03/2022 10:55,2021,1,WESTERN EUROPE-EU,ITALY,2,LIVERPOOL (JOHN LENNON),VENICE,0,0,0,5914,5914,0,-100
25/03/2022 10:55,2021,1,WESTERN EUROPE-EU,ITALY,2,MANCHESTER,BERGAMO,55644,54792,852,48320,48320,0,15.15728
25/03/2022 10:55,2021,1,WESTERN EUROPE-EU,ITALY,2,MANCHESTER,BOLOGNA,18616,18471,145,16466,16466,0,13.05721
25/03/2022 10:55,2021,1,WESTERN EUROPE-EU,ITALY,2,MANCHESTER,BRINDISI,2347,2347,0,6400,6400,0,-63.32812
25/03/2022 10:55,2021,1,WESTERN EUROPE-EU,ITALY,2,MANCHESTER,CAGLIARI (ELMAS),2156,2156,0,6166,6166,0,-65.03406
25/03/2022 10:55,2021,1,WESTERN EUROPE-EU,ITALY,2,MANCHESTER,CATANIA (FONTANAROSSA),2784,2784,0,16443,16443,0,-83.06878
25/03/2022 10:55,2021,1,WESTERN EUROPE-EU,ITALY,2,MANCHESTER,MILAN (MALPENSA),30884,30633,251,47125,47125,0,-34.46366
25/03/2022 10:55,2021,1,WESTERN EUROPE-EU,ITALY,2,MANCHESTER,NAPLES,16976,15960,1016,25979,23080,2899,-34.65491
25/03/2022 10:55,2021,1,WESTERN EUROPE-EU,ITALY,2,MANCHESTER,OLBIA,897,897,0,6257,6257,0,-85.66406
25/03/2022 10:55,2021,1,WESTERN EUROPE-EU,ITALY,2,MANCHESTER,PALERMO,5187,5187,0,7963,7963,0,-34.86123
25/03/2022 10:55,2021,1,WESTERN EUROPE-EU,ITALY,2,MANCHESTER,PISA,11691,11691,0,19679,19679,0,-40.59149
25/03/2022 10:55,2021,1,WESTERN EUROPE-EU,ITALY,2,MANCHESTER,ROME (CIAMPINO),36850,36850,0,52244,52244,0,-29.46558
25/03/2022 10:55,2021,1,WESTERN EUROPE-EU,ITALY,2,MANCHESTER,ROME (FIUMICINO),6931,6649,282,18239,18239,0,-61.99901
25/03/2022 10:55,2021,1,WESTERN EUROPE-EU,ITALY,2,MANCHESTER,TREVISO,8385,8385,0,8200,8200,0,2.2561
25/03/2022 10:55,2021,1,WESTERN EUROPE-EU,ITALY,2,MANCHESTER,TURIN,1460,420,1040,15889,9602,6287,-90.81125
25/03/2022 10:55,2021,1,WESTERN EUROPE-EU,ITALY,2,MANCHESTER,VENICE,4394,4286,108,35486,35486,0,-87.61765
25/03/2022 10:55,2021,1,WESTERN EUROPE-EU,ITALY,2,MANCHESTER,VERONA VILLAFRANCA,3147,2646,501,10196,6398,3798,-69.13495
25/03/2022 10:55,2021,1,WESTERN EUROPE-EU,ITALY,2,NEWCASTLE,PISA,0,0,0,2046,2046,0,-100
25/03/2022 10:55,2021,1,WESTERN EUROPE-EU,ITALY,2,NEWCASTLE,ROME (FIUMICINO),0,0,0,5528,5528,0,-100
25/03/2022 10:55,2021,1,WESTERN EUROPE-EU,ITALY,2,NEWCASTLE,TURIN,255,255,0,3345,3345,0,-92.37668
25/03/2022 10:55,2021,1,WESTERN EUROPE-EU,ITALY,2,NEWCASTLE,VERONA VILLAFRANCA,0,0,0,134,0,134,-100
25/03/2022 10:55,2021,1,WESTERN EUROPE-EU,ITALY,2,OXFORD (KIDLINGTON),BERGAMO,50,50,0,74,74,0,-32.43243
25/03/2022 10:55,2021,1,WESTERN EUROPE-EU,ITALY,2,OXFORD (KIDLINGTON),BOLOGNA,308,308,0,0,0,0,0
25/03/2022 10:55,2021,1,WESTERN EUROPE-EU,ITALY,2,PRESTWICK,PISA,0,0,0,2434,2434,0,-100
25/03/2022 10:55,2021,1,WESTERN EUROPE-EU,ITALY,2,PRESTWICK,ROME (CIAMPINO),0,0,0,6254,6095,159,-100
25/03/2022 10:55,2021,1,WESTERN EUROPE-EU,ITALY,2,SOUTHAMPTON,MILAN (MALPENSA),0,0,0,4,0,4,-100
25/03/2022 10:55,2021,1,WESTERN EUROPE-EU,LUXEMBOURG,1,GATWICK,LUXEMBOURG,0,0,0,13438,13438,0,-100
25/03/2022 10:55,2021,1,WESTERN EUROPE-EU,LUXEMBOURG,1,HEATHROW,LUXEMBOURG,7878,7878,0,37108,37108,0,-78.77008
25/03/2022 10:55,2021,1,WESTERN EUROPE-EU,LUXEMBOURG,1,LONDON CITY,LUXEMBOURG,23598,23598,0,31565,31565,0,-25.23998
25/03/2022 10:55,2021,1,WESTERN EUROPE-EU,LUXEMBOURG,1,LUTON,LUXEMBOURG,0,0,0,64,64,0,-100
25/03/2022 10:55,2021,1,WESTERN EUROPE-EU,LUXEMBOURG,1,STANSTED,LUXEMBOURG,27374,27276,98,29111,28988,123,-5.96682
25/03/2022 10:55,2021,1,WESTERN EUROPE-EU,LUXEMBOURG,2,BELFAST INTERNATIONAL,LUXEMBOURG,166,0,166,0,0,0,0
25/03/2022 10:55,2021,1,WESTERN EUROPE-EU,LUXEMBOURG,2,BIGGIN HILL,LUXEMBOURG,2,0,2,0,0,0,0
25/03/2022 10:55,2021,1,WESTERN EUROPE-EU,LUXEMBOURG,2,BIRMINGHAM,LUXEMBOURG,41,0,41,0,0,0,0
25/03/2022 10:55,2021,1,WESTERN EUROPE-EU,LUXEMBOURG,2,BOURNEMOUTH,LUXEMBOURG,45,45,0,0,0,0,0
25/03/2022 10:55,2021,1,WESTERN EUROPE-EU,LUXEMBOURG,2,EDINBURGH,LUXEMBOURG,0,0,0,9522,9522,0,-100
25/03/2022 10:55,2021,1,WESTERN EUROPE-EU,LUXEMBOURG,2,GLASGOW,LUXEMBOURG,47,0,47,0,0,0,0
25/03/2022 10:55,2021,1,WESTERN EUROPE-EU,LUXEMBOURG,2,MANCHESTER,LUXEMBOURG,0,0,0,2954,2954,0,-100
25/03/2022 10:55,2021,1,WESTERN EUROPE-EU,MALTA,1,GATWICK,MALTA,65142,64006,1136,68649,68649,0,-5.1086
25/03/2022 10:55,2021,1,WESTERN EUROPE-EU,MALTA,1,HEATHROW,MALTA,123237,122505,732,61262,61262,0,101.16385
25/03/2022 10:55,2021,1,WESTERN EUROPE-EU,MALTA,1,LUTON,MALTA,48621,48621,0,25560,25560,0,90.223
25/03/2022 10:55,2021,1,WESTERN EUROPE-EU,MALTA,1,SOUTHEND,MALTA,0,0,0,6329,6329,0,-100
25/03/2022 10:55,2021,1,WESTERN EUROPE-EU,MALTA,1,STANSTED,MALTA,50448,50448,0,25337,25285,52,99.10802
25/03/2022 10:55,2021,1,WESTERN EUROPE-EU,MALTA,2,ABERDEEN,MALTA,89,0,89,0,0,0,0
25/03/2022 10:55,2021,1,WESTERN EUROPE-EU,MALTA,2,BELFAST INTERNATIONAL,MALTA,0,0,0,2061,1989,72,-100
25/03/2022 10:55,2021,1,WESTERN EUROPE-EU,MALTA,2,BIGGIN HILL,MALTA,96,0,96,20,0,20,380
25/03/2022 10:55,2021,1,WESTERN EUROPE-EU,MALTA,2,BIRMINGHAM,MALTA,29005,29005,0,18031,18031,0,60.86185
25/03/2022 10:55,2021,1,WESTERN EUROPE-EU,MALTA,2,BOURNEMOUTH,MALTA,6846,6846,0,9520,9520,0,-28.08824
25/03/2022 10:55,2021,1,WESTERN EUROPE-EU,MALTA,2,BRISTOL,MALTA,8428,8428,0,15649,15649,0,-46.14352
25/03/2022 10:55,2021,1,WESTERN EUROPE-EU,MALTA,2,CARDIFF WALES,MALTA,0,0,0,6574,6574,0,-100
25/03/2022 10:55,2021,1,WESTERN EUROPE-EU,MALTA,2,EAST MIDLANDS INTERNATIONAL,MALTA,10159,10159,0,13781,13781,0,-26.28256
25/03/2022 10:55,2021,1,WESTERN EUROPE-EU,MALTA,2,EDINBURGH,MALTA,16402,16402,0,14339,14160,179,14.38734
25/03/2022 10:55,2021,1,WESTERN EUROPE-EU,MALTA,2,EXETER,MALTA,0,0,0,5222,5222,0,-100
25/03/2022 10:55,2021,1,WESTERN EUROPE-EU,MALTA,2,GLASGOW,MALTA,4164,4164,0,700,700,0,494.85714
25/03/2022 10:55,2021,1,WESTERN EUROPE-EU,MALTA,2,LEEDS BRADFORD,MALTA,13373,13373,0,11795,11795,0,13.37855
25/03/2022 10:55,2021,1,WESTERN EUROPE-EU,MALTA,2,LIVERPOOL (JOHN LENNON),MALTA,15627,15627,0,10718,10718,0,45.80146
25/03/2022 10:55,2021,1,WESTERN EUROPE-EU,MALTA,2,MANCHESTER,MALTA,83327,82229,1098,46919,46846,73,77.59756
25/03/2022 10:55,2021,1,WESTERN EUROPE-EU,MALTA,2,NEWCASTLE,MALTA,9059,9059,0,2875,2875,0,215.09565
25/03/2022 10:55,2021,1,WESTERN EUROPE-EU,NETHERLANDS,1,GATWICK,AMSTERDAM,51462,51459,3,262583,262486,97,-80.40163
25/03/2022 10:55,2021,1,WESTERN EUROPE-EU,NETHERLANDS,1,HEATHROW,AMSTERDAM,350659,350659,0,525790,525790,0,-33.30816
25/03/2022 10:55,2021,1,WESTERN EUROPE-EU,NETHERLANDS,1,LONDON CITY,AMSTERDAM,81750,81750,0,134649,134579,70,-39.28659
25/03/2022 10:55,2021,1,WESTERN EUROPE-EU,NETHERLANDS,1,LONDON CITY,ROTTERDAM,6407,6407,0,27458,27458,0,-76.66618
25/03/2022 10:55,2021,1,WESTERN EUROPE-EU,NETHERLANDS,1,LUTON,AMSTERDAM,51422,51422,0,201383,201383,0,-74.46557
25/03/2022 10:55,2021,1,WESTERN EUROPE-EU,NETHERLANDS,1,SOUTHEND,AMSTERDAM,0,0,0,35250,35250,0,-100
25/03/2022 10:55,2021,1,WESTERN EUROPE-EU,NETHERLANDS,1,SOUTHEND,GRONINGEN,0,0,0,3616,3616,0,-100
25/03/2022 10:55,2021,1,WESTERN EUROPE-EU,NETHERLANDS,1,STANSTED,AMSTERDAM,24611,24604,7,85838,85838,0,-71.32855
25/03/2022 10:55,2021,1,WESTERN EUROPE-EU,NETHERLANDS,1,STANSTED,EINDHOVEN,41667,41667,0,75263,75263,0,-44.63814
25/03/2022 10:55,2021,1,WESTERN EUROPE-EU,NETHERLANDS,1,STANSTED,MAASTRICHT,48,0,48,0,0,0,0
25/03/2022 10:55,2021,1,WESTERN EUROPE-EU,NETHERLANDS,2,ABERDEEN,AMSTERDAM,92243,92152,91,112058,112058,0,-17.68281
25/03/2022 10:55,2021,1,WESTERN EUROPE-EU,NETHERLANDS,2,ABERDEEN,ROTTERDAM,34,0,34,173,20,153,-80.34682
25/03/2022 10:55,2021,1,WESTERN EUROPE-EU,NETHERLANDS,2,BELFAST CITY (GEORGE BEST),AMSTERDAM,16398,16398,0,12768,12768,0,28.43045
25/03/2022 10:55,2021,1,WESTERN EUROPE-EU,NETHERLANDS,2,BELFAST INTERNATIONAL,AMSTERDAM,4341,4341,0,26458,26186,272,-83.59286
25/03/2022 10:55,2021,1,WESTERN EUROPE-EU,NETHERLANDS,2,BIGGIN HILL,AMSTERDAM,6,0,6,0,0,0,0
25/03/2022 10:55,2021,1,WESTERN EUROPE-EU,NETHERLANDS,2,BIGGIN HILL,EINDHOVEN,0,0,0,2,0,2,-100
25/03/2022 10:55,2021,1,WESTERN EUROPE-EU,NETHERLANDS,2,BIRMINGHAM,AMSTERDAM,124565,124563,2,182457,182457,0,-31.72912
25/03/2022 10:55,2021,1,WESTERN EUROPE-EU,NETHERLANDS,2,BRISTOL,AMSTERDAM,60318,60318,0,118625,118625,0,-49.15237
25/03/2022 10:55,2021,1,WESTERN EUROPE-EU,NETHERLANDS,2,CARDIFF WALES,AMSTERDAM,11426,11331,95,33765,33765,0,-66.16023
25/03/2022 10:55,2021,1,WESTERN EUROPE-EU,NETHERLANDS,2,DUNDEE,AMSTERDAM,0,0,0,21,0,21,-100
25/03/2022 10:55,2021,1,WESTERN EUROPE-EU,NETHERLANDS,2,EAST MIDLANDS INTERNATIONAL,AMSTERDAM,0,0,0,6542,6542,0,-100
25/03/2022 10:55,2021,1,WESTERN EUROPE-EU,NETHERLANDS,2,EDINBURGH,AMSTERDAM,131437,131437,0,172058,172025,33,-23.6089
25/03/2022 10:55,2021,1,WESTERN EUROPE-EU,NETHERLANDS,2,EDINBURGH,EINDHOVEN,2306,2306,0,9262,9262,0,-75.10257
25/03/2022 10:55,2021,1,WESTERN EUROPE-EU,NETHERLANDS,2,EDINBURGH,ROTTERDAM,0,0,0,968,968,0,-100
25/03/2022 10:55,2021,1,WESTERN EUROPE-EU,NETHERLANDS,2,EXETER,AMSTERDAM,0,0,0,10251,10251,0,-100
25/03/2022 10:55,2021,1,WESTERN EUROPE-EU,NETHERLANDS,2,GLASGOW,AMSTERDAM,96971,96764,207,116622,116531,91,-16.85017
25/03/2022 10:55,2021,1,WESTERN EUROPE-EU,NETHERLANDS,2,GLASGOW,EINDHOVEN,0,0,0,104,0,104,-100
25/03/2022 10:55,2021,1,WESTERN EUROPE-EU,NETHERLANDS,2,GUERNSEY,AMSTERDAM,199,198,1,0,0,0,0
25/03/2022 10:55,2021,1,WESTERN EUROPE-EU,NETHERLANDS,2,HUMBERSIDE,AMSTERDAM,5752,5726,26,29209,29209,0,-80.30744
25/03/2022 10:55,2021,1,WESTERN EUROPE-EU,NETHERLANDS,2,INVERNESS,AMSTERDAM,10757,10757,0,14600,14600,0,-26.32192
25/03/2022 10:55,2021,1,WESTERN EUROPE-EU,NETHERLANDS,2,LEEDS BRADFORD,AMSTERDAM,38472,38472,0,67696,67696,0,-43.16946
25/03/2022 10:55,2021,1,WESTERN EUROPE-EU,NETHERLANDS,2,LIVERPOOL (JOHN LENNON),AMSTERDAM,10709,10709,0,56416,56172,244,-81.0178
25/03/2022 10:55,2021,1,WESTERN EUROPE-EU,NETHERLANDS,2,LIVERPOOL (JOHN LENNON),EINDHOVEN,43,0,43,0,0,0,0
25/03/2022 10:55,2021,1,WESTERN EUROPE-EU,NETHERLANDS,2,MANCHESTER,AMSTERDAM,225591,225591,0,347524,347524,0,-35.08621
25/03/2022 10:55,2021,1,WESTERN EUROPE-EU,NETHERLANDS,2,MANCHESTER,EINDHOVEN,5939,5939,0,20282,20282,0,-70.71788
25/03/2022 10:55,2021,1,WESTERN EUROPE-EU,NETHERLANDS,2,MANCHESTER,GRONINGEN,0,0,0,86,0,86,-100
25/03/2022 10:55,2021,1,WESTERN EUROPE-EU,NETHERLANDS,2,MANCHESTER,ROTTERDAM,0,0,0,679,0,679,-100
25/03/2022 10:55,2021,1,WESTERN EUROPE-EU,NETHERLANDS,2,NEWCASTLE,AMSTERDAM,95024,95024,0,115365,115365,0,-17.63186
25/03/2022 10:55,2021,1,WESTERN EUROPE-EU,NETHERLANDS,2,NORWICH,AMSTERDAM,9850,9850,0,33097,33097,0,-70.23899
25/03/2022 10:55,2021,1,WESTERN EUROPE-EU,NETHERLANDS,2,SOUTHAMPTON,AMSTERDAM,9401,9401,0,28306,28306,0,-66.78796
25/03/2022 10:55,2021,1,WESTERN EUROPE-EU,NETHERLANDS,2,TEESSIDE INTERNATIONAL AIRPORT,AMSTERDAM,3860,3860,0,23898,23898,0,-83.84802
25/03/2022 10:55,2021,1,WESTERN EUROPE-EU,PORTUGAL(EXCLUDING MADEIRA),1,GATWICK,AZORES PONTA DELGADA,0,0,0,281,0,281,-100
25/03/2022 10:55,2021,1,WESTERN EUROPE-EU,PORTUGAL(EXCLUDING MADEIRA),1,GATWICK,FARO,147279,135361,11918,122008,120802,1206,20.71258
25/03/2022 10:55,2021,1,WESTERN EUROPE-EU,PORTUGAL(EXCLUDING MADEIRA),1,GATWICK,LISBON,79064,78979,85,89239,89189,50,-11.40197
25/03/2022 10:55,2021,1,WESTERN EUROPE-EU,PORTUGAL(EXCLUDING MADEIRA),1,GATWICK,OPORTO (PORTUGAL),72964,68325,4639,78794,78794,0,-7.39904
25/03/2022 10:55,2021,1,WESTERN EUROPE-EU,PORTUGAL(EXCLUDING MADEIRA),1,HEATHROW,FARO,128455,128062,393,58327,57959,368,120.23248
25/03/2022 10:55,2021,1,WESTERN EUROPE-EU,PORTUGAL(EXCLUDING MADEIRA),1,HEATHROW,LISBON,300798,300798,0,300400,300106,294,0.13249
25/03/2022 10:55,2021,1,WESTERN EUROPE-EU,PORTUGAL(EXCLUDING MADEIRA),1,HEATHROW,OPORTO (PORTUGAL),23706,23536,170,22425,22425,0,5.71237
25/03/2022 10:55,2021,1,WESTERN EUROPE-EU,PORTUGAL(EXCLUDING MADEIRA),1,LONDON CITY,FARO,4675,4675,0,1299,1299,0,259.89222
25/03/2022 10:55,2021,1,WESTERN EUROPE-EU,PORTUGAL(EXCLUDING MADEIRA),1,LUTON,AZORES PONTA DELGADA,206,206,0,0,0,0,0
25/03/2022 10:55,2021,1,WESTERN EUROPE-EU,PORTUGAL(EXCLUDING MADEIRA),1,LUTON,FARO,91770,91604,166,75315,75315,0,21.84824
25/03/2022 10:55,2021,1,WESTERN EUROPE-EU,PORTUGAL(EXCLUDING MADEIRA),1,LUTON,LISBON,79409,79409,0,137139,137139,0,-42.09598
25/03/2022 10:55,2021,1,WESTERN EUROPE-EU,PORTUGAL(EXCLUDING MADEIRA),1,LUTON,OPORTO (PORTUGAL),21306,21258,48,36475,36475,0,-41.58739
25/03/2022 10:55,2021,1,WESTERN EUROPE-EU,PORTUGAL(EXCLUDING MADEIRA),1,SOUTHEND,FARO,5141,5141,0,16717,16717,0,-69.24687
25/03/2022 10:55,2021,1,WESTERN EUROPE-EU,PORTUGAL(EXCLUDING MADEIRA),1,STANSTED,AZORES LAJES TERCEIRA ISLAND,0,0,0,317,317,0,-100
25/03/2022 10:55,2021,1,WESTERN EUROPE-EU,PORTUGAL(EXCLUDING MADEIRA),1,STANSTED,AZORES PONTA DELGADA,6533,6533,0,4961,4961,0,31.68716
25/03/2022 10:55,2021,1,WESTERN EUROPE-EU,PORTUGAL(EXCLUDING MADEIRA),1,STANSTED,FARO,134232,133707,525,83054,82978,76,61.62015
25/03/2022 10:55,2021,1,WESTERN EUROPE-EU,PORTUGAL(EXCLUDING MADEIRA),1,STANSTED,LISBON,188263,188263,0,178049,177369,680,5.73662
25/03/2022 10:55,2021,1,WESTERN EUROPE-EU,PORTUGAL(EXCLUDING MADEIRA),1,STANSTED,OPORTO (PORTUGAL),130214,130214,0,118645,118458,187,9.75094
25/03/2022 10:55,2021,1,WESTERN EUROPE-EU,PORTUGAL(EXCLUDING MADEIRA),2,ABERDEEN,FARO,2095,2095,0,1184,1184,0,76.94257
25/03/2022 10:55,2021,1,WESTERN EUROPE-EU,PORTUGAL(EXCLUDING MADEIRA),2,ABERDEEN,LISBON,0,0,0,90,0,90,-100
25/03/2022 10:55,2021,1,WESTERN EUROPE-EU,PORTUGAL(EXCLUDING MADEIRA),2,BELFAST CITY (GEORGE BEST),FARO,6757,6757,0,5,0,5,135040
25/03/2022 10:55,2021,1,WESTERN EUROPE-EU,PORTUGAL(EXCLUDING MADEIRA),2,BELFAST INTERNATIONAL,FARO,30276,30276,0,20427,20427,0,48.2156
25/03/2022 10:55,2021,1,WESTERN EUROPE-EU,PORTUGAL(EXCLUDING MADEIRA),2,BELFAST INTERNATIONAL,OPORTO (PORTUGAL),176,0,176,0,0,0,0
25/03/2022 10:55,2021,1,WESTERN EUROPE-EU,PORTUGAL(EXCLUDING MADEIRA),2,BIGGIN HILL,AZORES PONTA DELGADA,0,0,0,4,0,4,-100
25/03/2022 10:55,2021,1,WESTERN EUROPE-EU,PORTUGAL(EXCLUDING MADEIRA),2,BIGGIN HILL,FARO,63,0,63,25,0,25,152
25/03/2022 10:55,2021,1,WESTERN EUROPE-EU,PORTUGAL(EXCLUDING MADEIRA),2,BIGGIN HILL,LISBON,3,0,3,5,0,5,-40
25/03/2022 10:55,2021,1,WESTERN EUROPE-EU,PORTUGAL(EXCLUDING MADEIRA),2,BIRMINGHAM,FARO,69519,65151,4368,48340,47187,1153,43.81258
25/03/2022 10:55,2021,1,WESTERN EUROPE-EU,PORTUGAL(EXCLUDING MADEIRA),2,BIRMINGHAM,LISBON,4771,4771,0,0,0,0,0
25/03/2022 10:55,2021,1,WESTERN EUROPE-EU,PORTUGAL(EXCLUDING MADEIRA),2,BIRMINGHAM,OPORTO (PORTUGAL),13027,13027,0,14553,14553,0,-10.48581
25/03/2022 10:55,2021,1,WESTERN EUROPE-EU,PORTUGAL(EXCLUDING MADEIRA),2,BOURNEMOUTH,FARO,16519,16519,0,15569,15569,0,6.10187
25/03/2022 10:55,2021,1,WESTERN EUROPE-EU,PORTUGAL(EXCLUDING MADEIRA),2,BOURNEMOUTH,LISBON,2605,2605,0,90,0,90,2794.44444
25/03/2022 10:55,2021,1,WESTERN EUROPE-EU,PORTUGAL(EXCLUDING MADEIRA),2,BRISTOL,FARO,75460,73539,1921,55280,55280,0,36.50507
25/03/2022 10:55,2021,1,WESTERN EUROPE-EU,PORTUGAL(EXCLUDING MADEIRA),2,BRISTOL,LISBON,18764,18764,0,25629,25629,0,-26.78606
25/03/2022 10:55,2021,1,WESTERN EUROPE-EU,PORTUGAL(EXCLUDING MADEIRA),2,BRISTOL,OPORTO (PORTUGAL),12213,12213,0,12402,12402,0,-1.52395
25/03/2022 10:55,2021,1,WESTERN EUROPE-EU,PORTUGAL(EXCLUDING MADEIRA),2,CARDIFF WALES,FARO,3433,3134,299,3446,3446,0,-0.37725
25/03/2022 10:55,2021,1,WESTERN EUROPE-EU,PORTUGAL(EXCLUDING MADEIRA),2,DONCASTER SHEFFIELD,FARO,1044,1044,0,17,0,17,6041.17647
25/03/2022 10:55,2021,1,WESTERN EUROPE-EU,PORTUGAL(EXCLUDING MADEIRA),2,DUNDEE,FARO,4,0,4,1,0,1,300
25/03/2022 10:55,2021,1,WESTERN EUROPE-EU,PORTUGAL(EXCLUDING MADEIRA),2,EAST MIDLANDS INTERNATIONAL,FARO,52376,48234,4142,34487,33875,612,51.87172
25/03/2022 10:55,2021,1,WESTERN EUROPE-EU,PORTUGAL(EXCLUDING MADEIRA),2,EAST MIDLANDS INTERNATIONAL,OPORTO (PORTUGAL),0,0,0,177,177,0,-100
25/03/2022 10:55,2021,1,WESTERN EUROPE-EU,PORTUGAL(EXCLUDING MADEIRA),2,EDINBURGH,FARO,28279,28279,0,20199,20199,0,40.00198
25/03/2022 10:55,2021,1,WESTERN EUROPE-EU,PORTUGAL(EXCLUDING MADEIRA),2,EDINBURGH,LISBON,23942,23942,0,25773,25773,0,-7.10433
25/03/2022 10:55,2021,1,WESTERN EUROPE-EU,PORTUGAL(EXCLUDING MADEIRA),2,EDINBURGH,OPORTO (PORTUGAL),10063,10007,56,1819,1819,0,453.21605
25/03/2022 10:55,2021,1,WESTERN EUROPE-EU,PORTUGAL(EXCLUDING MADEIRA),2,EXETER,FARO,126,126,0,0,0,0,0
25/03/2022 10:55,2021,1,WESTERN EUROPE-EU,PORTUGAL(EXCLUDING MADEIRA),2,GLASGOW,FARO,19760,19760,0,16521,16521,0,19.60535
25/03/2022 10:55,2021,1,WESTERN EUROPE-EU,PORTUGAL(EXCLUDING MADEIRA),2,GLASGOW,LISBON,338,0,338,241,0,241,40.24896
25/03/2022 10:55,2021,1,WESTERN EUROPE-EU,PORTUGAL(EXCLUDING MADEIRA),2,GLASGOW,OPORTO (PORTUGAL),0,0,0,2996,0,2996,-100
25/03/2022 10:55,2021,1,WESTERN EUROPE-EU,PORTUGAL(EXCLUDING MADEIRA),2,LEEDS BRADFORD,FARO,42282,42282,0,25049,24687,362,68.79716
25/03/2022 10:55,2021,1,WESTERN EUROPE-EU,PORTUGAL(EXCLUDING MADEIRA),2,LIVERPOOL (JOHN LENNON),FARO,56431,56431,0,34500,34500,0,63.56812
25/03/2022 10:55,2021,1,WESTERN EUROPE-EU,PORTUGAL(EXCLUDING MADEIRA),2,LIVERPOOL (JOHN LENNON),OPORTO (PORTUGAL),5280,4874,406,8967,8967,0,-41.11743
25/03/2022 10:55,2021,1,WESTERN EUROPE-EU,PORTUGAL(EXCLUDING MADEIRA),2,MANCHESTER,FARO,138991,125721,13270,93465,91899,1566,48.70914
25/03/2022 10:55,2021,1,WESTERN EUROPE-EU,PORTUGAL(EXCLUDING MADEIRA),2,MANCHESTER,LISBON,95074,95074,0,92243,92037,206,3.06907
25/03/2022 10:55,2021,1,WESTERN EUROPE-EU,PORTUGAL(EXCLUDING MADEIRA),2,MANCHESTER,OPORTO (PORTUGAL),40107,31299,8808,29504,29303,201,35.9375
25/03/2022 10:55,2021,1,WESTERN EUROPE-EU,PORTUGAL(EXCLUDING MADEIRA),2,NEWCASTLE,FARO,28688,28688,0,22686,22686,0,26.45685
25/03/2022 10:55,2021,1,WESTERN EUROPE-EU,PORTUGAL(EXCLUDING MADEIRA),2,NEWQUAY,FARO,5342,5342,0,2719,2719,0,96.46929
25/03/2022 10:55,2021,1,WESTERN EUROPE-EU,PORTUGAL(EXCLUDING MADEIRA),2,PRESTWICK,FARO,7167,7167,0,12590,12590,0,-43.07387
25/03/2022 10:55,2021,1,WESTERN EUROPE-EU,PORTUGAL(EXCLUDING MADEIRA),2,SOUTHAMPTON,FARO,1864,1864,0,0,0,0,0
25/03/2022 10:55,2021,1,WESTERN EUROPE-EU,PORTUGAL(EXCLUDING MADEIRA),2,TEESSIDE INTERNATIONAL AIRPORT,FARO,3911,3911,0,0,0,0,0
25/03/2022 10:55,2021,1,WESTERN EUROPE-EU,PORTUGAL(MADEIRA),1,GATWICK,FUNCHAL,87208,74472,12736,85425,79778,5647,2.08721
25/03/2022 10:55,2021,1,WESTERN EUROPE-EU,PORTUGAL(MADEIRA),1,GATWICK,PORTO SANTO,6018,118,5900,0,0,0,0
25/03/2022 10:55,2021,1,WESTERN EUROPE-EU,PORTUGAL(MADEIRA),1,HEATHROW,FUNCHAL,56534,56534,0,21497,21497,0,162.98553
25/03/2022 10:55,2021,1,WESTERN EUROPE-EU,PORTUGAL(MADEIRA),1,LUTON,FUNCHAL,18673,18673,0,538,538,0,3370.81784
25/03/2022 10:55,2021,1,WESTERN EUROPE-EU,PORTUGAL(MADEIRA),1,STANSTED,FUNCHAL,19479,19479,0,14057,14057,0,38.57153
25/03/2022 10:55,2021,1,WESTERN EUROPE-EU,PORTUGAL(MADEIRA),2,BIRMINGHAM,FUNCHAL,19874,13497,6377,11775,11775,0,68.78132
25/03/2022 10:55,2021,1,WESTERN EUROPE-EU,PORTUGAL(MADEIRA),2,BRISTOL,FUNCHAL,21717,21717,0,19520,19520,0,11.25512
25/03/2022 10:55,2021,1,WESTERN EUROPE-EU,PORTUGAL(MADEIRA),2,EAST MIDLANDS INTERNATIONAL,FUNCHAL,6549,6549,0,10041,6338,3703,-34.77741
25/03/2022 10:55,2021,1,WESTERN EUROPE-EU,PORTUGAL(MADEIRA),2,EDINBURGH,FUNCHAL,7245,7245,0,7825,7825,0,-7.41214
25/03/2022 10:55,2021,1,WESTERN EUROPE-EU,PORTUGAL(MADEIRA),2,GLASGOW,FUNCHAL,6442,6442,0,5368,5368,0,20.00745
25/03/2022 10:55,2021,1,WESTERN EUROPE-EU,PORTUGAL(MADEIRA),2,GLASGOW,PORTO SANTO,177,177,0,0,0,0,0
25/03/2022 10:55,2021,1,WESTERN EUROPE-EU,PORTUGAL(MADEIRA),2,JERSEY,FUNCHAL,5399,0,5399,6653,0,6653,-18.84864
25/03/2022 10:55,2021,1,WESTERN EUROPE-EU,PORTUGAL(MADEIRA),2,LEEDS BRADFORD,FUNCHAL,11074,11074,0,7725,7725,0,43.35275
25/03/2022 10:55,2021,1,WESTERN EUROPE-EU,PORTUGAL(MADEIRA),2,MANCHESTER,FUNCHAL,50097,31705,18392,33786,29817,3969,48.27739
25/03/2022 10:55,2021,1,WESTERN EUROPE-EU,PORTUGAL(MADEIRA),2,MANCHESTER,PORTO SANTO,4046,0,4046,0,0,0,0
25/03/2022 10:55,2021,1,WESTERN EUROPE-EU,PORTUGAL(MADEIRA),2,NEWCASTLE,FUNCHAL,6042,6042,0,4402,4402,0,37.25579
25/03/2022 10:55,2021,1,WESTERN EUROPE-EU,SLOVENIA,1,GATWICK,LJUBLJANA,9200,9200,0,13171,13107,64,-30.14957
25/03/2022 10:55,2021,1,WESTERN EUROPE-EU,SLOVENIA,1,HEATHROW,LJUBLJANA,8717,8717,0,0,0,0,0
25/03/2022 10:55,2021,1,WESTERN EUROPE-EU,SLOVENIA,1,LUTON,LJUBLJANA,1425,1425,0,133,133,0,971.42857
25/03/2022 10:55,2021,1,WESTERN EUROPE-EU,SLOVENIA,1,SOUTHEND,LJUBLJANA,0,0,0,72,72,0,-100
25/03/2022 10:55,2021,1,WESTERN EUROPE-EU,SLOVENIA,1,STANSTED,LJUBLJANA,67,0,67,15997,15997,0,-99.58117
25/03/2022 10:55,2021,1,WESTERN EUROPE-EU,SLOVENIA,1,STANSTED,MARIBOR,100,0,100,0,0,0,0
25/03/2022 10:55,2021,1,WESTERN EUROPE-EU,SLOVENIA,2,BELFAST INTERNATIONAL,MARIBOR,0,0,0,92,0,92,-100
25/03/2022 10:55,2021,1,WESTERN EUROPE-EU,SLOVENIA,2,BIGGIN HILL,LJUBLJANA,10,0,10,0,0,0,0
25/03/2022 10:55,2021,1,WESTERN EUROPE-EU,SLOVENIA,2,CARDIFF WALES,MARIBOR,91,0,91,0,0,0,0
25/03/2022 10:55,2021,1,WESTERN EUROPE-EU,SPAIN,1,GATWICK,ALICANTE,170002,169576,426,165617,165035,582,2.64768
25/03/2022 10:55,2021,1,WESTERN EUROPE-EU,SPAIN,1,GATWICK,ALMERIA,19801,19801,0,19441,19441,0,1.85176
25/03/2022 10:55,2021,1,WESTERN EUROPE-EU,SPAIN,1,GATWICK,ASTURIAS,1182,823,359,10822,10822,0,-89.0778
25/03/2022 10:55,2021,1,WESTERN EUROPE-EU,SPAIN,1,GATWICK,BARCELONA,172593,172205,388,284627,284627,0,-39.36169
25/03/2022 10:55,2021,1,WESTERN EUROPE-EU,SPAIN,1,GATWICK,BILBAO,29751,29751,0,44560,44560,0,-33.23384
25/03/2022 10:55,2021,1,WESTERN EUROPE-EU,SPAIN,1,GATWICK,GRANADA,0,0,0,5130,5130,0,-100
25/03/2022 10:55,2021,1,WESTERN EUROPE-EU,SPAIN,1,GATWICK,IBIZA,66583,48639,17944,8608,6801,1807,673.50139
25/03/2022 10:55,2021,1,WESTERN EUROPE-EU,SPAIN,1,GATWICK,MADRID,144165,143701,464,212507,212335,172,-32.15988
25/03/2022 10:55,2021,1,WESTERN EUROPE-EU,SPAIN,1,GATWICK,MAHON,54980,44417,10563,15773,15478,295,248.57034
25/03/2022 10:55,2021,1,WESTERN EUROPE-EU,SPAIN,1,GATWICK,MALAGA,145676,138690,6986,179210,175242,3968,-18.71213
25/03/2022 10:55,2021,1,WESTERN EUROPE-EU,SPAIN,1,GATWICK,MURCIA INTERNATIONAL,44759,44759,0,32354,32354,0,38.34147
25/03/2022 10:55,2021,1,WESTERN EUROPE-EU,SPAIN,1,GATWICK,PALMA DE MALLORCA,152286,121177,31109,67710,65321,2389,124.90917
25/03/2022 10:55,2021,1,WESTERN EUROPE-EU,SPAIN,1,GATWICK,REUS,849,0,849,431,0,431,96.98376
25/03/2022 10:55,2021,1,WESTERN EUROPE-EU,SPAIN,1,GATWICK,SANTIAGO DE COMPOSTELA (SPAIN),13947,13947,0,0,0,0,0
25/03/2022 10:55,2021,1,WESTERN EUROPE-EU,SPAIN,1,GATWICK,SEVILLE,15147,15090,57,49908,49733,175,-69.65016
25/03/2022 10:55,2021,1,WESTERN EUROPE-EU,SPAIN,1,GATWICK,VALENCIA,45771,45771,0,53951,53951,0,-15.16191
25/03/2022 10:55,2021,1,WESTERN EUROPE-EU,SPAIN,1,HEATHROW,A CORUNA,0,0,0,20910,20910,0,-100
25/03/2022 10:55,2021,1,WESTERN EUROPE-EU,SPAIN,1,HEATHROW,ALICANTE,38509,38509,0,22027,22027,0,74.82635
25/03/2022 10:55,2021,1,WESTERN EUROPE-EU,SPAIN,1,HEATHROW,BARCELONA,170837,170837,0,188738,188738,0,-9.48458
25/03/2022 10:55,2021,1,WESTERN EUROPE-EU,SPAIN,1,HEATHROW,BILBAO,7784,7784,0,3318,3318,0,134.59916
25/03/2022 10:55,2021,1,WESTERN EUROPE-EU,SPAIN,1,HEATHROW,IBIZA,97874,97874,0,29729,29729,0,229.22063
25/03/2022 10:55,2021,1,WESTERN EUROPE-EU,SPAIN,1,HEATHROW,MADRID,425759,425650,109,454761,454499,262,-6.37742
25/03/2022 10:55,2021,1,WESTERN EUROPE-EU,SPAIN,1,HEATHROW,MAHON,16466,16466,0,4125,4125,0,299.17576
25/03/2022 10:55,2021,1,WESTERN EUROPE-EU,SPAIN,1,HEATHROW,MALAGA,168817,168636,181,63101,63084,17,167.53459
25/03/2022 10:55,2021,1,WESTERN EUROPE-EU,SPAIN,1,HEATHROW,PALMA DE MALLORCA,128802,128722,80,32942,32587,355,290.9963
25/03/2022 10:55,2021,1,WESTERN EUROPE-EU,SPAIN,1,HEATHROW,SEVILLE,13859,13726,133,4709,4592,117,194.30877
25/03/2022 10:55,2021,1,WESTERN EUROPE-EU,SPAIN,1,HEATHROW,VALENCIA,21591,21225,366,25624,25624,0,-15.73915
25/03/2022 10:55,2021,1,WESTERN EUROPE-EU,SPAIN,1,LONDON CITY,IBIZA,36026,36026,0,16090,16090,0,123.90305
25/03/2022 10:55,2021,1,WESTERN EUROPE-EU,SPAIN,1,LONDON CITY,MAHON,3088,3088,0,58,58,0,5224.13793
25/03/2022 10:55,2021,1,WESTERN EUROPE-EU,SPAIN,1,LONDON CITY,MALAGA,24512,24512,0,6841,6841,0,258.31019
25/03/2022 10:55,2021,1,WESTERN EUROPE-EU,SPAIN,1,LONDON CITY,PALMA DE MALLORCA,21921,21826,95,6307,6307,0,247.5662
25/03/2022 10:55,2021,1,WESTERN EUROPE-EU,SPAIN,1,LUTON,ALICANTE,84662,84662,0,68457,68457,0,23.67179
25/03/2022 10:55,2021,1,WESTERN EUROPE-EU,SPAIN,1,LUTON,BARCELONA,32528,32353,175,102065,102065,0,-68.13011
25/03/2022 10:55,2021,1,WESTERN EUROPE-EU,SPAIN,1,LUTON,CASTELLON COSTA AZAHAR,0,0,0,7479,7479,0,-100
25/03/2022 10:55,2021,1,WESTERN EUROPE-EU,SPAIN,1,LUTON,CASTELLON DE LA PLANA AIRPORT,0,0,0,333,333,0,-100
25/03/2022 10:55,2021,1,WESTERN EUROPE-EU,SPAIN,1,LUTON,GIRONA,4945,4945,0,284,284,0,1641.19718
25/03/2022 10:55,2021,1,WESTERN EUROPE-EU,SPAIN,1,LUTON,IBIZA,17276,17276,0,4029,4029,0,328.79126
25/03/2022 10:55,2021,1,WESTERN EUROPE-EU,SPAIN,1,LUTON,MADRID,308,68,240,20051,20051,0,-98.46392
25/03/2022 10:55,2021,1,WESTERN EUROPE-EU,SPAIN,1,LUTON,MAHON,12853,12853,0,5356,5356,0,139.97386
25/03/2022 10:55,2021,1,WESTERN EUROPE-EU,SPAIN,1,LUTON,MALAGA,127885,127885,0,98900,98193,707,29.30738
25/03/2022 10:55,2021,1,WESTERN EUROPE-EU,SPAIN,1,LUTON,MURCIA INTERNATIONAL,0,0,0,725,725,0,-100
25/03/2022 10:55,2021,1,WESTERN EUROPE-EU,SPAIN,1,LUTON,PALMA DE MALLORCA,94056,87752,6304,33174,33174,0,183.52324
25/03/2022 10:55,2021,1,WESTERN EUROPE-EU,SPAIN,1,LUTON,REUS,0,0,0,787,787,0,-100
25/03/2022 10:55,2021,1,WESTERN EUROPE-EU,SPAIN,1,LUTON,SEVILLE,4090,4090,0,21601,21601,0,-81.06569
25/03/2022 10:55,2021,1,WESTERN EUROPE-EU,SPAIN,1,LUTON,VALENCIA,0,0,0,7378,7378,0,-100
25/03/2022 10:55,2021,1,WESTERN EUROPE-EU,SPAIN,1,SOUTHEND,ALICANTE,19819,19819,0,43096,43096,0,-54.01197
25/03/2022 10:55,2021,1,WESTERN EUROPE-EU,SPAIN,1,SOUTHEND,BARCELONA,0,0,0,5434,5434,0,-100
25/03/2022 10:55,2021,1,WESTERN EUROPE-EU,SPAIN,1,SOUTHEND,BILBAO,0,0,0,11397,11397,0,-100
25/03/2022 10:55,2021,1,WESTERN EUROPE-EU,SPAIN,1,SOUTHEND,GIRONA,0,0,0,212,212,0,-100
25/03/2022 10:55,2021,1,WESTERN EUROPE-EU,SPAIN,1,SOUTHEND,IBIZA,0,0,0,462,462,0,-100
25/03/2022 10:55,2021,1,WESTERN EUROPE-EU,SPAIN,1,SOUTHEND,MAHON,0,0,0,449,449,0,-100
25/03/2022 10:55,2021,1,WESTERN EUROPE-EU,SPAIN,1,SOUTHEND,MALAGA,19235,19235,0,38006,38006,0,-49.38957
25/03/2022 10:55,2021,1,WESTERN EUROPE-EU,SPAIN,1,SOUTHEND,MURCIA INTERNATIONAL,0,0,0,6717,6717,0,-100
25/03/2022 10:55,2021,1,WESTERN EUROPE-EU,SPAIN,1,SOUTHEND,PALMA DE MALLORCA,21446,21446,0,7574,7574,0,183.15289
25/03/2022 10:55,2021,1,WESTERN EUROPE-EU,SPAIN,1,SOUTHEND,REUS,1375,1375,0,990,990,0,38.88889
25/03/2022 10:55,2021,1,WESTERN EUROPE-EU,SPAIN,1,STANSTED,ALICANTE,139874,139874,0,86984,86975,9,60.80429
25/03/2022 10:55,2021,1,WESTERN EUROPE-EU,SPAIN,1,STANSTED,ALMERIA,10068,10068,0,4681,4681,0,115.08225
25/03/2022 10:55,2021,1,WESTERN EUROPE-EU,SPAIN,1,STANSTED,BARCELONA,147468,147215,253,138523,138523,0,6.45741
25/03/2022 10:55,2021,1,WESTERN EUROPE-EU,SPAIN,1,STANSTED,BILBAO,0,0,0,6075,5890,185,-100
25/03/2022 10:55,2021,1,WESTERN EUROPE-EU,SPAIN,1,STANSTED,CASTELLON COSTA AZAHAR,13291,13291,0,8800,8800,0,51.03409
25/03/2022 10:55,2021,1,WESTERN EUROPE-EU,SPAIN,1,STANSTED,GIRONA,18490,18406,84,4279,4279,0,332.11031
25/03/2022 10:55,2021,1,WESTERN EUROPE-EU,SPAIN,1,STANSTED,IBIZA,72583,67585,4998,17448,17448,0,315.9961
25/03/2022 10:55,2021,1,WESTERN EUROPE-EU,SPAIN,1,STANSTED,JEREZ,10949,10949,0,12051,12051,0,-9.14447
25/03/2022 10:55,2021,1,WESTERN EUROPE-EU,SPAIN,1,STANSTED,MADRID,143938,143887,51,131922,131704,218,9.10841
25/03/2022 10:55,2021,1,WESTERN EUROPE-EU,SPAIN,1,STANSTED,MAHON,16509,14819,1690,1668,1668,0,889.7482
25/03/2022 10:55,2021,1,WESTERN EUROPE-EU,SPAIN,1,STANSTED,MALAGA,119131,119131,0,108069,107920,149,10.23605
25/03/2022 10:55,2021,1,WESTERN EUROPE-EU,SPAIN,1,STANSTED,MURCIA INTERNATIONAL,0,0,0,27148,27148,0,-100
25/03/2022 10:55,2021,1,WESTERN EUROPE-EU,SPAIN,1,STANSTED,PALMA DE MALLORCA,131164,122051,9113,50753,50699,54,158.43595
25/03/2022 10:55,2021,1,WESTERN EUROPE-EU,SPAIN,1,STANSTED,REUS,9664,9664,0,8195,8195,0,17.92556
25/03/2022 10:55,2021,1,WESTERN EUROPE-EU,SPAIN,1,STANSTED,SANTANDER,28266,28266,0,27088,27088,0,4.34879
25/03/2022 10:55,2021,1,WESTERN EUROPE-EU,SPAIN,1,STANSTED,SANTIAGO DE COMPOSTELA (SPAIN),37772,37772,0,25088,25012,76,50.55804
25/03/2022 10:55,2021,1,WESTERN EUROPE-EU,SPAIN,1,STANSTED,SEVILLE,58802,58802,0,41717,41717,0,40.95453
25/03/2022 10:55,2021,1,WESTERN EUROPE-EU,SPAIN,1,STANSTED,VALENCIA,61464,61464,0,49226,49140,86,24.86085
25/03/2022 10:55,2021,1,WESTERN EUROPE-EU,SPAIN,1,STANSTED,ZARAGOZA,20468,20468,0,25800,25800,0,-20.66667
25/03/2022 10:55,2021,1,WESTERN EUROPE-EU,SPAIN,2,ABERDEEN,ALICANTE,10343,10343,0,11062,11062,0,-6.49973
25/03/2022 10:55,2021,1,WESTERN EUROPE-EU,SPAIN,2,ABERDEEN,MALAGA,5270,5270,0,2459,2459,0,114.31476
25/03/2022 10:55,2021,1,WESTERN EUROPE-EU,SPAIN,2,ABERDEEN,PALMA DE MALLORCA,2258,0,2258,0,0,0,0
25/03/2022 10:55,2021,1,WESTERN EUROPE-EU,SPAIN,2,BELFAST CITY (GEORGE BEST),ALICANTE,11296,11296,0,0,0,0,0
25/03/2022 10:55,2021,1,WESTERN EUROPE-EU,SPAIN,2,BELFAST CITY (GEORGE BEST),BARCELONA,5460,5460,0,0,0,0,0
25/03/2022 10:55,2021,1,WESTERN EUROPE-EU,SPAIN,2,BELFAST CITY (GEORGE BEST),IBIZA,746,746,0,0,0,0,0
25/03/2022 10:55,2021,1,WESTERN EUROPE-EU,SPAIN,2,BELFAST CITY (GEORGE BEST),MALAGA,8044,8044,0,0,0,0,0
25/03/2022 10:55,2021,1,WESTERN EUROPE-EU,SPAIN,2,BELFAST CITY (GEORGE BEST),PALMA DE MALLORCA,8288,8288,0,7,0,7,118300
25/03/2022 10:55,2021,1,WESTERN EUROPE-EU,SPAIN,2,BELFAST CITY (GEORGE BEST),VALENCIA,953,889,64,0,0,0,0
25/03/2022 10:55,2021,1,WESTERN EUROPE-EU,SPAIN,2,BELFAST INTERNATIONAL,ALICANTE,37912,37912,0,27082,27082,0,39.98966
25/03/2022 10:55,2021,1,WESTERN EUROPE-EU,SPAIN,2,BELFAST INTERNATIONAL,BARCELONA,0,0,0,929,929,0,-100
25/03/2022 10:55,2021,1,WESTERN EUROPE-EU,SPAIN,2,BELFAST INTERNATIONAL,GIRONA,0,0,0,32,32,0,-100
25/03/2022 10:55,2021,1,WESTERN EUROPE-EU,SPAIN,2,BELFAST INTERNATIONAL,IBIZA,8376,8369,7,1162,1162,0,620.82616
25/03/2022 10:55,2021,1,WESTERN EUROPE-EU,SPAIN,2,BELFAST INTERNATIONAL,MAHON,1097,1097,0,0,0,0,0
25/03/2022 10:55,2021,1,WESTERN EUROPE-EU,SPAIN,2,BELFAST INTERNATIONAL,MALAGA,32448,32425,23,27898,27884,14,16.30941
25/03/2022 10:55,2021,1,WESTERN EUROPE-EU,SPAIN,2,BELFAST INTERNATIONAL,PALMA DE MALLORCA,23362,21722,1640,2767,2767,0,744.30791
25/03/2022 10:55,2021,1,WESTERN EUROPE-EU,SPAIN,2,BELFAST INTERNATIONAL,SEVILLE,180,180,0,0,0,0,0
25/03/2022 10:55,2021,1,WESTERN EUROPE-EU,SPAIN,2,BELFAST INTERNATIONAL,VALENCIA,2017,0,2017,0,0,0,0
25/03/2022 10:55,2021,1,WESTERN EUROPE-EU,SPAIN,2,BIGGIN HILL,ALICANTE,5,0,5,0,0,0,0
25/03/2022 10:55,2021,1,WESTERN EUROPE-EU,SPAIN,2,BIGGIN HILL,BARCELONA,6,0,6,0,0,0,0
25/03/2022 10:55,2021,1,WESTERN EUROPE-EU,SPAIN,2,BIGGIN HILL,GIRONA,5,0,5,0,0,0,0
25/03/2022 10:55,2021,1,WESTERN EUROPE-EU,SPAIN,2,BIGGIN HILL,IBIZA,208,0,208,32,0,32,550
25/03/2022 10:55,2021,1,WESTERN EUROPE-EU,SPAIN,2,BIGGIN HILL,MADRID,12,0,12,0,0,0,0
25/03/2022 10:55,2021,1,WESTERN EUROPE-EU,SPAIN,2,BIGGIN HILL,MAHON,54,0,54,0,0,0,0
25/03/2022 10:55,2021,1,WESTERN EUROPE-EU,SPAIN,2,BIGGIN HILL,MALAGA,81,0,81,20,0,20,305
25/03/2022 10:55,2021,1,WESTERN EUROPE-EU,SPAIN,2,BIGGIN HILL,PALMA DE MALLORCA,48,0,48,0,0,0,0
25/03/2022 10:55,2021,1,WESTERN EUROPE-EU,SPAIN,2,BIRMINGHAM,ALICANTE,92463,92463,0,75442,71071,4371,22.5617
25/03/2022 10:55,2021,1,WESTERN EUROPE-EU,SPAIN,2,BIRMINGHAM,ALMERIA,3438,3438,0,290,290,0,1085.51724
25/03/2022 10:55,2021,1,WESTERN EUROPE-EU,SPAIN,2,BIRMINGHAM,BARCELONA,46583,46091,492,61796,61041,755,-24.6181
25/03/2022 10:55,2021,1,WESTERN EUROPE-EU,SPAIN,2,BIRMINGHAM,BILBAO,0,0,0,293,0,293,-100
25/03/2022 10:55,2021,1,WESTERN EUROPE-EU,SPAIN,2,BIRMINGHAM,GIRONA,0,0,0,153,0,153,-100
25/03/2022 10:55,2021,1,WESTERN EUROPE-EU,SPAIN,2,BIRMINGHAM,IBIZA,38964,25667,13297,5796,5072,724,572.25673
25/03/2022 10:55,2021,1,WESTERN EUROPE-EU,SPAIN,2,BIRMINGHAM,MADRID,14476,14476,0,25619,25619,0,-43.49506
25/03/2022 10:55,2021,1,WESTERN EUROPE-EU,SPAIN,2,BIRMINGHAM,MAHON,18684,13139,5545,1486,1486,0,1157.33513
25/03/2022 10:55,2021,1,WESTERN EUROPE-EU,SPAIN,2,BIRMINGHAM,MALAGA,82629,75796,6833,67462,63311,4151,22.48229
25/03/2022 10:55,2021,1,WESTERN EUROPE-EU,SPAIN,2,BIRMINGHAM,MURCIA INTERNATIONAL,21760,21760,0,17523,17381,142,24.17965
25/03/2022 10:55,2021,1,WESTERN EUROPE-EU,SPAIN,2,BIRMINGHAM,PALMA DE MALLORCA,79786,63842,15944,17600,15808,1792,353.32955
25/03/2022 10:55,2021,1,WESTERN EUROPE-EU,SPAIN,2,BIRMINGHAM,REUS,4365,4365,0,2563,2563,0,70.30823
25/03/2022 10:55,2021,1,WESTERN EUROPE-EU,SPAIN,2,BIRMINGHAM,VALENCIA,130,59,71,40,40,0,225
25/03/2022 10:55,2021,1,WESTERN EUROPE-EU,SPAIN,2,BIRMINGHAM,VIGO,83,0,83,0,0,0,0
25/03/2022 10:55,2021,1,WESTERN EUROPE-EU,SPAIN,2,BOURNEMOUTH,ALICANTE,20789,20789,0,17896,17896,0,16.16562
25/03/2022 10:55,2021,1,WESTERN EUROPE-EU,SPAIN,2,BOURNEMOUTH,GIRONA,6771,6771,0,2849,2849,0,137.66234
25/03/2022 10:55,2021,1,WESTERN EUROPE-EU,SPAIN,2,BOURNEMOUTH,MALAGA,21560,21508,52,16189,16189,0,33.17685
25/03/2022 10:55,2021,1,WESTERN EUROPE-EU,SPAIN,2,BOURNEMOUTH,MURCIA INTERNATIONAL,8244,8244,0,4710,4710,0,75.03185
25/03/2022 10:55,2021,1,WESTERN EUROPE-EU,SPAIN,2,BOURNEMOUTH,PALMA DE MALLORCA,21745,15125,6620,3875,3875,0,461.16129
25/03/2022 10:55,2021,1,WESTERN EUROPE-EU,SPAIN,2,BRISTOL,ALICANTE,90704,90704,0,77960,77960,0,16.34684
25/03/2022 10:55,2021,1,WESTERN EUROPE-EU,SPAIN,2,BRISTOL,BARCELONA,22224,22224,0,35360,35360,0,-37.14932
25/03/2022 10:55,2021,1,WESTERN EUROPE-EU,SPAIN,2,BRISTOL,BILBAO,2626,2626,0,6477,6477,0,-59.45654
25/03/2022 10:55,2021,1,WESTERN EUROPE-EU,SPAIN,2,BRISTOL,GIRONA,4467,4467,0,3362,3362,0,32.86734
25/03/2022 10:55,2021,1,WESTERN EUROPE-EU,SPAIN,2,BRISTOL,IBIZA,30888,20899,9989,5725,5725,0,439.52838
25/03/2022 10:55,2021,1,WESTERN EUROPE-EU,SPAIN,2,BRISTOL,MADRID,22983,22983,0,24047,24047,0,-4.42467
25/03/2022 10:55,2021,1,WESTERN EUROPE-EU,SPAIN,2,BRISTOL,MAHON,14027,12506,1521,1929,1929,0,627.16433
25/03/2022 10:55,2021,1,WESTERN EUROPE-EU,SPAIN,2,BRISTOL,MALAGA,79447,79447,0,69281,67805,1476,14.67358
25/03/2022 10:55,2021,1,WESTERN EUROPE-EU,SPAIN,2,BRISTOL,MURCIA INTERNATIONAL,14842,14842,0,14989,14989,0,-0.98072
25/03/2022 10:55,2021,1,WESTERN EUROPE-EU,SPAIN,2,BRISTOL,PALMA DE MALLORCA,101963,89671,12292,21642,21342,300,371.13483
25/03/2022 10:55,2021,1,WESTERN EUROPE-EU,SPAIN,2,BRISTOL,SEVILLE,3656,3656,0,16703,16703,0,-78.11172
25/03/2022 10:55,2021,1,WESTERN EUROPE-EU,SPAIN,2,BRISTOL,VALENCIA,9174,9135,39,9883,9883,0,-7.17394
25/03/2022 10:55,2021,1,WESTERN EUROPE-EU,SPAIN,2,CARDIFF WALES,ALICANTE,18208,14697,3511,20896,13246,7650,-12.86371
25/03/2022 10:55,2021,1,WESTERN EUROPE-EU,SPAIN,2,CARDIFF WALES,BARCELONA,1790,1790,0,777,777,0,130.37323
25/03/2022 10:55,2021,1,WESTERN EUROPE-EU,SPAIN,2,CARDIFF WALES,IBIZA,955,0,955,0,0,0,0
25/03/2022 10:55,2021,1,WESTERN EUROPE-EU,SPAIN,2,CARDIFF WALES,MADRID,64,0,64,0,0,0,0
25/03/2022 10:55,2021,1,WESTERN EUROPE-EU,SPAIN,2,CARDIFF WALES,MALAGA,13141,11767,1374,8723,4855,3868,50.64771
25/03/2022 10:55,2021,1,WESTERN EUROPE-EU,SPAIN,2,CARDIFF WALES,PALMA DE MALLORCA,11589,4009,7580,621,621,0,1766.18357
25/03/2022 10:55,2021,1,WESTERN EUROPE-EU,SPAIN,2,CARDIFF WALES,SEVILLE,0,0,0,72,0,72,-100
25/03/2022 10:55,2021,1,WESTERN EUROPE-EU,SPAIN,2,DONCASTER SHEFFIELD,ALICANTE,13931,5676,8255,7676,0,7676,81.48775
25/03/2022 10:55,2021,1,WESTERN EUROPE-EU,SPAIN,2,DONCASTER SHEFFIELD,IBIZA,1842,0,1842,0,0,0,0
25/03/2022 10:55,2021,1,WESTERN EUROPE-EU,SPAIN,2,DONCASTER SHEFFIELD,MAHON,1071,0,1071,0,0,0,0
25/03/2022 10:55,2021,1,WESTERN EUROPE-EU,SPAIN,2,DONCASTER SHEFFIELD,MALAGA,4764,0,4764,4740,49,4691,0.50633
25/03/2022 10:55,2021,1,WESTERN EUROPE-EU,SPAIN,2,DONCASTER SHEFFIELD,PALMA DE MALLORCA,14433,0,14433,1409,0,1409,924.34351
25/03/2022 10:55,2021,1,WESTERN EUROPE-EU,SPAIN,2,DUNDEE,MALAGA,2,0,2,0,0,0,0
25/03/2022 10:55,2021,1,WESTERN EUROPE-EU,SPAIN,2,EAST MIDLANDS INTERNATIONAL,ALICANTE,79454,76528,2926,77274,73435,3839,2.82113
25/03/2022 10:55,2021,1,WESTERN EUROPE-EU,SPAIN,2,EAST MIDLANDS INTERNATIONAL,BARCELONA,17060,17060,0,4036,4036,0,322.69574
25/03/2022 10:55,2021,1,WESTERN EUROPE-EU,SPAIN,2,EAST MIDLANDS INTERNATIONAL,GIRONA,1969,1969,0,99,99,0,1888.88889
25/03/2022 10:55,2021,1,WESTERN EUROPE-EU,SPAIN,2,EAST MIDLANDS INTERNATIONAL,IBIZA,21006,13289,7717,4290,4290,0,389.65035
25/03/2022 10:55,2021,1,WESTERN EUROPE-EU,SPAIN,2,EAST MIDLANDS INTERNATIONAL,JEREZ,163,0,163,0,0,0,0
25/03/2022 10:55,2021,1,WESTERN EUROPE-EU,SPAIN,2,EAST MIDLANDS INTERNATIONAL,MAHON,11293,11293,0,4863,4863,0,132.22291
25/03/2022 10:55,2021,1,WESTERN EUROPE-EU,SPAIN,2,EAST MIDLANDS INTERNATIONAL,MALAGA,58974,58830,144,53659,49896,3763,9.90514
25/03/2022 10:55,2021,1,WESTERN EUROPE-EU,SPAIN,2,EAST MIDLANDS INTERNATIONAL,MURCIA INTERNATIONAL,0,0,0,1572,1572,0,-100
25/03/2022 10:55,2021,1,WESTERN EUROPE-EU,SPAIN,2,EAST MIDLANDS INTERNATIONAL,PALMA DE MALLORCA,67734,56777,10957,15334,15334,0,341.72427
25/03/2022 10:55,2021,1,WESTERN EUROPE-EU,SPAIN,2,EAST MIDLANDS INTERNATIONAL,REUS,1692,1692,0,2094,2094,0,-19.19771
25/03/2022 10:55,2021,1,WESTERN EUROPE-EU,SPAIN,2,EAST MIDLANDS INTERNATIONAL,SEVILLE,0,0,0,168,168,0,-100
25/03/2022 10:55,2021,1,WESTERN EUROPE-EU,SPAIN,2,EAST MIDLANDS INTERNATIONAL,VALENCIA,7809,7809,0,4446,4446,0,75.64103
25/03/2022 10:55,2021,1,WESTERN EUROPE-EU,SPAIN,2,EDINBURGH,ALICANTE,43648,43648,0,49557,49557,0,-11.92364
25/03/2022 10:55,2021,1,WESTERN EUROPE-EU,SPAIN,2,EDINBURGH,BARCELONA,36188,36188,0,30111,30111,0,20.18199
25/03/2022 10:55,2021,1,WESTERN EUROPE-EU,SPAIN,2,EDINBURGH,BILBAO,0,0,0,537,537,0,-100
25/03/2022 10:55,2021,1,WESTERN EUROPE-EU,SPAIN,2,EDINBURGH,GIRONA,1401,1401,0,256,256,0,447.26562
25/03/2022 10:55,2021,1,WESTERN EUROPE-EU,SPAIN,2,EDINBURGH,IBIZA,6761,6761,0,2028,2028,0,233.38264
25/03/2022 10:55,2021,1,WESTERN EUROPE-EU,SPAIN,2,EDINBURGH,LIEIDA,80,0,80,0,0,0,0
25/03/2022 10:55,2021,1,WESTERN EUROPE-EU,SPAIN,2,EDINBURGH,MADRID,23765,23705,60,28517,28517,0,-16.66374
25/03/2022 10:55,2021,1,WESTERN EUROPE-EU,SPAIN,2,EDINBURGH,MAHON,2578,2578,0,0,0,0,0
25/03/2022 10:55,2021,1,WESTERN EUROPE-EU,SPAIN,2,EDINBURGH,MALAGA,32791,32791,0,30884,30193,691,6.17472
25/03/2022 10:55,2021,1,WESTERN EUROPE-EU,SPAIN,2,EDINBURGH,PALMA DE MALLORCA,38660,38660,0,7063,7063,0,447.35948
25/03/2022 10:55,2021,1,WESTERN EUROPE-EU,SPAIN,2,EDINBURGH,SANTANDER,8610,8610,0,8757,8757,0,-1.67866
25/03/2022 10:55,2021,1,WESTERN EUROPE-EU,SPAIN,2,EDINBURGH,SANTIAGO DE COMPOSTELA (SPAIN),0,0,0,185,185,0,-100
25/03/2022 10:55,2021,1,WESTERN EUROPE-EU,SPAIN,2,EDINBURGH,SEVILLE,9260,9174,86,17019,17019,0,-45.59022
25/03/2022 10:55,2021,1,WESTERN EUROPE-EU,SPAIN,2,EDINBURGH,VALENCIA,2871,2871,0,2210,2210,0,29.9095
25/03/2022 10:55,2021,1,WESTERN EUROPE-EU,SPAIN,2,EXETER,ALICANTE,8076,8076,0,9870,9870,0,-18.17629
25/03/2022 10:55,2021,1,WESTERN EUROPE-EU,SPAIN,2,EXETER,MALAGA,7074,7074,0,9692,9692,0,-27.01197
25/03/2022 10:55,2021,1,WESTERN EUROPE-EU,SPAIN,2,EXETER,PALMA DE MALLORCA,3746,0,3746,0,0,0,0
25/03/2022 10:55,2021,1,WESTERN EUROPE-EU,SPAIN,2,GLASGOW,ALICANTE,46575,44805,1770,48831,44905,3926,-4.62002
25/03/2022 10:55,2021,1,WESTERN EUROPE-EU,SPAIN,2,GLASGOW,BARCELONA,0,0,0,7142,7142,0,-100
25/03/2022 10:55,2021,1,WESTERN EUROPE-EU,SPAIN,2,GLASGOW,BILBAO,0,0,0,67,0,67,-100
25/03/2022 10:55,2021,1,WESTERN EUROPE-EU,SPAIN,2,GLASGOW,IBIZA,11912,11122,790,505,505,0,2258.81188
25/03/2022 10:55,2021,1,WESTERN EUROPE-EU,SPAIN,2,GLASGOW,MADRID,115,0,115,47,47,0,144.68085
25/03/2022 10:55,2021,1,WESTERN EUROPE-EU,SPAIN,2,GLASGOW,MAHON,2224,2224,0,0,0,0,0
25/03/2022 10:55,2021,1,WESTERN EUROPE-EU,SPAIN,2,GLASGOW,MALAGA,42830,40659,2171,40240,38388,1852,6.43638
25/03/2022 10:55,2021,1,WESTERN EUROPE-EU,SPAIN,2,GLASGOW,PALMA DE MALLORCA,25837,23390,2447,3023,3023,0,754.68078
25/03/2022 10:55,2021,1,WESTERN EUROPE-EU,SPAIN,2,GLASGOW,SEVILLE,241,0,241,0,0,0,0
25/03/2022 10:55,2021,1,WESTERN EUROPE-EU,SPAIN,2,GUERNSEY,BARCELONA,121,121,0,0,0,0,0
25/03/2022 10:55,2021,1,WESTERN EUROPE-EU,SPAIN,2,GUERNSEY,IBIZA,72,0,72,0,0,0,0
25/03/2022 10:55,2021,1,WESTERN EUROPE-EU,SPAIN,2,GUERNSEY,MALAGA,306,0,306,0,0,0,0
25/03/2022 10:55,2021,1,WESTERN EUROPE-EU,SPAIN,2,GUERNSEY,PALMA DE MALLORCA,838,107,731,0,0,0,0
25/03/2022 10:55,2021,1,WESTERN EUROPE-EU,SPAIN,2,HUMBERSIDE,A CORUNA,0,0,0,33,0,33,-100
25/03/2022 10:55,2021,1,WESTERN EUROPE-EU,SPAIN,2,HUMBERSIDE,PALMA DE MALLORCA,1,0,1,0,0,0,0
25/03/2022 10:55,2021,1,WESTERN EUROPE-EU,SPAIN,2,HUMBERSIDE,SANTANDER,0,0,0,18,0,18,-100
25/03/2022 10:55,2021,1,WESTERN EUROPE-EU,SPAIN,2,HUMBERSIDE,VALENCIA,0,0,0,33,0,33,-100
25/03/2022 10:55,2021,1,WESTERN EUROPE-EU,SPAIN,2,JERSEY,BARCELONA,120,0,120,0,0,0,0
25/03/2022 10:55,2021,1,WESTERN EUROPE-EU,SPAIN,2,JERSEY,IBIZA,602,602,0,0,0,0,0
25/03/2022 10:55,2021,1,WESTERN EUROPE-EU,SPAIN,2,JERSEY,MALAGA,1339,69,1270,0,0,0,0
25/03/2022 10:55,2021,1,WESTERN EUROPE-EU,SPAIN,2,JERSEY,PALMA DE MALLORCA,4409,0,4409,707,0,707,523.62093
25/03/2022 10:55,2021,1,WESTERN EUROPE-EU,SPAIN,2,LEEDS BRADFORD,ALICANTE,63269,63269,0,62725,62537,188,0.86728
25/03/2022 10:55,2021,1,WESTERN EUROPE-EU,SPAIN,2,LEEDS BRADFORD,ALMERIA,0,0,0,261,261,0,-100
25/03/2022 10:55,2021,1,WESTERN EUROPE-EU,SPAIN,2,LEEDS BRADFORD,BARCELONA,0,0,0,5166,5166,0,-100
25/03/2022 10:55,2021,1,WESTERN EUROPE-EU,SPAIN,2,LEEDS BRADFORD,GIRONA,0,0,0,1594,1594,0,-100
25/03/2022 10:55,2021,1,WESTERN EUROPE-EU,SPAIN,2,LEEDS BRADFORD,IBIZA,19236,19236,0,6002,6002,0,220.49317
25/03/2022 10:55,2021,1,WESTERN EUROPE-EU,SPAIN,2,LEEDS BRADFORD,MAHON,12316,12316,0,1352,1352,0,810.94675
25/03/2022 10:55,2021,1,WESTERN EUROPE-EU,SPAIN,2,LEEDS BRADFORD,MALAGA,53506,53506,0,40837,40519,318,31.02334
25/03/2022 10:55,2021,1,WESTERN EUROPE-EU,SPAIN,2,LEEDS BRADFORD,MURCIA INTERNATIONAL,0,0,0,1301,1301,0,-100
25/03/2022 10:55,2021,1,WESTERN EUROPE-EU,SPAIN,2,LEEDS BRADFORD,PALMA DE MALLORCA,56845,56696,149,10657,10504,153,433.40527
25/03/2022 10:55,2021,1,WESTERN EUROPE-EU,SPAIN,2,LEEDS BRADFORD,VALENCIA,88,0,88,144,144,0,-38.88889
25/03/2022 10:55,2021,1,WESTERN EUROPE-EU,SPAIN,2,LIVERPOOL (JOHN LENNON),ALICANTE,72856,72856,0,72369,72369,0,0.67294
25/03/2022 10:55,2021,1,WESTERN EUROPE-EU,SPAIN,2,LIVERPOOL (JOHN LENNON),BARCELONA,20800,20800,0,30348,30348,0,-31.46171
25/03/2022 10:55,2021,1,WESTERN EUROPE-EU,SPAIN,2,LIVERPOOL (JOHN LENNON),BILBAO,52,0,52,0,0,0,0
25/03/2022 10:55,2021,1,WESTERN EUROPE-EU,SPAIN,2,LIVERPOOL (JOHN LENNON),GIRONA,1669,1669,0,56,56,0,2880.35714
25/03/2022 10:55,2021,1,WESTERN EUROPE-EU,SPAIN,2,LIVERPOOL (JOHN LENNON),IBIZA,7471,7471,0,3285,3285,0,127.4277
25/03/2022 10:55,2021,1,WESTERN EUROPE-EU,SPAIN,2,LIVERPOOL (JOHN LENNON),MADRID,748,0,748,16088,13243,2845,-95.35057
25/03/2022 10:55,2021,1,WESTERN EUROPE-EU,SPAIN,2,LIVERPOOL (JOHN LENNON),MALAGA,72111,71942,169,58545,58545,0,23.17192
25/03/2022 10:55,2021,1,WESTERN EUROPE-EU,SPAIN,2,LIVERPOOL (JOHN LENNON),MURCIA INTERNATIONAL,0,0,0,327,327,0,-100
25/03/2022 10:55,2021,1,WESTERN EUROPE-EU,SPAIN,2,LIVERPOOL (JOHN LENNON),PALMA DE MALLORCA,52703,52703,0,16891,16891,0,212.01823
25/03/2022 10:55,2021,1,WESTERN EUROPE-EU,SPAIN,2,LIVERPOOL (JOHN LENNON),PAMPLONA,126,0,126,0,0,0,0
25/03/2022 10:55,2021,1,WESTERN EUROPE-EU,SPAIN,2,LIVERPOOL (JOHN LENNON),REUS,2034,2034,0,2541,2541,0,-19.95277
25/03/2022 10:55,2021,1,WESTERN EUROPE-EU,SPAIN,2,MANCHESTER,ALICANTE,210732,198746,11986,168475,159695,8780,25.08206
25/03/2022 10:55,2021,1,WESTERN EUROPE-EU,SPAIN,2,MANCHESTER,ALMERIA,14022,14022,0,5649,5649,0,148.22092
25/03/2022 10:55,2021,1,WESTERN EUROPE-EU,SPAIN,2,MANCHESTER,BARCELONA,94608,94346,262,108022,108022,0,-12.41784
25/03/2022 10:55,2021,1,WESTERN EUROPE-EU,SPAIN,2,MANCHESTER,BILBAO,1471,1471,0,11217,11124,93,-86.88598
25/03/2022 10:55,2021,1,WESTERN EUROPE-EU,SPAIN,2,MANCHESTER,CASTELLON COSTA AZAHAR,313,0,313,0,0,0,0
25/03/2022 10:55,2021,1,WESTERN EUROPE-EU,SPAIN,2,MANCHESTER,GIRONA,7074,7074,0,3293,3293,0,114.81931
25/03/2022 10:55,2021,1,WESTERN EUROPE-EU,SPAIN,2,MANCHESTER,GRANADA,244,0,244,4135,4135,0,-94.09915
25/03/2022 10:55,2021,1,WESTERN EUROPE-EU,SPAIN,2,MANCHESTER,IBIZA,86565,66469,20096,16242,14288,1954,432.97008
25/03/2022 10:55,2021,1,WESTERN EUROPE-EU,SPAIN,2,MANCHESTER,JEREZ,100,0,100,0,0,0,0
25/03/2022 10:55,2021,1,WESTERN EUROPE-EU,SPAIN,2,MANCHESTER,MADRID,44468,44428,40,53752,52530,1222,-17.27192
25/03/2022 10:55,2021,1,WESTERN EUROPE-EU,SPAIN,2,MANCHESTER,MAHON,34501,22078,12423,2516,2488,28,1271.26391
25/03/2022 10:55,2021,1,WESTERN EUROPE-EU,SPAIN,2,MANCHESTER,MALAGA,161869,146951,14918,129091,118885,10206,25.39139
25/03/2022 10:55,2021,1,WESTERN EUROPE-EU,SPAIN,2,MANCHESTER,MURCIA INTERNATIONAL,35161,35161,0,24649,24649,0,42.64676
25/03/2022 10:55,2021,1,WESTERN EUROPE-EU,SPAIN,2,MANCHESTER,PALMA DE MALLORCA,213640,177479,36161,63341,59992,3349,237.28549
25/03/2022 10:55,2021,1,WESTERN EUROPE-EU,SPAIN,2,MANCHESTER,REUS,6999,5108,1891,3847,3377,470,81.93397
25/03/2022 10:55,2021,1,WESTERN EUROPE-EU,SPAIN,2,MANCHESTER,SANTANDER,8461,8461,0,0,0,0,0
25/03/2022 10:55,2021,1,WESTERN EUROPE-EU,SPAIN,2,MANCHESTER,SEVILLE,16842,16842,0,20967,20967,0,-19.67377
25/03/2022 10:55,2021,1,WESTERN EUROPE-EU,SPAIN,2,MANCHESTER,VALENCIA,17107,16517,590,14130,14130,0,21.06865
25/03/2022 10:55,2021,1,WESTERN EUROPE-EU,SPAIN,2,NEWCASTLE,ALICANTE,67903,67903,0,71764,71764,0,-5.38013
25/03/2022 10:55,2021,1,WESTERN EUROPE-EU,SPAIN,2,NEWCASTLE,BARCELONA,4228,4228,0,10432,10432,0,-59.47086
25/03/2022 10:55,2021,1,WESTERN EUROPE-EU,SPAIN,2,NEWCASTLE,IBIZA,17443,17443,0,0,0,0,0
25/03/2022 10:55,2021,1,WESTERN EUROPE-EU,SPAIN,2,NEWCASTLE,MAHON,5007,5007,0,703,703,0,612.23329
25/03/2022 10:55,2021,1,WESTERN EUROPE-EU,SPAIN,2,NEWCASTLE,MALAGA,43402,43402,0,43634,43634,0,-0.5317
25/03/2022 10:55,2021,1,WESTERN EUROPE-EU,SPAIN,2,NEWCASTLE,PALMA DE MALLORCA,56541,56541,0,11104,11104,0,409.19488
25/03/2022 10:55,2021,1,WESTERN EUROPE-EU,SPAIN,2,NEWCASTLE,VALENCIA,70,0,70,0,0,0,0
25/03/2022 10:55,2021,1,WESTERN EUROPE-EU,SPAIN,2,NEWQUAY,ALICANTE,8905,8905,0,9429,9429,0,-5.55732
25/03/2022 10:55,2021,1,WESTERN EUROPE-EU,SPAIN,2,NORWICH,PALMA DE MALLORCA,3299,0,3299,0,0,0,0
25/03/2022 10:55,2021,1,WESTERN EUROPE-EU,SPAIN,2,OXFORD (KIDLINGTON),GIRONA,0,0,0,121,121,0,-100
25/03/2022 10:55,2021,1,WESTERN EUROPE-EU,SPAIN,2,PRESTWICK,ALICANTE,21235,21235,0,19767,19767,0,7.42652
25/03/2022 10:55,2021,1,WESTERN EUROPE-EU,SPAIN,2,PRESTWICK,BARCELONA,1654,1654,0,2137,2137,0,-22.60178
25/03/2022 10:55,2021,1,WESTERN EUROPE-EU,SPAIN,2,PRESTWICK,IBIZA,1685,1685,0,1770,1770,0,-4.80226
25/03/2022 10:55,2021,1,WESTERN EUROPE-EU,SPAIN,2,PRESTWICK,MALAGA,11057,11057,0,12935,12935,0,-14.51875
25/03/2022 10:55,2021,1,WESTERN EUROPE-EU,SPAIN,2,PRESTWICK,MURCIA INTERNATIONAL,7389,7389,0,3287,3287,0,124.79465
25/03/2022 10:55,2021,1,WESTERN EUROPE-EU,SPAIN,2,PRESTWICK,PALMA DE MALLORCA,4922,4922,0,4181,4181,0,17.72303
25/03/2022 10:55,2021,1,WESTERN EUROPE-EU,SPAIN,2,PRESTWICK,VALENCIA,0,0,0,212,212,0,-100
25/03/2022 10:55,2021,1,WESTERN EUROPE-EU,SPAIN,2,SOUTHAMPTON,ALICANTE,1809,1809,0,0,0,0,0
25/03/2022 10:55,2021,1,WESTERN EUROPE-EU,SPAIN,2,SOUTHAMPTON,IBIZA,2619,2619,0,0,0,0,0
25/03/2022 10:55,2021,1,WESTERN EUROPE-EU,SPAIN,2,SOUTHAMPTON,MALAGA,2854,2854,0,0,0,0,0
25/03/2022 10:55,2021,1,WESTERN EUROPE-EU,SPAIN,2,SOUTHAMPTON,PALMA DE MALLORCA,3516,3516,0,0,0,0,0
25/03/2022 10:55,2021,1,WESTERN EUROPE-EU,SPAIN,2,TEESSIDE INTERNATIONAL AIRPORT,ALICANTE,11260,11260,0,0,0,0,0
25/03/2022 10:55,2021,1,WESTERN EUROPE-EU,SPAIN,2,TEESSIDE INTERNATIONAL AIRPORT,PALMA DE MALLORCA,5365,5365,0,0,0,0,0
25/03/2022 10:55,2021,1,WESTERN EUROPE-EU,SPAIN(CANARY ISLANDS),1,GATWICK,ARRECIFE,79706,60120,19586,90702,75835,14867,-12.12322
25/03/2022 10:55,2021,1,WESTERN EUROPE-EU,SPAIN(CANARY ISLANDS),1,GATWICK,FUERTEVENTURA,41416,25258,16158,47519,36951,10568,-12.84328
25/03/2022 10:55,2021,1,WESTERN EUROPE-EU,SPAIN(CANARY ISLANDS),1,GATWICK,LAS PALMAS,51743,30051,21692,67548,50833,16715,-23.39818
25/03/2022 10:55,2021,1,WESTERN EUROPE-EU,SPAIN(CANARY ISLANDS),1,GATWICK,SANTA CRUZ DE LA PALMA,1746,0,1746,11241,7354,3887,-84.46757
25/03/2022 10:55,2021,1,WESTERN EUROPE-EU,SPAIN(CANARY ISLANDS),1,GATWICK,TENERIFE (SURREINA SOFIA),116565,86963,29602,173219,146771,26448,-32.70657
25/03/2022 10:55,2021,1,WESTERN EUROPE-EU,SPAIN(CANARY ISLANDS),1,HEATHROW,ARRECIFE,31138,31138,0,5568,5568,0,459.23132
25/03/2022 10:55,2021,1,WESTERN EUROPE-EU,SPAIN(CANARY ISLANDS),1,HEATHROW,LAS PALMAS,10104,9943,161,4249,3380,869,137.79713
25/03/2022 10:55,2021,1,WESTERN EUROPE-EU,SPAIN(CANARY ISLANDS),1,HEATHROW,TENERIFE (SURREINA SOFIA),72329,72329,0,20453,20453,0,253.63516
25/03/2022 10:55,2021,1,WESTERN EUROPE-EU,SPAIN(CANARY ISLANDS),1,LUTON,ARRECIFE,25164,21598,3566,25182,23180,2002,-0.07148
25/03/2022 10:55,2021,1,WESTERN EUROPE-EU,SPAIN(CANARY ISLANDS),1,LUTON,FUERTEVENTURA,23531,23531,0,7570,7570,0,210.84544
25/03/2022 10:55,2021,1,WESTERN EUROPE-EU,SPAIN(CANARY ISLANDS),1,LUTON,LAS PALMAS,23142,23142,0,12464,12271,193,85.67073
25/03/2022 10:55,2021,1,WESTERN EUROPE-EU,SPAIN(CANARY ISLANDS),1,LUTON,TENERIFE (SURREINA SOFIA),62720,59944,2776,62768,58618,4150,-0.07647
25/03/2022 10:55,2021,1,WESTERN EUROPE-EU,SPAIN(CANARY ISLANDS),1,SOUTHEND,ARRECIFE,0,0,0,7300,7300,0,-100
25/03/2022 10:55,2021,1,WESTERN EUROPE-EU,SPAIN(CANARY ISLANDS),1,SOUTHEND,TENERIFE (SURREINA SOFIA),0,0,0,6460,6460,0,-100
25/03/2022 10:55,2021,1,WESTERN EUROPE-EU,SPAIN(CANARY ISLANDS),1,STANSTED,ARRECIFE,71258,71258,0,68767,67090,1677,3.62238
25/03/2022 10:55,2021,1,WESTERN EUROPE-EU,SPAIN(CANARY ISLANDS),1,STANSTED,FUERTEVENTURA,37393,37393,0,48559,48559,0,-22.99471
25/03/2022 10:55,2021,1,WESTERN EUROPE-EU,SPAIN(CANARY ISLANDS),1,STANSTED,LAS PALMAS,56475,50306,6169,57111,52642,4469,-1.11362
25/03/2022 10:55,2021,1,WESTERN EUROPE-EU,SPAIN(CANARY ISLANDS),1,STANSTED,TENERIFE (SURREINA SOFIA),121754,118247,3507,105751,99417,6334,15.13272
25/03/2022 10:55,2021,1,WESTERN EUROPE-EU,SPAIN(CANARY ISLANDS),2,ABERDEEN,LAS PALMAS,42,0,42,88,0,88,-52.27273
25/03/2022 10:55,2021,1,WESTERN EUROPE-EU,SPAIN(CANARY ISLANDS),2,ABERDEEN,TENERIFE (SURREINA SOFIA),6983,0,6983,9680,0,9680,-27.86157
25/03/2022 10:55,2021,1,WESTERN EUROPE-EU,SPAIN(CANARY ISLANDS),2,BELFAST INTERNATIONAL,ARRECIFE,23553,23403,150,22706,22351,355,3.73029
25/03/2022 10:55,2021,1,WESTERN EUROPE-EU,SPAIN(CANARY ISLANDS),2,BELFAST INTERNATIONAL,FUERTEVENTURA,3045,3045,0,11175,11175,0,-72.75168
25/03/2022 10:55,2021,1,WESTERN EUROPE-EU,SPAIN(CANARY ISLANDS),2,BELFAST INTERNATIONAL,LAS PALMAS,8133,8133,0,6458,6458,0,25.93682
25/03/2022 10:55,2021,1,WESTERN EUROPE-EU,SPAIN(CANARY ISLANDS),2,BELFAST INTERNATIONAL,TENERIFE (SURREINA SOFIA),33593,33593,0,24258,24076,182,38.48215
25/03/2022 10:55,2021,1,WESTERN EUROPE-EU,SPAIN(CANARY ISLANDS),2,BIGGIN HILL,LAS PALMAS,12,0,12,5,0,5,140
25/03/2022 10:55,2021,1,WESTERN EUROPE-EU,SPAIN(CANARY ISLANDS),2,BIRMINGHAM,ARRECIFE,60623,43341,17282,59417,47602,11815,2.02972
25/03/2022 10:55,2021,1,WESTERN EUROPE-EU,SPAIN(CANARY ISLANDS),2,BIRMINGHAM,FUERTEVENTURA,33786,24606,9180,37905,31810,6095,-10.86664
25/03/2022 10:55,2021,1,WESTERN EUROPE-EU,SPAIN(CANARY ISLANDS),2,BIRMINGHAM,LAS PALMAS,43202,24685,18517,36600,28404,8196,18.03825
25/03/2022 10:55,2021,1,WESTERN EUROPE-EU,SPAIN(CANARY ISLANDS),2,BIRMINGHAM,TENERIFE (SURREINA SOFIA),93384,74766,18618,99402,78708,20694,-6.0542
25/03/2022 10:55,2021,1,WESTERN EUROPE-EU,SPAIN(CANARY ISLANDS),2,BOURNEMOUTH,ARRECIFE,8153,0,8153,8487,0,8487,-3.93543
25/03/2022 10:55,2021,1,WESTERN EUROPE-EU,SPAIN(CANARY ISLANDS),2,BOURNEMOUTH,LAS PALMAS,4291,1280,3011,7495,3763,3732,-42.7485
25/03/2022 10:55,2021,1,WESTERN EUROPE-EU,SPAIN(CANARY ISLANDS),2,BOURNEMOUTH,TENERIFE (SURREINA SOFIA),12877,6164,6713,13856,5702,8154,-7.06553
25/03/2022 10:55,2021,1,WESTERN EUROPE-EU,SPAIN(CANARY ISLANDS),2,BRISTOL,ARRECIFE,46477,38698,7779,40936,32122,8814,13.53576
25/03/2022 10:55,2021,1,WESTERN EUROPE-EU,SPAIN(CANARY ISLANDS),2,BRISTOL,FUERTEVENTURA,18612,14606,4006,15766,11226,4540,18.0515
25/03/2022 10:55,2021,1,WESTERN EUROPE-EU,SPAIN(CANARY ISLANDS),2,BRISTOL,LAS PALMAS,28529,22895,5634,22267,17926,4341,28.12233
25/03/2022 10:55,2021,1,WESTERN EUROPE-EU,SPAIN(CANARY ISLANDS),2,BRISTOL,TENERIFE (SURREINA SOFIA),68196,62634,5562,58637,46942,11695,16.30199
25/03/2022 10:55,2021,1,WESTERN EUROPE-EU,SPAIN(CANARY ISLANDS),2,CARDIFF WALES,ARRECIFE,6847,0,6847,8300,0,8300,-17.50602
25/03/2022 10:55,2021,1,WESTERN EUROPE-EU,SPAIN(CANARY ISLANDS),2,CARDIFF WALES,LAS PALMAS,3276,0,3276,3962,0,3962,-17.31449
25/03/2022 10:55,2021,1,WESTERN EUROPE-EU,SPAIN(CANARY ISLANDS),2,CARDIFF WALES,TENERIFE (SURREINA SOFIA),10107,0,10107,12006,578,11428,-15.81709
25/03/2022 10:55,2021,1,WESTERN EUROPE-EU,SPAIN(CANARY ISLANDS),2,DONCASTER SHEFFIELD,ARRECIFE,18441,2194,16247,9967,472,9495,85.02057
25/03/2022 10:55,2021,1,WESTERN EUROPE-EU,SPAIN(CANARY ISLANDS),2,DONCASTER SHEFFIELD,FUERTEVENTURA,1292,1292,0,0,0,0,0
25/03/2022 10:55,2021,1,WESTERN EUROPE-EU,SPAIN(CANARY ISLANDS),2,DONCASTER SHEFFIELD,LAS PALMAS,5934,0,5934,4914,532,4382,20.75702
25/03/2022 10:55,2021,1,WESTERN EUROPE-EU,SPAIN(CANARY ISLANDS),2,DONCASTER SHEFFIELD,TENERIFE (SURREINA SOFIA),19966,5307,14659,14174,733,13441,40.86355
25/03/2022 10:55,2021,1,WESTERN EUROPE-EU,SPAIN(CANARY ISLANDS),2,EAST MIDLANDS INTERNATIONAL,ARRECIFE,46263,42179,4084,47668,43207,4461,-2.94747
25/03/2022 10:55,2021,1,WESTERN EUROPE-EU,SPAIN(CANARY ISLANDS),2,EAST MIDLANDS INTERNATIONAL,FUERTEVENTURA,17895,17895,0,28212,23960,4252,-36.56954
25/03/2022 10:55,2021,1,WESTERN EUROPE-EU,SPAIN(CANARY ISLANDS),2,EAST MIDLANDS INTERNATIONAL,LAS PALMAS,13243,13243,0,20760,20760,0,-36.20906
25/03/2022 10:55,2021,1,WESTERN EUROPE-EU,SPAIN(CANARY ISLANDS),2,EAST MIDLANDS INTERNATIONAL,TENERIFE (NORTE LOS RODEOS),90,90,0,0,0,0,0
25/03/2022 10:55,2021,1,WESTERN EUROPE-EU,SPAIN(CANARY ISLANDS),2,EAST MIDLANDS INTERNATIONAL,TENERIFE (SURREINA SOFIA),72768,61526,11242,79490,67843,11647,-8.45641
25/03/2022 10:55,2021,1,WESTERN EUROPE-EU,SPAIN(CANARY ISLANDS),2,EDINBURGH,ARRECIFE,32386,31395,991,33449,29339,4110,-3.17797
25/03/2022 10:55,2021,1,WESTERN EUROPE-EU,SPAIN(CANARY ISLANDS),2,EDINBURGH,FUERTEVENTURA,18336,18336,0,22534,22534,0,-18.62963
25/03/2022 10:55,2021,1,WESTERN EUROPE-EU,SPAIN(CANARY ISLANDS),2,EDINBURGH,LAS PALMAS,16991,16991,0,17642,17642,0,-3.69006
25/03/2022 10:55,2021,1,WESTERN EUROPE-EU,SPAIN(CANARY ISLANDS),2,EDINBURGH,TENERIFE (SURREINA SOFIA),68838,63718,5120,81297,72449,8848,-15.32529
25/03/2022 10:55,2021,1,WESTERN EUROPE-EU,SPAIN(CANARY ISLANDS),2,EXETER,ARRECIFE,5970,0,5970,8586,0,8586,-30.4682
25/03/2022 10:55,2021,1,WESTERN EUROPE-EU,SPAIN(CANARY ISLANDS),2,EXETER,LAS PALMAS,2836,0,2836,3869,0,3869,-26.69941
25/03/2022 10:55,2021,1,WESTERN EUROPE-EU,SPAIN(CANARY ISLANDS),2,EXETER,TENERIFE (SURREINA SOFIA),5821,0,5821,12498,0,12498,-53.42455
25/03/2022 10:55,2021,1,WESTERN EUROPE-EU,SPAIN(CANARY ISLANDS),2,GLASGOW,ARRECIFE,27134,19561,7573,29549,24612,4937,-8.17287
25/03/2022 10:55,2021,1,WESTERN EUROPE-EU,SPAIN(CANARY ISLANDS),2,GLASGOW,FUERTEVENTURA,6667,6667,0,13203,13203,0,-49.5039
25/03/2022 10:55,2021,1,WESTERN EUROPE-EU,SPAIN(CANARY ISLANDS),2,GLASGOW,LAS PALMAS,18967,15454,3513,22193,17903,4290,-14.53611
25/03/2022 10:55,2021,1,WESTERN EUROPE-EU,SPAIN(CANARY ISLANDS),2,GLASGOW,TENERIFE (SURREINA SOFIA),52371,45392,6979,53134,46051,7083,-1.43599
25/03/2022 10:55,2021,1,WESTERN EUROPE-EU,SPAIN(CANARY ISLANDS),2,JERSEY,TENERIFE (SURREINA SOFIA),198,0,198,1296,0,1296,-84.72222
25/03/2022 10:55,2021,1,WESTERN EUROPE-EU,SPAIN(CANARY ISLANDS),2,LEEDS BRADFORD,ARRECIFE,34465,34465,0,28175,27987,188,22.32476
25/03/2022 10:55,2021,1,WESTERN EUROPE-EU,SPAIN(CANARY ISLANDS),2,LEEDS BRADFORD,FUERTEVENTURA,12889,12889,0,11830,11830,0,8.95182
25/03/2022 10:55,2021,1,WESTERN EUROPE-EU,SPAIN(CANARY ISLANDS),2,LEEDS BRADFORD,LAS PALMAS,13267,13267,0,13993,13993,0,-5.18831
25/03/2022 10:55,2021,1,WESTERN EUROPE-EU,SPAIN(CANARY ISLANDS),2,LEEDS BRADFORD,TENERIFE (SURREINA SOFIA),49187,49187,0,51475,51286,189,-4.44488
25/03/2022 10:55,2021,1,WESTERN EUROPE-EU,SPAIN(CANARY ISLANDS),2,LIVERPOOL (JOHN LENNON),ARRECIFE,12650,12650,0,22576,22576,0,-43.96704
25/03/2022 10:55,2021,1,WESTERN EUROPE-EU,SPAIN(CANARY ISLANDS),2,LIVERPOOL (JOHN LENNON),FUERTEVENTURA,5396,5396,0,14390,14390,0,-62.50174
25/03/2022 10:55,2021,1,WESTERN EUROPE-EU,SPAIN(CANARY ISLANDS),2,LIVERPOOL (JOHN LENNON),TENERIFE (SURREINA SOFIA),11745,11745,0,13193,13193,0,-10.97552
25/03/2022 10:55,2021,1,WESTERN EUROPE-EU,SPAIN(CANARY ISLANDS),2,MANCHESTER,ARRECIFE,138152,110052,28100,125593,106847,18746,9.99976
25/03/2022 10:55,2021,1,WESTERN EUROPE-EU,SPAIN(CANARY ISLANDS),2,MANCHESTER,FUERTEVENTURA,64206,47034,17172,56258,40964,15294,14.12777
25/03/2022 10:55,2021,1,WESTERN EUROPE-EU,SPAIN(CANARY ISLANDS),2,MANCHESTER,LAS PALMAS,81821,50532,31289,59701,40646,19055,37.05131
25/03/2022 10:55,2021,1,WESTERN EUROPE-EU,SPAIN(CANARY ISLANDS),2,MANCHESTER,SANTA CRUZ DE LA PALMA,1620,0,1620,3900,0,3900,-58.46154
25/03/2022 10:55,2021,1,WESTERN EUROPE-EU,SPAIN(CANARY ISLANDS),2,MANCHESTER,TENERIFE (NORTE LOS RODEOS),0,0,0,101,101,0,-100
25/03/2022 10:55,2021,1,WESTERN EUROPE-EU,SPAIN(CANARY ISLANDS),2,MANCHESTER,TENERIFE (SURREINA SOFIA),251043,216257,34786,236539,199190,37349,6.13176
25/03/2022 10:55,2021,1,WESTERN EUROPE-EU,SPAIN(CANARY ISLANDS),2,NEWCASTLE,ARRECIFE,28333,28333,0,27138,27138,0,4.40342
25/03/2022 10:55,2021,1,WESTERN EUROPE-EU,SPAIN(CANARY ISLANDS),2,NEWCASTLE,FUERTEVENTURA,9739,9739,0,10923,10923,0,-10.83951
25/03/2022 10:55,2021,1,WESTERN EUROPE-EU,SPAIN(CANARY ISLANDS),2,NEWCASTLE,LAS PALMAS,13892,13892,0,13619,13619,0,2.00455
25/03/2022 10:55,2021,1,WESTERN EUROPE-EU,SPAIN(CANARY ISLANDS),2,NEWCASTLE,TENERIFE (SURREINA SOFIA),59887,59887,0,50864,50718,146,17.73946
25/03/2022 10:55,2021,1,WESTERN EUROPE-EU,SPAIN(CANARY ISLANDS),2,NORWICH,TENERIFE (SURREINA SOFIA),4593,0,4593,3763,0,3763,22.05687
25/03/2022 10:55,2021,1,WESTERN EUROPE-EU,SPAIN(CANARY ISLANDS),2,PRESTWICK,ARRECIFE,2289,2289,0,7424,7424,0,-69.16756
25/03/2022 10:55,2021,1,WESTERN EUROPE-EU,SPAIN(CANARY ISLANDS),2,PRESTWICK,FUERTEVENTURA,0,0,0,174,0,174,-100
25/03/2022 10:55,2021,1,WESTERN EUROPE-EU,SPAIN(CANARY ISLANDS),2,PRESTWICK,TENERIFE (SURREINA SOFIA),19869,19869,0,17340,17340,0,14.58478
25/03/2022 10:55,2021,1,WESTERN EUROPE-EU,SWEDEN,1,GATWICK,GOTEBORG (LANDVETTER),0,0,0,24791,24791,0,-100
25/03/2022 10:55,2021,1,WESTERN EUROPE-EU,SWEDEN,1,GATWICK,MALMO,285,0,285,0,0,0,0
25/03/2022 10:55,2021,1,WESTERN EUROPE-EU,SWEDEN,1,GATWICK,OSTERSUND / FROSON,0,0,0,5744,5744,0,-100
25/03/2022 10:55,2021,1,WESTERN EUROPE-EU,SWEDEN,1,GATWICK,PAJALA YLLAS,178,0,178,0,0,0,0
25/03/2022 10:55,2021,1,WESTERN EUROPE-EU,SWEDEN,1,GATWICK,STOCKHOLM (ARLANDA),28071,28071,0,86018,85933,85,-67.36613
25/03/2022 10:55,2021,1,WESTERN EUROPE-EU,SWEDEN,1,HEATHROW,GOTEBORG (LANDVETTER),26756,26756,0,63840,63840,0,-58.08897
25/03/2022 10:55,2021,1,WESTERN EUROPE-EU,SWEDEN,1,HEATHROW,KIRUNA,0,0,0,1248,0,1248,-100
25/03/2022 10:55,2021,1,WESTERN EUROPE-EU,SWEDEN,1,HEATHROW,SCANDINAVIAN MOUNTAINS AIRPORT,0,0,0,553,553,0,-100
25/03/2022 10:55,2021,1,WESTERN EUROPE-EU,SWEDEN,1,HEATHROW,STOCKHOLM (ARLANDA),171246,171246,0,261011,261011,0,-34.39127
25/03/2022 10:55,2021,1,WESTERN EUROPE-EU,SWEDEN,1,LUTON,MALMO,205,0,205,0,0,0,0
25/03/2022 10:55,2021,1,WESTERN EUROPE-EU,SWEDEN,1,STANSTED,GOTEBORG (LANDVETTER),38917,38917,0,46001,46001,0,-15.39967
25/03/2022 10:55,2021,1,WESTERN EUROPE-EU,SWEDEN,1,STANSTED,HALMSTAD,0,0,0,346,0,346,-100
25/03/2022 10:55,2021,1,WESTERN EUROPE-EU,SWEDEN,1,STANSTED,STOCKHOLM (ARLANDA),18676,18495,181,0,0,0,0
25/03/2022 10:55,2021,1,WESTERN EUROPE-EU,SWEDEN,1,STANSTED,STOCKHOLM (SKAVSTA),15342,15342,0,48158,48158,0,-68.14236
25/03/2022 10:55,2021,1,WESTERN EUROPE-EU,SWEDEN,1,STANSTED,VASTERAS,16882,16882,0,20031,20031,0,-15.72063
25/03/2022 10:55,2021,1,WESTERN EUROPE-EU,SWEDEN,2,ABERDEEN,GOTEBORG (LANDVETTER),206,0,206,0,0,0,0
25/03/2022 10:55,2021,1,WESTERN EUROPE-EU,SWEDEN,2,ABERDEEN,RONNEBY,105,0,105,36,0,36,191.66667
25/03/2022 10:55,2021,1,WESTERN EUROPE-EU,SWEDEN,2,BIGGIN HILL,GOTEBORG (LANDVETTER),8,0,8,0,0,0,0
25/03/2022 10:55,2021,1,WESTERN EUROPE-EU,SWEDEN,2,BIGGIN HILL,MALMO,4,0,4,0,0,0,0
25/03/2022 10:55,2021,1,WESTERN EUROPE-EU,SWEDEN,2,BIGGIN HILL,STOCKHOLM (BROMMA),4,0,4,0,0,0,0
25/03/2022 10:55,2021,1,WESTERN EUROPE-EU,SWEDEN,2,BIRMINGHAM,GOTEBORG (LANDVETTER),0,0,0,299,0,299,-100
25/03/2022 10:55,2021,1,WESTERN EUROPE-EU,SWEDEN,2,BIRMINGHAM,PAJALA YLLAS,368,0,368,0,0,0,0
25/03/2022 10:55,2021,1,WESTERN EUROPE-EU,SWEDEN,2,BIRMINGHAM,SCANDINAVIAN MOUNTAINS AIRPORT,238,0,238,0,0,0,0
25/03/2022 10:55,2021,1,WESTERN EUROPE-EU,SWEDEN,2,BIRMINGHAM,STOCKHOLM (ARLANDA),0,0,0,149,149,0,-100
25/03/2022 10:55,2021,1,WESTERN EUROPE-EU,SWEDEN,2,BIRMINGHAM,VASTERAS,0,0,0,173,173,0,-100
25/03/2022 10:55,2021,1,WESTERN EUROPE-EU,SWEDEN,2,BOURNEMOUTH,PAJALA YLLAS,351,0,351,0,0,0,0
25/03/2022 10:55,2021,1,WESTERN EUROPE-EU,SWEDEN,2,CARDIFF WALES,PAJALA YLLAS,360,0,360,0,0,0,0
25/03/2022 10:55,2021,1,WESTERN EUROPE-EU,SWEDEN,2,EAST MIDLANDS INTERNATIONAL,PAJALA YLLAS,170,0,170,0,0,0,0
25/03/2022 10:55,2021,1,WESTERN EUROPE-EU,SWEDEN,2,EDINBURGH,GOTEBORG (LANDVETTER),5085,5085,0,7281,7281,0,-30.16069
25/03/2022 10:55,2021,1,WESTERN EUROPE-EU,SWEDEN,2,EDINBURGH,RONNEBY,15,0,15,0,0,0,0
25/03/2022 10:55,2021,1,WESTERN EUROPE-EU,SWEDEN,2,EDINBURGH,STOCKHOLM (ARLANDA),7437,7437,0,9867,9867,0,-24.62755
25/03/2022 10:55,2021,1,WESTERN EUROPE-EU,SWEDEN,2,EDINBURGH,STOCKHOLM (SKAVSTA),0,0,0,613,613,0,-100
25/03/2022 10:55,2021,1,WESTERN EUROPE-EU,SWEDEN,2,EXETER,PAJALA YLLAS,336,0,336,0,0,0,0
25/03/2022 10:55,2021,1,WESTERN EUROPE-EU,SWEDEN,2,GLASGOW,GOTEBORG (LANDVETTER),165,0,165,0,0,0,0
25/03/2022 10:55,2021,1,WESTERN EUROPE-EU,SWEDEN,2,GLASGOW,MALMO,201,47,154,0,0,0,0
25/03/2022 10:55,2021,1,WESTERN EUROPE-EU,SWEDEN,2,GLASGOW,PAJALA YLLAS,336,0,336,0,0,0,0
25/03/2022 10:55,2021,1,WESTERN EUROPE-EU,SWEDEN,2,GLASGOW,STOCKHOLM (ARLANDA),72,0,72,0,0,0,0
25/03/2022 10:55,2021,1,WESTERN EUROPE-EU,SWEDEN,2,HUMBERSIDE,PAJALA YLLAS,720,0,720,0,0,0,0
25/03/2022 10:55,2021,1,WESTERN EUROPE-EU,SWEDEN,2,LEEDS BRADFORD,PAJALA YLLAS,170,170,0,0,0,0,0
25/03/2022 10:55,2021,1,WESTERN EUROPE-EU,SWEDEN,2,LIVERPOOL (JOHN LENNON),PAJALA YLLAS,360,0,360,0,0,0,0
25/03/2022 10:55,2021,1,WESTERN EUROPE-EU,SWEDEN,2,LIVERPOOL (JOHN LENNON),STOCKHOLM (ARLANDA),2775,2775,0,0,0,0,0
25/03/2022 10:55,2021,1,WESTERN EUROPE-EU,SWEDEN,2,MANCHESTER,GOTEBORG (LANDVETTER),6811,6811,0,10841,10789,52,-37.17369
25/03/2022 10:55,2021,1,WESTERN EUROPE-EU,SWEDEN,2,MANCHESTER,STOCKHOLM (ARLANDA),14446,14446,0,33196,33196,0,-56.48271
25/03/2022 10:55,2021,1,WESTERN EUROPE-EU,SWEDEN,2,NEWCASTLE,RONNEBY,11,0,11,0,0,0,0
25/03/2022 10:55,2021,1,WESTERN EUROPE-EU,SWEDEN,2,NORWICH,PAJALA YLLAS,179,0,179,0,0,0,0
25/03/2022 10:55,2021,2,WESTERN EUROPE-OTHER,BOSNIA-HERZEGOVINA,1,HEATHROW,SARAJEVO,0,0,0,193,0,193,-100
25/03/2022 10:55,2021,2,WESTERN EUROPE-OTHER,BOSNIA-HERZEGOVINA,1,LUTON,SARAJEVO,0,0,0,1097,1097,0,-100
25/03/2022 10:55,2021,2,WESTERN EUROPE-OTHER,BOSNIA-HERZEGOVINA,1,STANSTED,SARAJEVO,38,0,38,0,0,0,0
25/03/2022 10:55,2021,2,WESTERN EUROPE-OTHER,BOSNIA-HERZEGOVINA,2,BELFAST INTERNATIONAL,BANJA LUKA,158,0,158,0,0,0,0
25/03/2022 10:55,2021,2,WESTERN EUROPE-OTHER,BOSNIA-HERZEGOVINA,2,BELFAST INTERNATIONAL,MOSTAR,97,0,97,0,0,0,0
25/03/2022 10:55,2021,2,WESTERN EUROPE-OTHER,BOSNIA-HERZEGOVINA,2,BELFAST INTERNATIONAL,SARAJEVO,60,0,60,110,0,110,-45.45455
25/03/2022 10:55,2021,2,WESTERN EUROPE-OTHER,BOSNIA-HERZEGOVINA,2,BIGGIN HILL,SARAJEVO,8,0,8,0,0,0,0
25/03/2022 10:55,2021,2,WESTERN EUROPE-OTHER,BOSNIA-HERZEGOVINA,2,CARDIFF WALES,SARAJEVO,0,0,0,138,0,138,-100
25/03/2022 10:55,2021,2,WESTERN EUROPE-OTHER,BOSNIA-HERZEGOVINA,2,GLASGOW,SARAJEVO,0,0,0,98,0,98,-100
25/03/2022 10:55,2021,2,WESTERN EUROPE-OTHER,FAROE ISLANDS,2,ABERDEEN,VAGAR,338,0,338,77,0,77,338.96104
25/03/2022 10:55,2021,2,WESTERN EUROPE-OTHER,FAROE ISLANDS,2,BELFAST CITY (GEORGE BEST),VAGAR,0,0,0,30,0,30,-100
25/03/2022 10:55,2021,2,WESTERN EUROPE-OTHER,FAROE ISLANDS,2,BELFAST INTERNATIONAL,VAGAR,0,0,0,160,0,160,-100
25/03/2022 10:55,2021,2,WESTERN EUROPE-OTHER,FAROE ISLANDS,2,CARDIFF WALES,VAGAR,0,0,0,145,0,145,-100
25/03/2022 10:55,2021,2,WESTERN EUROPE-OTHER,FAROE ISLANDS,2,EDINBURGH,VAGAR,2802,2802,0,1481,1481,0,89.19649
25/03/2022 10:55,2021,2,WESTERN EUROPE-OTHER,FAROE ISLANDS,2,GLASGOW,VAGAR,144,0,144,0,0,0,0
25/03/2022 10:55,2021,2,WESTERN EUROPE-OTHER,FAROE ISLANDS,2,LIVERPOOL (JOHN LENNON),VAGAR,0,0,0,74,0,74,-100
25/03/2022 10:55,2021,2,WESTERN EUROPE-OTHER,ICELAND,1,GATWICK,KEFLAVIK,16614,15893,721,55627,49563,6064,-70.13321
25/03/2022 10:55,2021,2,WESTERN EUROPE-OTHER,ICELAND,1,HEATHROW,KEFLAVIK,110691,110691,0,87484,87458,26,26.52714
25/03/2022 10:55,2021,2,WESTERN EUROPE-OTHER,ICELAND,1,HEATHROW,REYKJAVIK,0,0,0,20,0,20,-100
25/03/2022 10:55,2021,2,WESTERN EUROPE-OTHER,ICELAND,1,LUTON,KEFLAVIK,34636,34636,0,81270,81270,0,-57.38157
25/03/2022 10:55,2021,2,WESTERN EUROPE-OTHER,ICELAND,1,STANSTED,KEFLAVIK,18083,18083,0,189,0,189,9467.72487
25/03/2022 10:55,2021,2,WESTERN EUROPE-OTHER,ICELAND,2,ABERDEEN,KEFLAVIK,98,0,98,0,0,0,0
25/03/2022 10:55,2021,2,WESTERN EUROPE-OTHER,ICELAND,2,ABERDEEN,REYKJAVIK,80,0,80,0,0,0,0
25/03/2022 10:55,2021,2,WESTERN EUROPE-OTHER,ICELAND,2,BELFAST INTERNATIONAL,KEFLAVIK,125,0,125,6592,6592,0,-98.10376
25/03/2022 10:55,2021,2,WESTERN EUROPE-OTHER,ICELAND,2,BIRMINGHAM,KEFLAVIK,3239,3239,0,725,725,0,346.75862
25/03/2022 10:55,2021,2,WESTERN EUROPE-OTHER,ICELAND,2,BRISTOL,KEFLAVIK,4283,4283,0,12534,9251,3283,-65.82895
25/03/2022 10:55,2021,2,WESTERN EUROPE-OTHER,ICELAND,2,DONCASTER SHEFFIELD,KEFLAVIK,0,0,0,5,0,5,-100
25/03/2022 10:55,2021,2,WESTERN EUROPE-OTHER,ICELAND,2,EAST MIDLANDS INTERNATIONAL,KEFLAVIK,477,477,0,636,636,0,-25
25/03/2022 10:55,2021,2,WESTERN EUROPE-OTHER,ICELAND,2,EDINBURGH,AKUREYRI,153,0,153,0,0,0,0
25/03/2022 10:55,2021,2,WESTERN EUROPE-OTHER,ICELAND,2,EDINBURGH,KEFLAVIK,10585,10373,212,16906,16906,0,-37.38909
25/03/2022 10:55,2021,2,WESTERN EUROPE-OTHER,ICELAND,2,GLASGOW,EGILSSTADIR,319,0,319,0,0,0,0
25/03/2022 10:55,2021,2,WESTERN EUROPE-OTHER,ICELAND,2,GLASGOW,KEFLAVIK,2534,2534,0,15673,15584,89,-83.83207
25/03/2022 10:55,2021,2,WESTERN EUROPE-OTHER,ICELAND,2,GLASGOW,REYKJAVIK,0,0,0,30,0,30,-100
25/03/2022 10:55,2021,2,WESTERN EUROPE-OTHER,ICELAND,2,LEEDS BRADFORD,KEFLAVIK,437,437,0,720,720,0,-39.30556
25/03/2022 10:55,2021,2,WESTERN EUROPE-OTHER,ICELAND,2,MANCHESTER,KEFLAVIK,44257,43589,668,60655,54077,6578,-27.03487
25/03/2022 10:55,2021,2,WESTERN EUROPE-OTHER,ICELAND,2,NEWCASTLE,KEFLAVIK,1083,1083,0,738,738,0,46.74797
25/03/2022 10:55,2021,2,WESTERN EUROPE-OTHER,KOSOVO,1,GATWICK,PRISTINA,154,0,154,110,0,110,40
25/03/2022 10:55,2021,2,WESTERN EUROPE-OTHER,KOSOVO,1,HEATHROW,PRISTINA,8032,8032,0,2139,2139,0,275.50257
25/03/2022 10:55,2021,2,WESTERN EUROPE-OTHER,KOSOVO,1,LUTON,PRISTINA,45948,45948,0,36685,36685,0,25.2501
25/03/2022 10:55,2021,2,WESTERN EUROPE-OTHER,KOSOVO,1,STANSTED,PRISTINA,0,0,0,112,0,112,-100
25/03/2022 10:55,2021,2,WESTERN EUROPE-OTHER,KOSOVO,2,MANCHESTER,PRISTINA,116,0,116,0,0,0,0
25/03/2022 10:55,2021,2,WESTERN EUROPE-OTHER,MACEDONIA,1,LUTON,OHRID,0,0,0,8821,8821,0,-100
25/03/2022 10:55,2021,2,WESTERN EUROPE-OTHER,MACEDONIA,1,LUTON,SKOPJE,39536,39536,0,18765,18575,190,110.69011
25/03/2022 10:55,2021,2,WESTERN EUROPE-OTHER,MACEDONIA,2,BELFAST INTERNATIONAL,SKOPJE,80,0,80,0,0,0,0
25/03/2022 10:55,2021,2,WESTERN EUROPE-OTHER,MACEDONIA,2,BIGGIN HILL,SKOPJE,2,0,2,0,0,0,0
25/03/2022 10:55,2021,2,WESTERN EUROPE-OTHER,NORWAY,1,GATWICK,BERGEN,15072,14863,209,35853,34581,1272,-57.96168
25/03/2022 10:55,2021,2,WESTERN EUROPE-OTHER,NORWAY,1,GATWICK,OSLO (GARDERMOEN),51076,51076,0,92689,92689,0,-44.8953
25/03/2022 10:55,2021,2,WESTERN EUROPE-OTHER,NORWAY,1,GATWICK,STAVANGER,8532,8532,0,13709,13709,0,-37.76351
25/03/2022 10:55,2021,2,WESTERN EUROPE-OTHER,NORWAY,1,GATWICK,TROMSOE,1300,1300,0,14335,14335,0,-90.93129
25/03/2022 10:55,2021,2,WESTERN EUROPE-OTHER,NORWAY,1,GATWICK,TRONDHEIM (VAERNES),1109,1109,0,8040,8040,0,-86.20647
25/03/2022 10:55,2021,2,WESTERN EUROPE-OTHER,NORWAY,1,HEATHROW,BERGEN,16974,16974,0,0,0,0,0
25/03/2022 10:55,2021,2,WESTERN EUROPE-OTHER,NORWAY,1,HEATHROW,OSLO (GARDERMOEN),96313,96313,0,161096,161096,0,-40.21391
25/03/2022 10:55,2021,2,WESTERN EUROPE-OTHER,NORWAY,1,HEATHROW,STAVANGER,0,0,0,11311,11311,0,-100
25/03/2022 10:55,2021,2,WESTERN EUROPE-OTHER,NORWAY,1,LUTON,BERGEN,0,0,0,10381,10381,0,-100
25/03/2022 10:55,2021,2,WESTERN EUROPE-OTHER,NORWAY,1,LUTON,OSLO (GARDERMOEN),0,0,0,15290,15290,0,-100
25/03/2022 10:55,2021,2,WESTERN EUROPE-OTHER,NORWAY,1,LUTON,STAVANGER,0,0,0,5177,5177,0,-100
25/03/2022 10:55,2021,2,WESTERN EUROPE-OTHER,NORWAY,1,LUTON,TROMSOE,0,0,0,7962,7962,0,-100
25/03/2022 10:55,2021,2,WESTERN EUROPE-OTHER,NORWAY,1,SOUTHEND,BERGEN,0,0,0,47,47,0,-100
25/03/2022 10:55,2021,2,WESTERN EUROPE-OTHER,NORWAY,1,STANSTED,KRISTIANSAND (KJEVIK),0,0,0,3579,3579,0,-100
25/03/2022 10:55,2021,2,WESTERN EUROPE-OTHER,NORWAY,1,STANSTED,OSLO (GARDERMOEN),42037,42037,0,74091,74091,0,-43.26301
25/03/2022 10:55,2021,2,WESTERN EUROPE-OTHER,NORWAY,1,STANSTED,SANDEFJORD(TORP),3290,3290,0,11786,11786,0,-72.08553
25/03/2022 10:55,2021,2,WESTERN EUROPE-OTHER,NORWAY,2,ABERDEEN,ALESUND,9,0,9,371,0,371,-97.57412
25/03/2022 10:55,2021,2,WESTERN EUROPE-OTHER,NORWAY,2,ABERDEEN,BERGEN,13990,13922,68,22444,22418,26,-37.66708
25/03/2022 10:55,2021,2,WESTERN EUROPE-OTHER,NORWAY,2,ABERDEEN,FLORO,0,0,0,69,0,69,-100
25/03/2022 10:55,2021,2,WESTERN EUROPE-OTHER,NORWAY,2,ABERDEEN,HAUGESUND,44,44,0,280,216,64,-84.28571
25/03/2022 10:55,2021,2,WESTERN EUROPE-OTHER,NORWAY,2,ABERDEEN,KRISTIANSUND (KUERNBERGET),0,0,0,67,0,67,-100
25/03/2022 10:55,2021,2,WESTERN EUROPE-OTHER,NORWAY,2,ABERDEEN,OSLO (GARDERMOEN),0,0,0,3263,3186,77,-100
25/03/2022 10:55,2021,2,WESTERN EUROPE-OTHER,NORWAY,2,ABERDEEN,STAVANGER,21659,21659,0,30705,30597,108,-29.461
25/03/2022 10:55,2021,2,WESTERN EUROPE-OTHER,NORWAY,2,ABERDEEN,TRONDHEIM (VAERNES),0,0,0,59,0,59,-100
25/03/2022 10:55,2021,2,WESTERN EUROPE-OTHER,NORWAY,2,BELFAST INTERNATIONAL,OSLO (GARDERMOEN),0,0,0,172,0,172,-100
25/03/2022 10:55,2021,2,WESTERN EUROPE-OTHER,NORWAY,2,BIRMINGHAM,BERGEN,167,0,167,320,0,320,-47.8125
25/03/2022 10:55,2021,2,WESTERN EUROPE-OTHER,NORWAY,2,BIRMINGHAM,OSLO (GARDERMOEN),0,0,0,183,183,0,-100
25/03/2022 10:55,2021,2,WESTERN EUROPE-OTHER,NORWAY,2,BOURNEMOUTH,BERGEN,0,0,0,390,0,390,-100
25/03/2022 10:55,2021,2,WESTERN EUROPE-OTHER,NORWAY,2,BRISTOL,BARDUFOSS,0,0,0,636,0,636,-100
25/03/2022 10:55,2021,2,WESTERN EUROPE-OTHER,NORWAY,2,BRISTOL,BERGEN,200,0,200,600,0,600,-66.66667
25/03/2022 10:55,2021,2,WESTERN EUROPE-OTHER,NORWAY,2,CARDIFF WALES,OSLO (GARDERMOEN),0,0,0,128,0,128,-100
25/03/2022 10:55,2021,2,WESTERN EUROPE-OTHER,NORWAY,2,EAST MIDLANDS INTERNATIONAL,OSLO (GARDERMOEN),0,0,0,187,0,187,-100
25/03/2022 10:55,2021,2,WESTERN EUROPE-OTHER,NORWAY,2,EDINBURGH,BERGEN,0,0,0,639,595,44,-100
25/03/2022 10:55,2021,2,WESTERN EUROPE-OTHER,NORWAY,2,EDINBURGH,OSLO (GARDERMOEN),13475,13475,0,22857,22857,0,-41.04651
25/03/2022 10:55,2021,2,WESTERN EUROPE-OTHER,NORWAY,2,EDINBURGH,STAVANGER,11,11,0,1582,1582,0,-99.30468
25/03/2022 10:55,2021,2,WESTERN EUROPE-OTHER,NORWAY,2,GLASGOW,ALESUND,194,0,194,266,0,266,-27.06767
25/03/2022 10:55,2021,2,WESTERN EUROPE-OTHER,NORWAY,2,GLASGOW,BERGEN,0,0,0,296,0,296,-100
25/03/2022 10:55,2021,2,WESTERN EUROPE-OTHER,NORWAY,2,GLASGOW,SANDEFJORD(TORP),102,102,0,0,0,0,0
25/03/2022 10:55,2021,2,WESTERN EUROPE-OTHER,NORWAY,2,GLASGOW,TRONDHEIM (VAERNES),68,0,68,0,0,0,0
25/03/2022 10:55,2021,2,WESTERN EUROPE-OTHER,NORWAY,2,INVERNESS,ALESUND,0,0,0,46,0,46,-100
25/03/2022 10:55,2021,2,WESTERN EUROPE-OTHER,NORWAY,2,LEEDS BRADFORD,BERGEN,0,0,0,125,0,125,-100
25/03/2022 10:55,2021,2,WESTERN EUROPE-OTHER,NORWAY,2,LIVERPOOL (JOHN LENNON),BERGEN,0,0,0,1717,1717,0,-100
25/03/2022 10:55,2021,2,WESTERN EUROPE-OTHER,NORWAY,2,LIVERPOOL (JOHN LENNON),OSLO (GARDERMOEN),354,0,354,1479,0,1479,-76.06491
25/03/2022 10:55,2021,2,WESTERN EUROPE-OTHER,NORWAY,2,LIVERPOOL (JOHN LENNON),SANDEFJORD(TORP),0,0,0,366,0,366,-100
25/03/2022 10:55,2021,2,WESTERN EUROPE-OTHER,NORWAY,2,LIVERPOOL (JOHN LENNON),STAVANGER,138,0,138,221,0,221,-37.55656
25/03/2022 10:55,2021,2,WESTERN EUROPE-OTHER,NORWAY,2,LIVERPOOL (JOHN LENNON),TROMSOE,0,0,0,371,0,371,-100
25/03/2022 10:55,2021,2,WESTERN EUROPE-OTHER,NORWAY,2,LIVERPOOL (JOHN LENNON),TRONDHEIM (VAERNES),0,0,0,374,0,374,-100
25/03/2022 10:55,2021,2,WESTERN EUROPE-OTHER,NORWAY,2,MANCHESTER,BERGEN,484,298,186,7213,6272,941,-93.28989
25/03/2022 10:55,2021,2,WESTERN EUROPE-OTHER,NORWAY,2,MANCHESTER,OSLO (GARDERMOEN),15523,15523,0,28475,28475,0,-45.48551
25/03/2022 10:55,2021,2,WESTERN EUROPE-OTHER,NORWAY,2,MANCHESTER,SANDEFJORD(TORP),5514,5514,0,18855,18855,0,-70.75577
25/03/2022 10:55,2021,2,WESTERN EUROPE-OTHER,NORWAY,2,MANCHESTER,STAVANGER,0,0,0,4742,4742,0,-100
25/03/2022 10:55,2021,2,WESTERN EUROPE-OTHER,NORWAY,2,NEWCASTLE,BERGEN,202,202,0,130,0,130,55.38462
25/03/2022 10:55,2021,2,WESTERN EUROPE-OTHER,NORWAY,2,NEWCASTLE,STAVANGER,0,0,0,2487,2487,0,-100
25/03/2022 10:55,2021,2,WESTERN EUROPE-OTHER,NORWAY,2,NORWICH,BERGEN,43,0,43,0,0,0,0
25/03/2022 10:55,2021,2,WESTERN EUROPE-OTHER,NORWAY,2,SUMBURGH,ALESUND,0,0,0,47,0,47,-100
25/03/2022 10:55,2021,2,WESTERN EUROPE-OTHER,NORWAY,2,SUMBURGH,BERGEN,0,0,0,72,72,0,-100
25/03/2022 10:55,2021,2,WESTERN EUROPE-OTHER,NORWAY,2,TEESSIDE INTERNATIONAL AIRPORT,ALESUND,0,0,0,24,0,24,-100
25/03/2022 10:55,2021,2,WESTERN EUROPE-OTHER,REPUBLIC OF MONTENEGRO,1,GATWICK,PODGORICA,0,0,0,111,0,111,-100
25/03/2022 10:55,2021,2,WESTERN EUROPE-OTHER,REPUBLIC OF MONTENEGRO,1,GATWICK,TIVAT,3404,3404,0,3479,3479,0,-2.15579
25/03/2022 10:55,2021,2,WESTERN EUROPE-OTHER,REPUBLIC OF MONTENEGRO,1,STANSTED,PODGORICA,7264,7264,0,12893,12893,0,-43.65935
25/03/2022 10:55,2021,2,WESTERN EUROPE-OTHER,REPUBLIC OF MONTENEGRO,2,BIGGIN HILL,PODGORICA,3,0,3,0,0,0,0
25/03/2022 10:55,2021,2,WESTERN EUROPE-OTHER,REPUBLIC OF MONTENEGRO,2,MANCHESTER,TIVAT,782,782,0,1761,1761,0,-55.59341
25/03/2022 10:55,2021,2,WESTERN EUROPE-OTHER,REPUBLIC OF SERBIA,1,HEATHROW,BELGRADE,23218,23197,21,27808,27515,293,-16.50604
25/03/2022 10:55,2021,2,WESTERN EUROPE-OTHER,REPUBLIC OF SERBIA,1,LUTON,BELGRADE,28144,28144,0,29558,29558,0,-4.78381
25/03/2022 10:55,2021,2,WESTERN EUROPE-OTHER,REPUBLIC OF SERBIA,2,MANCHESTER,BELGRADE,60,0,60,0,0,0,0
25/03/2022 10:55,2021,2,WESTERN EUROPE-OTHER,SWITZERLAND,1,GATWICK,BALE MULHOUSE,29745,29745,0,67026,67026,0,-55.6217
25/03/2022 10:55,2021,2,WESTERN EUROPE-OTHER,SWITZERLAND,1,GATWICK,GENEVA,94436,94339,97,306483,302615,3868,-69.1872
25/03/2022 10:55,2021,2,WESTERN EUROPE-OTHER,SWITZERLAND,1,GATWICK,ZURICH,16447,16447,0,35290,35290,0,-53.39473
25/03/2022 10:55,2021,2,WESTERN EUROPE-OTHER,SWITZERLAND,1,HEATHROW,BALE MULHOUSE,13533,13533,0,56410,56410,0,-76.00957
25/03/2022 10:55,2021,2,WESTERN EUROPE-OTHER,SWITZERLAND,1,HEATHROW,GENEVA,222073,222073,0,338486,338486,0,-34.39226
25/03/2022 10:55,2021,2,WESTERN EUROPE-OTHER,SWITZERLAND,1,HEATHROW,SION,0,0,0,551,551,0,-100
25/03/2022 10:55,2021,2,WESTERN EUROPE-OTHER,SWITZERLAND,1,HEATHROW,ZURICH,267360,267360,0,345888,345007,881,-22.7033
25/03/2022 10:55,2021,2,WESTERN EUROPE-OTHER,SWITZERLAND,1,LONDON CITY,ALTENRHEIN,0,0,0,62,0,62,-100
25/03/2022 10:55,2021,2,WESTERN EUROPE-OTHER,SWITZERLAND,1,LONDON CITY,GENEVA,4105,4105,0,35475,35450,25,-88.42847
25/03/2022 10:55,2021,2,WESTERN EUROPE-OTHER,SWITZERLAND,1,LONDON CITY,SION,0,0,0,93,93,0,-100
25/03/2022 10:55,2021,2,WESTERN EUROPE-OTHER,SWITZERLAND,1,LONDON CITY,ZURICH,49318,49318,0,76513,76513,0,-35.54298
25/03/2022 10:55,2021,2,WESTERN EUROPE-OTHER,SWITZERLAND,1,LUTON,BALE MULHOUSE,0,0,0,11225,11225,0,-100
25/03/2022 10:55,2021,2,WESTERN EUROPE-OTHER,SWITZERLAND,1,LUTON,GENEVA,28305,28305,0,119124,119124,0,-76.23905
25/03/2022 10:55,2021,2,WESTERN EUROPE-OTHER,SWITZERLAND,1,LUTON,ZURICH,5289,5289,0,33236,33236,0,-84.08653
25/03/2022 10:55,2021,2,WESTERN EUROPE-OTHER,SWITZERLAND,1,SOUTHEND,GENEVA,0,0,0,17027,17027,0,-100
25/03/2022 10:55,2021,2,WESTERN EUROPE-OTHER,SWITZERLAND,1,STANSTED,BALE MULHOUSE,0,0,0,189,0,189,-100
25/03/2022 10:55,2021,2,WESTERN EUROPE-OTHER,SWITZERLAND,1,STANSTED,GENEVA,654,654,0,59857,59857,0,-98.9074
25/03/2022 10:55,2021,2,WESTERN EUROPE-OTHER,SWITZERLAND,1,STANSTED,ZURICH,0,0,0,204,120,84,-100
25/03/2022 10:55,2021,2,WESTERN EUROPE-OTHER,SWITZERLAND,2,ABERDEEN,GENEVA,14,14,0,3271,3271,0,-99.572
25/03/2022 10:55,2021,2,WESTERN EUROPE-OTHER,SWITZERLAND,2,BELFAST INTERNATIONAL,BALE MULHOUSE,49,0,49,0,0,0,0
25/03/2022 10:55,2021,2,WESTERN EUROPE-OTHER,SWITZERLAND,2,BELFAST INTERNATIONAL,GENEVA,532,478,54,14052,14017,35,-96.21406
25/03/2022 10:55,2021,2,WESTERN EUROPE-OTHER,SWITZERLAND,2,BIGGIN HILL,BERNE,14,0,14,22,0,22,-36.36364
25/03/2022 10:55,2021,2,WESTERN EUROPE-OTHER,SWITZERLAND,2,BIGGIN HILL,GENEVA,18,0,18,25,0,25,-28
25/03/2022 10:55,2021,2,WESTERN EUROPE-OTHER,SWITZERLAND,2,BIGGIN HILL,SION,15,0,15,26,0,26,-42.30769
25/03/2022 10:55,2021,2,WESTERN EUROPE-OTHER,SWITZERLAND,2,BIGGIN HILL,ZURICH,30,0,30,1,0,1,2900
25/03/2022 10:55,2021,2,WESTERN EUROPE-OTHER,SWITZERLAND,2,BIRMINGHAM,GENEVA,4405,4405,0,57620,57620,0,-92.35509
25/03/2022 10:55,2021,2,WESTERN EUROPE-OTHER,SWITZERLAND,2,BIRMINGHAM,ZURICH,4441,4315,126,19526,19480,46,-77.25597
25/03/2022 10:55,2021,2,WESTERN EUROPE-OTHER,SWITZERLAND,2,BOURNEMOUTH,GENEVA,757,757,0,18009,18009,0,-95.79655
25/03/2022 10:55,2021,2,WESTERN EUROPE-OTHER,SWITZERLAND,2,BRISTOL,BALE MULHOUSE,750,750,0,10103,10103,0,-92.57646
25/03/2022 10:55,2021,2,WESTERN EUROPE-OTHER,SWITZERLAND,2,BRISTOL,BERNE,69,0,69,0,0,0,0
25/03/2022 10:55,2021,2,WESTERN EUROPE-OTHER,SWITZERLAND,2,BRISTOL,GENEVA,15852,15852,0,83508,79769,3739,-81.01739
25/03/2022 10:55,2021,2,WESTERN EUROPE-OTHER,SWITZERLAND,2,CARDIFF WALES,GENEVA,37,0,37,1047,1047,0,-96.46609
25/03/2022 10:55,2021,2,WESTERN EUROPE-OTHER,SWITZERLAND,2,EAST MIDLANDS INTERNATIONAL,GENEVA,0,0,0,3059,3059,0,-100
25/03/2022 10:55,2021,2,WESTERN EUROPE-OTHER,SWITZERLAND,2,EDINBURGH,BALE MULHOUSE,7890,7890,0,15772,15772,0,-49.97464
25/03/2022 10:55,2021,2,WESTERN EUROPE-OTHER,SWITZERLAND,2,EDINBURGH,GENEVA,14034,14034,0,68302,64660,3642,-79.45302
25/03/2022 10:55,2021,2,WESTERN EUROPE-OTHER,SWITZERLAND,2,EDINBURGH,ZURICH,2254,2254,0,3152,3152,0,-28.48985
25/03/2022 10:55,2021,2,WESTERN EUROPE-OTHER,SWITZERLAND,2,EXETER,GENEVA,0,0,0,902,902,0,-100
25/03/2022 10:55,2021,2,WESTERN EUROPE-OTHER,SWITZERLAND,2,GLASGOW,GENEVA,377,377,0,9651,9651,0,-96.09367
25/03/2022 10:55,2021,2,WESTERN EUROPE-OTHER,SWITZERLAND,2,ISLE OF MAN,GENEVA,0,0,0,1069,0,1069,-100
25/03/2022 10:55,2021,2,WESTERN EUROPE-OTHER,SWITZERLAND,2,JERSEY,GENEVA,0,0,0,949,949,0,-100
25/03/2022 10:55,2021,2,WESTERN EUROPE-OTHER,SWITZERLAND,2,LEEDS BRADFORD,GENEVA,446,446,0,23581,23581,0,-98.10865
25/03/2022 10:55,2021,2,WESTERN EUROPE-OTHER,SWITZERLAND,2,LIVERPOOL (JOHN LENNON),GENEVA,1809,1726,83,57635,57635,0,-96.86128
25/03/2022 10:55,2021,2,WESTERN EUROPE-OTHER,SWITZERLAND,2,MANCHESTER,BALE MULHOUSE,4045,4045,0,19713,19713,0,-79.48055
25/03/2022 10:55,2021,2,WESTERN EUROPE-OTHER,SWITZERLAND,2,MANCHESTER,BERNE,389,0,389,0,0,0,0
25/03/2022 10:55,2021,2,WESTERN EUROPE-OTHER,SWITZERLAND,2,MANCHESTER,GENEVA,41104,41104,0,89674,88154,1520,-54.16286
25/03/2022 10:55,2021,2,WESTERN EUROPE-OTHER,SWITZERLAND,2,MANCHESTER,ZURICH,28550,28550,0,38601,38601,0,-26.03819
25/03/2022 10:55,2021,2,WESTERN EUROPE-OTHER,SWITZERLAND,2,NEWCASTLE,GENEVA,108,108,0,22870,22870,0,-99.52777
25/03/2022 10:55,2021,2,WESTERN EUROPE-OTHER,SWITZERLAND,2,SOUTHAMPTON,GENEVA,358,358,0,8992,8992,0,-96.01868
25/03/2022 10:55,2021,2,WESTERN EUROPE-OTHER,TURKEY,1,GATWICK,ANKARA (ESENBOGA),0,0,0,2848,2848,0,-100
25/03/2022 10:55,2021,2,WESTERN EUROPE-OTHER,TURKEY,1,GATWICK,ANTALYA,23620,19005,4615,105185,81212,23973,-77.54433
25/03/2022 10:55,2021,2,WESTERN EUROPE-OTHER,TURKEY,1,GATWICK,BODRUM (MILAS),405,405,0,33872,30375,3497,-98.80432
25/03/2022 10:55,2021,2,WESTERN EUROPE-OTHER,TURKEY,1,GATWICK,DALAMAN,11677,8611,3066,111489,80355,31134,-89.52632
25/03/2022 10:55,2021,2,WESTERN EUROPE-OTHER,TURKEY,1,GATWICK,ISTANBUL,36208,36208,0,65786,65449,337,-44.96093
25/03/2022 10:55,2021,2,WESTERN EUROPE-OTHER,TURKEY,1,GATWICK,ISTANBUL (SABIHA GOKCEN),8,0,8,12176,12176,0,-99.9343
25/03/2022 10:55,2021,2,WESTERN EUROPE-OTHER,TURKEY,1,GATWICK,IZMIR (ADNAN MENDERES),707,0,707,14146,10823,3323,-95.00212
25/03/2022 10:55,2021,2,WESTERN EUROPE-OTHER,TURKEY,1,HEATHROW,ANKARA (ESENBOGA),0,0,0,679,679,0,-100
25/03/2022 10:55,2021,2,WESTERN EUROPE-OTHER,TURKEY,1,HEATHROW,ANTALYA,1663,1663,0,0,0,0,0
25/03/2022 10:55,2021,2,WESTERN EUROPE-OTHER,TURKEY,1,HEATHROW,BODRUM (MILAS),911,911,0,3954,3954,0,-76.96004
25/03/2022 10:55,2021,2,WESTERN EUROPE-OTHER,TURKEY,1,HEATHROW,DALAMAN,2928,2928,0,25165,25165,0,-88.36479
25/03/2022 10:55,2021,2,WESTERN EUROPE-OTHER,TURKEY,1,HEATHROW,ISTANBUL,385503,385489,14,420854,420780,74,-8.39983
25/03/2022 10:55,2021,2,WESTERN EUROPE-OTHER,TURKEY,1,HEATHROW,ISTANBUL (SABIHA GOKCEN),7901,7901,0,0,0,0,0
25/03/2022 10:55,2021,2,WESTERN EUROPE-OTHER,TURKEY,1,LUTON,ANKARA (ESENBOGA),0,0,0,3277,3277,0,-100
25/03/2022 10:55,2021,2,WESTERN EUROPE-OTHER,TURKEY,1,LUTON,ANTALYA,5547,5547,0,10471,10471,0,-47.02512
25/03/2022 10:55,2021,2,WESTERN EUROPE-OTHER,TURKEY,1,LUTON,BODRUM (MILAS),0,0,0,7137,7137,0,-100
25/03/2022 10:55,2021,2,WESTERN EUROPE-OTHER,TURKEY,1,LUTON,DALAMAN,1754,1754,0,7008,7008,0,-74.97146
25/03/2022 10:55,2021,2,WESTERN EUROPE-OTHER,TURKEY,1,LUTON,GAZIANTEP,957,957,0,3349,3349,0,-71.42431
25/03/2022 10:55,2021,2,WESTERN EUROPE-OTHER,TURKEY,1,LUTON,IZMIR (ADNAN MENDERES),534,534,0,5727,5727,0,-90.67575
25/03/2022 10:55,2021,2,WESTERN EUROPE-OTHER,TURKEY,1,STANSTED,ADANA,0,0,0,189,189,0,-100
25/03/2022 10:55,2021,2,WESTERN EUROPE-OTHER,TURKEY,1,STANSTED,ANKARA (ESENBOGA),1288,1288,0,773,600,173,66.62354
25/03/2022 10:55,2021,2,WESTERN EUROPE-OTHER,TURKEY,1,STANSTED,ANTALYA,30029,30029,0,69981,62838,7143,-57.08978
25/03/2022 10:55,2021,2,WESTERN EUROPE-OTHER,TURKEY,1,STANSTED,BODRUM (MILAS),210,210,0,11016,11016,0,-98.09368
25/03/2022 10:55,2021,2,WESTERN EUROPE-OTHER,TURKEY,1,STANSTED,DALAMAN,15225,15225,0,38948,33015,5933,-60.90942
25/03/2022 10:55,2021,2,WESTERN EUROPE-OTHER,TURKEY,1,STANSTED,GAZIANTEP,0,0,0,1475,515,960,-100
25/03/2022 10:55,2021,2,WESTERN EUROPE-OTHER,TURKEY,1,STANSTED,ISTANBUL,0,0,0,1596,1247,349,-100
25/03/2022 10:55,2021,2,WESTERN EUROPE-OTHER,TURKEY,1,STANSTED,ISTANBUL (SABIHA GOKCEN),204382,204382,0,291148,290907,241,-29.80134
25/03/2022 10:55,2021,2,WESTERN EUROPE-OTHER,TURKEY,1,STANSTED,IZMIR (ADNAN MENDERES),15022,14775,247,41683,41206,477,-63.96133
25/03/2022 10:55,2021,2,WESTERN EUROPE-OTHER,TURKEY,1,STANSTED,KAHRAMANMARAS,0,0,0,116,0,116,-100
25/03/2022 10:55,2021,2,WESTERN EUROPE-OTHER,TURKEY,1,STANSTED,KAYSERI  ERKILET,0,0,0,160,0,160,-100
25/03/2022 10:55,2021,2,WESTERN EUROPE-OTHER,TURKEY,2,ABERDEEN,ISTANBUL (SABIHA GOKCEN),0,0,0,31,0,31,-100
25/03/2022 10:55,2021,2,WESTERN EUROPE-OTHER,TURKEY,2,BELFAST INTERNATIONAL,ANTALYA,2710,2710,0,1796,1796,0,50.89087
25/03/2022 10:55,2021,2,WESTERN EUROPE-OTHER,TURKEY,2,BELFAST INTERNATIONAL,DALAMAN,1468,1468,0,12068,12068,0,-87.8356
25/03/2022 10:55,2021,2,WESTERN EUROPE-OTHER,TURKEY,2,BELFAST INTERNATIONAL,ISTANBUL ATATURK,0,0,0,97,0,97,-100
25/03/2022 10:55,2021,2,WESTERN EUROPE-OTHER,TURKEY,2,BIGGIN HILL,ANTALYA,4,0,4,0,0,0,0
25/03/2022 10:55,2021,2,WESTERN EUROPE-OTHER,TURKEY,2,BIGGIN HILL,BODRUM (MILAS),1,0,1,19,0,19,-94.73684
25/03/2022 10:55,2021,2,WESTERN EUROPE-OTHER,TURKEY,2,BIGGIN HILL,DALAMAN,0,0,0,21,0,21,-100
25/03/2022 10:55,2021,2,WESTERN EUROPE-OTHER,TURKEY,2,BIGGIN HILL,ISTANBUL (SABIHA GOKCEN),0,0,0,1,0,1,-100
25/03/2022 10:55,2021,2,WESTERN EUROPE-OTHER,TURKEY,2,BIGGIN HILL,ISTANBUL ATATURK,5,0,5,9,0,9,-44.44444
25/03/2022 10:55,2021,2,WESTERN EUROPE-OTHER,TURKEY,2,BIRMINGHAM,ANTALYA,18230,14220,4010,44657,29153,15504,-59.17773
25/03/2022 10:55,2021,2,WESTERN EUROPE-OTHER,TURKEY,2,BIRMINGHAM,BODRUM (MILAS),0,0,0,5466,5466,0,-100
25/03/2022 10:55,2021,2,WESTERN EUROPE-OTHER,TURKEY,2,BIRMINGHAM,DALAMAN,13473,11000,2473,34247,20202,14045,-60.65933
25/03/2022 10:55,2021,2,WESTERN EUROPE-OTHER,TURKEY,2,BIRMINGHAM,ISTANBUL,32798,32798,0,44277,44277,0,-25.92542
25/03/2022 10:55,2021,2,WESTERN EUROPE-OTHER,TURKEY,2,BIRMINGHAM,ISTANBUL (SABIHA GOKCEN),209,0,209,228,0,228,-8.33333
25/03/2022 10:55,2021,2,WESTERN EUROPE-OTHER,TURKEY,2,BIRMINGHAM,IZMIR (ADNAN MENDERES),0,0,0,2754,137,2617,-100
25/03/2022 10:55,2021,2,WESTERN EUROPE-OTHER,TURKEY,2,BOURNEMOUTH,ANTALYA,0,0,0,3199,0,3199,-100
25/03/2022 10:55,2021,2,WESTERN EUROPE-OTHER,TURKEY,2,BOURNEMOUTH,DALAMAN,0,0,0,2998,0,2998,-100
25/03/2022 10:55,2021,2,WESTERN EUROPE-OTHER,TURKEY,2,BRISTOL,ANTALYA,5845,5845,0,14236,7535,6701,-58.94212
25/03/2022 10:55,2021,2,WESTERN EUROPE-OTHER,TURKEY,2,BRISTOL,BODRUM (MILAS),0,0,0,13395,13395,0,-100
25/03/2022 10:55,2021,2,WESTERN EUROPE-OTHER,TURKEY,2,BRISTOL,DALAMAN,5326,5326,0,26049,16261,9788,-79.55392
25/03/2022 10:55,2021,2,WESTERN EUROPE-OTHER,TURKEY,2,CARDIFF WALES,ANTALYA,0,0,0,2745,0,2745,-100
25/03/2022 10:55,2021,2,WESTERN EUROPE-OTHER,TURKEY,2,CARDIFF WALES,DALAMAN,0,0,0,5676,0,5676,-100
25/03/2022 10:55,2021,2,WESTERN EUROPE-OTHER,TURKEY,2,DONCASTER SHEFFIELD,ANTALYA,0,0,0,4742,63,4679,-100
25/03/2022 10:55,2021,2,WESTERN EUROPE-OTHER,TURKEY,2,DONCASTER SHEFFIELD,DALAMAN,0,0,0,9685,0,9685,-100
25/03/2022 10:55,2021,2,WESTERN EUROPE-OTHER,TURKEY,2,EAST MIDLANDS INTERNATIONAL,ANTALYA,2750,2750,0,13699,13699,0,-79.92554
25/03/2022 10:55,2021,2,WESTERN EUROPE-OTHER,TURKEY,2,EAST MIDLANDS INTERNATIONAL,BODRUM (MILAS),0,0,0,3689,3689,0,-100
25/03/2022 10:55,2021,2,WESTERN EUROPE-OTHER,TURKEY,2,EAST MIDLANDS INTERNATIONAL,DALAMAN,4789,4789,0,20841,14769,6072,-77.02126
25/03/2022 10:55,2021,2,WESTERN EUROPE-OTHER,TURKEY,2,EDINBURGH,ANTALYA,6898,6898,0,8769,8769,0,-21.33653
25/03/2022 10:55,2021,2,WESTERN EUROPE-OTHER,TURKEY,2,EDINBURGH,BODRUM (MILAS),0,0,0,8853,8853,0,-100
25/03/2022 10:55,2021,2,WESTERN EUROPE-OTHER,TURKEY,2,EDINBURGH,DALAMAN,2624,2624,0,14431,14431,0,-81.81692
25/03/2022 10:55,2021,2,WESTERN EUROPE-OTHER,TURKEY,2,EDINBURGH,ISTANBUL,14951,14757,194,26631,26631,0,-43.85866
25/03/2022 10:55,2021,2,WESTERN EUROPE-OTHER,TURKEY,2,EXETER,DALAMAN,0,0,0,2713,0,2713,-100
25/03/2022 10:55,2021,2,WESTERN EUROPE-OTHER,TURKEY,2,GLASGOW,ANTALYA,9767,7621,2146,18143,14449,3694,-46.16657
25/03/2022 10:55,2021,2,WESTERN EUROPE-OTHER,TURKEY,2,GLASGOW,BODRUM (MILAS),0,0,0,2082,2082,0,-100
25/03/2022 10:55,2021,2,WESTERN EUROPE-OTHER,TURKEY,2,GLASGOW,DALAMAN,7538,5901,1637,30058,20886,9172,-74.92182
25/03/2022 10:55,2021,2,WESTERN EUROPE-OTHER,TURKEY,2,GLASGOW,ISTANBUL,0,0,0,109,0,109,-100
25/03/2022 10:55,2021,2,WESTERN EUROPE-OTHER,TURKEY,2,GLASGOW,IZMIR (ADNAN MENDERES),0,0,0,2622,2622,0,-100
25/03/2022 10:55,2021,2,WESTERN EUROPE-OTHER,TURKEY,2,GUERNSEY,ISTANBUL (SABIHA GOKCEN),6,0,6,0,0,0,0
25/03/2022 10:55,2021,2,WESTERN EUROPE-OTHER,TURKEY,2,LEEDS BRADFORD,ANTALYA,10151,10151,0,19734,19576,158,-48.56086
25/03/2022 10:55,2021,2,WESTERN EUROPE-OTHER,TURKEY,2,LEEDS BRADFORD,BODRUM (MILAS),0,0,0,5010,5010,0,-100
25/03/2022 10:55,2021,2,WESTERN EUROPE-OTHER,TURKEY,2,LEEDS BRADFORD,DALAMAN,7708,7708,0,20189,20189,0,-61.82079
25/03/2022 10:55,2021,2,WESTERN EUROPE-OTHER,TURKEY,2,LIVERPOOL (JOHN LENNON),ANTALYA,0,0,0,3319,3319,0,-100
25/03/2022 10:55,2021,2,WESTERN EUROPE-OTHER,TURKEY,2,LIVERPOOL (JOHN LENNON),BODRUM (MILAS),0,0,0,7094,7094,0,-100
25/03/2022 10:55,2021,2,WESTERN EUROPE-OTHER,TURKEY,2,LIVERPOOL (JOHN LENNON),DALAMAN,1142,1142,0,6862,6862,0,-83.35762
25/03/2022 10:55,2021,2,WESTERN EUROPE-OTHER,TURKEY,2,MANCHESTER,ANTALYA,41807,33981,7826,120089,87833,32256,-65.18665
25/03/2022 10:55,2021,2,WESTERN EUROPE-OTHER,TURKEY,2,MANCHESTER,BODRUM (MILAS),1022,0,1022,15128,11863,3265,-93.24432
25/03/2022 10:55,2021,2,WESTERN EUROPE-OTHER,TURKEY,2,MANCHESTER,DALAMAN,24044,19316,4728,126096,85383,40713,-80.93199
25/03/2022 10:55,2021,2,WESTERN EUROPE-OTHER,TURKEY,2,MANCHESTER,ISTANBUL,108308,108308,0,89527,89299,228,20.97803
25/03/2022 10:55,2021,2,WESTERN EUROPE-OTHER,TURKEY,2,MANCHESTER,ISTANBUL (SABIHA GOKCEN),36787,36787,0,58801,58801,0,-37.43814
25/03/2022 10:55,2021,2,WESTERN EUROPE-OTHER,TURKEY,2,MANCHESTER,IZMIR (ADNAN MENDERES),557,0,557,16211,12674,3537,-96.56406
25/03/2022 10:55,2021,2,WESTERN EUROPE-OTHER,TURKEY,2,NEWCASTLE,ANTALYA,9871,9871,0,21148,21148,0,-53.32419
25/03/2022 10:55,2021,2,WESTERN EUROPE-OTHER,TURKEY,2,NEWCASTLE,BODRUM (MILAS),0,0,0,3499,3499,0,-100
25/03/2022 10:55,2021,2,WESTERN EUROPE-OTHER,TURKEY,2,NEWCASTLE,DALAMAN,7514,7514,0,27934,27934,0,-73.10088
25/03/2022 10:55,2021,2,WESTERN EUROPE-OTHER,TURKEY,2,NEWCASTLE,IZMIR (ADNAN MENDERES),0,0,0,3431,3431,0,-100
25/03/2022 10:55,2021,3,EASTERN EUROPE-EU,BULGARIA,1,GATWICK,BURGAS,2455,2455,0,0,0,0,0
25/03/2022 10:55,2021,3,EASTERN EUROPE-EU,BULGARIA,1,GATWICK,SOFIA,47287,46289,998,91313,83881,7432,-48.21438
25/03/2022 10:55,2021,3,EASTERN EUROPE-EU,BULGARIA,1,GATWICK,VARNA,4279,4279,0,3715,3715,0,15.1817
25/03/2022 10:55,2021,3,EASTERN EUROPE-EU,BULGARIA,1,HEATHROW,SOFIA,48812,48812,0,79023,78616,407,-38.23064
25/03/2022 10:55,2021,3,EASTERN EUROPE-EU,BULGARIA,1,LUTON,BURGAS,43049,43049,0,46319,46319,0,-7.05974
25/03/2022 10:55,2021,3,EASTERN EUROPE-EU,BULGARIA,1,LUTON,PLOVDIV,5562,5562,0,0,0,0,0
25/03/2022 10:55,2021,3,EASTERN EUROPE-EU,BULGARIA,1,LUTON,SOFIA,179964,179964,0,206346,206129,217,-12.78532
25/03/2022 10:55,2021,3,EASTERN EUROPE-EU,BULGARIA,1,LUTON,VARNA,66766,66766,0,73016,73016,0,-8.55977
25/03/2022 10:55,2021,3,EASTERN EUROPE-EU,BULGARIA,1,SOUTHEND,SOFIA,0,0,0,5831,5831,0,-100
25/03/2022 10:55,2021,3,EASTERN EUROPE-EU,BULGARIA,1,STANSTED,PLOVDIV,20756,20756,0,27925,27925,0,-25.67234
25/03/2022 10:55,2021,3,EASTERN EUROPE-EU,BULGARIA,1,STANSTED,SOFIA,124665,124562,103,125347,125168,179,-0.54409
25/03/2022 10:55,2021,3,EASTERN EUROPE-EU,BULGARIA,2,ABERDEEN,SOFIA,0,0,0,78,0,78,-100
25/03/2022 10:55,2021,3,EASTERN EUROPE-EU,BULGARIA,2,ABERDEEN,VARNA,0,0,0,241,0,241,-100
25/03/2022 10:55,2021,3,EASTERN EUROPE-EU,BULGARIA,2,BELFAST INTERNATIONAL,PLOVDIV,567,0,567,3632,0,3632,-84.38877
25/03/2022 10:55,2021,3,EASTERN EUROPE-EU,BULGARIA,2,BELFAST INTERNATIONAL,SOFIA,349,0,349,5105,0,5105,-93.16357
25/03/2022 10:55,2021,3,EASTERN EUROPE-EU,BULGARIA,2,BIGGIN HILL,SOFIA,5,0,5,0,0,0,0
25/03/2022 10:55,2021,3,EASTERN EUROPE-EU,BULGARIA,2,BIRMINGHAM,SOFIA,8538,8045,493,28478,25189,3289,-70.01896
25/03/2022 10:55,2021,3,EASTERN EUROPE-EU,BULGARIA,2,BRISTOL,SOFIA,2173,1871,302,16577,11968,4609,-86.89148
25/03/2022 10:55,2021,3,EASTERN EUROPE-EU,BULGARIA,2,CARDIFF WALES,SOFIA,0,0,0,164,0,164,-100
25/03/2022 10:55,2021,3,EASTERN EUROPE-EU,BULGARIA,2,DONCASTER SHEFFIELD,BURGAS,2298,2298,0,0,0,0,0
25/03/2022 10:55,2021,3,EASTERN EUROPE-EU,BULGARIA,2,EAST MIDLANDS INTERNATIONAL,SOFIA,444,119,325,7124,3644,3480,-93.76755
25/03/2022 10:55,2021,3,EASTERN EUROPE-EU,BULGARIA,2,EDINBURGH,SOFIA,18358,18358,0,29272,29272,0,-37.28478
25/03/2022 10:55,2021,3,EASTERN EUROPE-EU,BULGARIA,2,GLASGOW,SOFIA,147,81,66,0,0,0,0
25/03/2022 10:55,2021,3,EASTERN EUROPE-EU,BULGARIA,2,LEEDS BRADFORD,SOFIA,0,0,0,182,182,0,-100
25/03/2022 10:55,2021,3,EASTERN EUROPE-EU,BULGARIA,2,LIVERPOOL (JOHN LENNON),BURGAS,2802,2802,0,0,0,0,0
25/03/2022 10:55,2021,3,EASTERN EUROPE-EU,BULGARIA,2,LIVERPOOL (JOHN LENNON),SOFIA,13116,13048,68,16817,16817,0,-22.00749
25/03/2022 10:55,2021,3,EASTERN EUROPE-EU,BULGARIA,2,LIVERPOOL (JOHN LENNON),VARNA,12205,12205,0,19337,19337,0,-36.88266
25/03/2022 10:55,2021,3,EASTERN EUROPE-EU,BULGARIA,2,MANCHESTER,SOFIA,19116,18389,727,30673,25863,4810,-37.67809
25/03/2022 10:55,2021,3,EASTERN EUROPE-EU,BULGARIA,2,NEWCASTLE,SOFIA,111,111,0,3225,3225,0,-96.55814
25/03/2022 10:55,2021,3,EASTERN EUROPE-EU,BULGARIA,2,NEWQUAY,SOFIA,147,0,147,174,0,174,-15.51724
25/03/2022 10:55,2021,3,EASTERN EUROPE-EU,CZECH REPUBLIC,1,GATWICK,PRAGUE,13536,13478,58,45131,45131,0,-70.00731
25/03/2022 10:55,2021,3,EASTERN EUROPE-EU,CZECH REPUBLIC,1,HEATHROW,PRAGUE,53729,53729,0,112458,112458,0,-52.22305
25/03/2022 10:55,2021,3,EASTERN EUROPE-EU,CZECH REPUBLIC,1,LONDON CITY,PRAGUE,2036,2036,0,7216,7216,0,-71.78492
25/03/2022 10:55,2021,3,EASTERN EUROPE-EU,CZECH REPUBLIC,1,LUTON,PRAGUE,0,0,0,33195,33195,0,-100
25/03/2022 10:55,2021,3,EASTERN EUROPE-EU,CZECH REPUBLIC,1,SOUTHEND,PRAGUE,0,0,0,5576,5576,0,-100
25/03/2022 10:55,2021,3,EASTERN EUROPE-EU,CZECH REPUBLIC,1,STANSTED,BRNO (TURANY),22799,22799,0,27679,27679,0,-17.63069
25/03/2022 10:55,2021,3,EASTERN EUROPE-EU,CZECH REPUBLIC,1,STANSTED,OSTRAVA,10232,10232,0,16261,16261,0,-37.07644
25/03/2022 10:55,2021,3,EASTERN EUROPE-EU,CZECH REPUBLIC,1,STANSTED,PRAGUE,115775,115715,60,108097,108097,0,7.10288
25/03/2022 10:55,2021,3,EASTERN EUROPE-EU,CZECH REPUBLIC,2,BELFAST INTERNATIONAL,PRAGUE,564,564,0,5928,5928,0,-90.48583
25/03/2022 10:55,2021,3,EASTERN EUROPE-EU,CZECH REPUBLIC,2,BIGGIN HILL,KUNOVICE,0,0,0,10,0,10,-100
25/03/2022 10:55,2021,3,EASTERN EUROPE-EU,CZECH REPUBLIC,2,BIGGIN HILL,PRAGUE,4,0,4,13,0,13,-69.23077
25/03/2022 10:55,2021,3,EASTERN EUROPE-EU,CZECH REPUBLIC,2,BIRMINGHAM,PRAGUE,4672,4672,0,7212,7212,0,-35.21908
25/03/2022 10:55,2021,3,EASTERN EUROPE-EU,CZECH REPUBLIC,2,BOURNEMOUTH,PRAGUE,0,0,0,10358,10358,0,-100
25/03/2022 10:55,2021,3,EASTERN EUROPE-EU,CZECH REPUBLIC,2,BRISTOL,PRAGUE,9189,9189,0,18838,18838,0,-51.22094
25/03/2022 10:55,2021,3,EASTERN EUROPE-EU,CZECH REPUBLIC,2,CARDIFF WALES,PRAGUE,462,0,462,0,0,0,0
25/03/2022 10:55,2021,3,EASTERN EUROPE-EU,CZECH REPUBLIC,2,EAST MIDLANDS INTERNATIONAL,PRAGUE,554,554,0,5965,5965,0,-90.71249
25/03/2022 10:55,2021,3,EASTERN EUROPE-EU,CZECH REPUBLIC,2,EDINBURGH,PRAGUE,18465,18465,0,39007,38969,38,-52.66234
25/03/2022 10:55,2021,3,EASTERN EUROPE-EU,CZECH REPUBLIC,2,GLASGOW,PRAGUE,968,0,968,6916,6542,374,-86.00347
25/03/2022 10:55,2021,3,EASTERN EUROPE-EU,CZECH REPUBLIC,2,LEEDS BRADFORD,PRAGUE,2681,2681,0,3045,3045,0,-11.95402
25/03/2022 10:55,2021,3,EASTERN EUROPE-EU,CZECH REPUBLIC,2,LIVERPOOL (JOHN LENNON),PRAGUE,86,0,86,11258,11258,0,-99.2361
25/03/2022 10:55,2021,3,EASTERN EUROPE-EU,CZECH REPUBLIC,2,MANCHESTER,PRAGUE,23775,23697,78,96552,96552,0,-75.37596
25/03/2022 10:55,2021,3,EASTERN EUROPE-EU,CZECH REPUBLIC,2,NEWCASTLE,PRAGUE,2424,2424,0,6847,6847,0,-64.59763
25/03/2022 10:55,2021,3,EASTERN EUROPE-EU,ESTONIA,1,GATWICK,TALLIN,16244,16244,0,24950,24817,133,-34.89379
25/03/2022 10:55,2021,3,EASTERN EUROPE-EU,ESTONIA,1,HEATHROW,TALLIN,0,0,0,245,0,245,-100
25/03/2022 10:55,2021,3,EASTERN EUROPE-EU,ESTONIA,1,STANSTED,TALLIN,32949,32835,114,28389,28389,0,16.06256
25/03/2022 10:55,2021,3,EASTERN EUROPE-EU,ESTONIA,2,BELFAST INTERNATIONAL,TALLIN,54,0,54,0,0,0,0
25/03/2022 10:55,2021,3,EASTERN EUROPE-EU,ESTONIA,2,CARDIFF WALES,TALLIN,403,0,403,0,0,0,0
25/03/2022 10:55,2021,3,EASTERN EUROPE-EU,ESTONIA,2,EDINBURGH,TALLIN,2861,2861,0,10440,10440,0,-72.59579
25/03/2022 10:55,2021,3,EASTERN EUROPE-EU,ESTONIA,2,GLASGOW,TALLIN,70,0,70,0,0,0,0
25/03/2022 10:55,2021,3,EASTERN EUROPE-EU,ESTONIA,2,LIVERPOOL (JOHN LENNON),TALLIN,2407,2407,0,0,0,0,0
25/03/2022 10:55,2021,3,EASTERN EUROPE-EU,HUNGARY,1,GATWICK,BUDAPEST,22564,22097,467,93157,93085,72,-75.77852
25/03/2022 10:55,2021,3,EASTERN EUROPE-EU,HUNGARY,1,HEATHROW,BUDAPEST,30007,30007,0,61585,61585,0,-51.27547
25/03/2022 10:55,2021,3,EASTERN EUROPE-EU,HUNGARY,1,LONDON CITY,BUDAPEST,0,0,0,8434,8434,0,-100
25/03/2022 10:55,2021,3,EASTERN EUROPE-EU,HUNGARY,1,LUTON,BUDAPEST,139563,139491,72,161935,161762,173,-13.81542
25/03/2022 10:55,2021,3,EASTERN EUROPE-EU,HUNGARY,1,LUTON,DEBRECEN,20369,20369,0,43232,43232,0,-52.88444
25/03/2022 10:55,2021,3,EASTERN EUROPE-EU,HUNGARY,1,SOUTHEND,BUDAPEST,0,0,0,5448,5448,0,-100
25/03/2022 10:55,2021,3,EASTERN EUROPE-EU,HUNGARY,1,STANSTED,BUDAPEST,133998,133764,234,124845,124845,0,7.33149
25/03/2022 10:55,2021,3,EASTERN EUROPE-EU,HUNGARY,2,ABERDEEN,BUDAPEST,0,0,0,42,0,42,-100
25/03/2022 10:55,2021,3,EASTERN EUROPE-EU,HUNGARY,2,BIGGIN HILL,BUDAPEST,4,0,4,3,0,3,33.33333
25/03/2022 10:55,2021,3,EASTERN EUROPE-EU,HUNGARY,2,BIRMINGHAM,BUDAPEST,8622,8515,107,19819,19819,0,-56.49629
25/03/2022 10:55,2021,3,EASTERN EUROPE-EU,HUNGARY,2,BOURNEMOUTH,BUDAPEST,3094,3094,0,0,0,0,0
25/03/2022 10:55,2021,3,EASTERN EUROPE-EU,HUNGARY,2,BRISTOL,BUDAPEST,18354,18354,0,21474,21474,0,-14.5292
25/03/2022 10:55,2021,3,EASTERN EUROPE-EU,HUNGARY,2,CARDIFF WALES,BUDAPEST,62,0,62,0,0,0,0
25/03/2022 10:55,2021,3,EASTERN EUROPE-EU,HUNGARY,2,DONCASTER SHEFFIELD,BUDAPEST,0,0,0,9392,9392,0,-100
25/03/2022 10:55,2021,3,EASTERN EUROPE-EU,HUNGARY,2,DONCASTER SHEFFIELD,DEBRECEN,0,0,0,7034,7034,0,-100
25/03/2022 10:55,2021,3,EASTERN EUROPE-EU,HUNGARY,2,EAST MIDLANDS INTERNATIONAL,BUDAPEST,10651,10651,0,15057,15057,0,-29.26214
25/03/2022 10:55,2021,3,EASTERN EUROPE-EU,HUNGARY,2,EDINBURGH,BUDAPEST,28029,28029,0,56505,56505,0,-50.39554
25/03/2022 10:55,2021,3,EASTERN EUROPE-EU,HUNGARY,2,GLASGOW,BUDAPEST,221,0,221,8819,8724,95,-97.49405
25/03/2022 10:55,2021,3,EASTERN EUROPE-EU,HUNGARY,2,GLASGOW,DEBRECEN,39,0,39,0,0,0,0
25/03/2022 10:55,2021,3,EASTERN EUROPE-EU,HUNGARY,2,LEEDS BRADFORD,BUDAPEST,1121,1121,0,3397,3397,0,-67.00029
25/03/2022 10:55,2021,3,EASTERN EUROPE-EU,HUNGARY,2,LIVERPOOL (JOHN LENNON),BUDAPEST,5881,5612,269,14686,14686,0,-59.95506
25/03/2022 10:55,2021,3,EASTERN EUROPE-EU,HUNGARY,2,MANCHESTER,BUDAPEST,37930,37536,394,55318,55318,0,-31.43281
25/03/2022 10:55,2021,3,EASTERN EUROPE-EU,HUNGARY,2,NEWCASTLE,BUDAPEST,1251,1251,0,0,0,0,0
25/03/2022 10:55,2021,3,EASTERN EUROPE-EU,HUNGARY,2,OXFORD (KIDLINGTON),BUDAPEST,0,0,0,61,61,0,-100
25/03/2022 10:55,2021,3,EASTERN EUROPE-EU,LATVIA,1,GATWICK,RIGA,39348,39348,0,45913,45913,0,-14.29878
25/03/2022 10:55,2021,3,EASTERN EUROPE-EU,LATVIA,1,LUTON,RIGA,28667,28667,0,53234,53230,4,-46.14908
25/03/2022 10:55,2021,3,EASTERN EUROPE-EU,LATVIA,1,STANSTED,RIGA,86374,86374,0,87595,87595,0,-1.39392
25/03/2022 10:55,2021,3,EASTERN EUROPE-EU,LATVIA,2,ABERDEEN,RIGA,2159,1911,248,401,0,401,438.40399
25/03/2022 10:55,2021,3,EASTERN EUROPE-EU,LATVIA,2,BIGGIN HILL,RIGA,8,0,8,4,0,4,100
25/03/2022 10:55,2021,3,EASTERN EUROPE-EU,LATVIA,2,BIRMINGHAM,RIGA,2103,2062,41,134,134,0,1469.40299
25/03/2022 10:55,2021,3,EASTERN EUROPE-EU,LATVIA,2,BRISTOL,RIGA,2522,2522,0,0,0,0,0
25/03/2022 10:55,2021,3,EASTERN EUROPE-EU,LATVIA,2,DONCASTER SHEFFIELD,RIGA,7791,7791,0,16263,16263,0,-52.09371
25/03/2022 10:55,2021,3,EASTERN EUROPE-EU,LATVIA,2,EAST MIDLANDS INTERNATIONAL,RIGA,14870,14870,0,20600,20600,0,-27.81553
25/03/2022 10:55,2021,3,EASTERN EUROPE-EU,LATVIA,2,EDINBURGH,RIGA,17488,17488,0,16258,16258,0,7.56551
25/03/2022 10:55,2021,3,EASTERN EUROPE-EU,LATVIA,2,GLASGOW,RIGA,0,0,0,98,0,98,-100
25/03/2022 10:55,2021,3,EASTERN EUROPE-EU,LATVIA,2,LEEDS BRADFORD,RIGA,2973,2884,89,7821,7821,0,-61.98696
25/03/2022 10:55,2021,3,EASTERN EUROPE-EU,LATVIA,2,LIVERPOOL (JOHN LENNON),RIGA,126,126,0,0,0,0,0
25/03/2022 10:55,2021,3,EASTERN EUROPE-EU,LATVIA,2,MANCHESTER,RIGA,23219,23219,0,18788,18788,0,23.5842
25/03/2022 10:55,2021,3,EASTERN EUROPE-EU,LITHUANIA,1,GATWICK,VILNIUS,3921,3593,328,5313,4975,338,-26.19989
25/03/2022 10:55,2021,3,EASTERN EUROPE-EU,LITHUANIA,1,HEATHROW,VILNIUS,47,47,0,49,49,0,-4.08163
25/03/2022 10:55,2021,3,EASTERN EUROPE-EU,LITHUANIA,1,LONDON CITY,VILNIUS,21507,21507,0,15207,15207,0,41.42829
25/03/2022 10:55,2021,3,EASTERN EUROPE-EU,LITHUANIA,1,LUTON,KAUNAS,84619,84619,0,91248,91248,0,-7.26482
25/03/2022 10:55,2021,3,EASTERN EUROPE-EU,LITHUANIA,1,LUTON,PALANGA,8438,8438,0,18543,18543,0,-54.49496
25/03/2022 10:55,2021,3,EASTERN EUROPE-EU,LITHUANIA,1,LUTON,VILNIUS,75689,75689,0,80465,80465,0,-5.9355
25/03/2022 10:55,2021,3,EASTERN EUROPE-EU,LITHUANIA,1,SOUTHEND,VILNIUS,78,78,0,24600,24600,0,-99.68293
25/03/2022 10:55,2021,3,EASTERN EUROPE-EU,LITHUANIA,1,STANSTED,KAUNAS,31230,31230,0,32890,32890,0,-5.04713
25/03/2022 10:55,2021,3,EASTERN EUROPE-EU,LITHUANIA,1,STANSTED,PALANGA,13243,13243,0,14679,14679,0,-9.78268
25/03/2022 10:55,2021,3,EASTERN EUROPE-EU,LITHUANIA,1,STANSTED,VILNIUS,44273,44208,65,43817,42735,1082,1.04069
25/03/2022 10:55,2021,3,EASTERN EUROPE-EU,LITHUANIA,2,BELFAST INTERNATIONAL,VILNIUS,873,523,350,11965,11965,0,-92.70372
25/03/2022 10:55,2021,3,EASTERN EUROPE-EU,LITHUANIA,2,BIGGIN HILL,VILNIUS,4,0,4,0,0,0,0
25/03/2022 10:55,2021,3,EASTERN EUROPE-EU,LITHUANIA,2,BIRMINGHAM,VILNIUS,8614,8614,0,307,176,131,2705.86319
25/03/2022 10:55,2021,3,EASTERN EUROPE-EU,LITHUANIA,2,BRISTOL,KAUNAS,14154,14154,0,15002,15002,0,-5.65258
25/03/2022 10:55,2021,3,EASTERN EUROPE-EU,LITHUANIA,2,CITY OF DERRY (EGLINTON),VILNIUS,0,0,0,70,0,70,-100
25/03/2022 10:55,2021,3,EASTERN EUROPE-EU,LITHUANIA,2,DONCASTER SHEFFIELD,VILNIUS,9292,9292,0,20533,20533,0,-54.74602
25/03/2022 10:55,2021,3,EASTERN EUROPE-EU,LITHUANIA,2,EDINBURGH,KAUNAS,14248,14248,0,14384,14346,38,-0.94549
25/03/2022 10:55,2021,3,EASTERN EUROPE-EU,LITHUANIA,2,LEEDS BRADFORD,VILNIUS,10514,10514,0,453,453,0,2220.9713
25/03/2022 10:55,2021,3,EASTERN EUROPE-EU,LITHUANIA,2,LIVERPOOL (JOHN LENNON),KAUNAS,7287,7219,68,0,0,0,0
25/03/2022 10:55,2021,3,EASTERN EUROPE-EU,LITHUANIA,2,LIVERPOOL (JOHN LENNON),VILNIUS,12271,12217,54,14963,14963,0,-17.99104
25/03/2022 10:55,2021,3,EASTERN EUROPE-EU,LITHUANIA,2,MANCHESTER,KAUNAS,1634,1634,0,0,0,0,0
25/03/2022 10:55,2021,3,EASTERN EUROPE-EU,POLAND,1,GATWICK,GDANSK,216,216,0,44335,44335,0,-99.5128
25/03/2022 10:55,2021,3,EASTERN EUROPE-EU,POLAND,1,GATWICK,KRAKOW,20098,20098,0,83924,83143,781,-76.05214
25/03/2022 10:55,2021,3,EASTERN EUROPE-EU,POLAND,1,GATWICK,WARSAW (CHOPIN),770,0,770,245,0,245,214.28571
25/03/2022 10:55,2021,3,EASTERN EUROPE-EU,POLAND,1,GATWICK,WROCLAW,0,0,0,20,0,20,-100
25/03/2022 10:55,2021,3,EASTERN EUROPE-EU,POLAND,1,HEATHROW,KATOWICE,0,0,0,40,40,0,-100
25/03/2022 10:55,2021,3,EASTERN EUROPE-EU,POLAND,1,HEATHROW,KRAKOW,8861,8861,0,31955,31955,0,-72.27038
25/03/2022 10:55,2021,3,EASTERN EUROPE-EU,POLAND,1,HEATHROW,WARSAW (CHOPIN),119505,119505,0,160785,141690,19095,-25.67404
25/03/2022 10:55,2021,3,EASTERN EUROPE-EU,POLAND,1,LONDON CITY,WARSAW (CHOPIN),0,0,0,18190,15241,2949,-100
25/03/2022 10:55,2021,3,EASTERN EUROPE-EU,POLAND,1,LUTON,BYDGOSZCZ,13126,13126,0,15892,15892,0,-17.40498
25/03/2022 10:55,2021,3,EASTERN EUROPE-EU,POLAND,1,LUTON,GDANSK,82861,82861,0,85585,85585,0,-3.1828
25/03/2022 10:55,2021,3,EASTERN EUROPE-EU,POLAND,1,LUTON,KATOWICE,67617,67617,0,90500,90500,0,-25.28508
25/03/2022 10:55,2021,3,EASTERN EUROPE-EU,POLAND,1,LUTON,KRAKOW,99705,99705,0,131864,131864,0,-24.38801
25/03/2022 10:55,2021,3,EASTERN EUROPE-EU,POLAND,1,LUTON,LUBLIN (PORT LOTNICZY),35970,35970,0,55572,55572,0,-35.27316
25/03/2022 10:55,2021,3,EASTERN EUROPE-EU,POLAND,1,LUTON,POZNAN,41757,41757,0,51596,51596,0,-19.06931
25/03/2022 10:55,2021,3,EASTERN EUROPE-EU,POLAND,1,LUTON,RZESZOW,24719,24719,0,20056,20056,0,23.2499
25/03/2022 10:55,2021,3,EASTERN EUROPE-EU,POLAND,1,LUTON,SZYMANY (MAZURY),958,958,0,18153,18153,0,-94.72264
25/03/2022 10:55,2021,3,EASTERN EUROPE-EU,POLAND,1,LUTON,WARSAW (CHOPIN),124017,124017,0,179993,179993,0,-31.09899
25/03/2022 10:55,2021,3,EASTERN EUROPE-EU,POLAND,1,LUTON,WROCLAW,42251,42251,0,52036,52036,0,-18.80429
25/03/2022 10:55,2021,3,EASTERN EUROPE-EU,POLAND,1,STANSTED,BYDGOSZCZ,19717,19717,0,39966,39966,0,-50.66557
25/03/2022 10:55,2021,3,EASTERN EUROPE-EU,POLAND,1,STANSTED,GDANSK,69635,69501,134,59777,59777,0,16.49129
25/03/2022 10:55,2021,3,EASTERN EUROPE-EU,POLAND,1,STANSTED,KATOWICE,44177,44177,0,53434,53434,0,-17.32418
25/03/2022 10:55,2021,3,EASTERN EUROPE-EU,POLAND,1,STANSTED,KRAKOW,105250,105250,0,120518,120334,184,-12.66865
25/03/2022 10:55,2021,3,EASTERN EUROPE-EU,POLAND,1,STANSTED,LODZ LUBLINEK,22936,22936,0,40485,40485,0,-43.34692
25/03/2022 10:55,2021,3,EASTERN EUROPE-EU,POLAND,1,STANSTED,POZNAN,45689,45689,0,53891,53891,0,-15.21961
25/03/2022 10:55,2021,3,EASTERN EUROPE-EU,POLAND,1,STANSTED,RZESZOW,36471,36471,0,39400,39400,0,-7.43401
25/03/2022 10:55,2021,3,EASTERN EUROPE-EU,POLAND,1,STANSTED,SZCZECIN (GOLENOW),30318,30318,0,33567,33567,0,-9.67915
25/03/2022 10:55,2021,3,EASTERN EUROPE-EU,POLAND,1,STANSTED,SZYMANY (MAZURY),10707,10707,0,14479,14479,0,-26.05152
25/03/2022 10:55,2021,3,EASTERN EUROPE-EU,POLAND,1,STANSTED,WARSAW (CHOPIN),177,163,14,0,0,0,0
25/03/2022 10:55,2021,3,EASTERN EUROPE-EU,POLAND,1,STANSTED,WARSAW (MODLIN MASOVIA),112224,112224,0,123882,123806,76,-9.41057
25/03/2022 10:55,2021,3,EASTERN EUROPE-EU,POLAND,1,STANSTED,WROCLAW,64182,64182,0,72774,72726,48,-11.80641
25/03/2022 10:55,2021,3,EASTERN EUROPE-EU,POLAND,2,ABERDEEN,GDANSK,7738,7513,225,15707,15237,470,-50.73534
25/03/2022 10:55,2021,3,EASTERN EUROPE-EU,POLAND,2,ABERDEEN,WARSAW (CHOPIN),0,0,0,58,0,58,-100
25/03/2022 10:55,2021,3,EASTERN EUROPE-EU,POLAND,2,BELFAST INTERNATIONAL,GDANSK,5108,5108,0,7314,7314,0,-30.16133
25/03/2022 10:55,2021,3,EASTERN EUROPE-EU,POLAND,2,BELFAST INTERNATIONAL,KRAKOW,6836,6836,0,29960,29960,0,-77.18291
25/03/2022 10:55,2021,3,EASTERN EUROPE-EU,POLAND,2,BELFAST INTERNATIONAL,WARSAW (CHOPIN),0,0,0,35,0,35,-100
25/03/2022 10:55,2021,3,EASTERN EUROPE-EU,POLAND,2,BELFAST INTERNATIONAL,WARSAW (MODLIN MASOVIA),4758,4758,0,7659,7626,33,-37.87701
25/03/2022 10:55,2021,3,EASTERN EUROPE-EU,POLAND,2,BIGGIN HILL,GDANSK,2,0,2,0,0,0,0
25/03/2022 10:55,2021,3,EASTERN EUROPE-EU,POLAND,2,BIGGIN HILL,KATOWICE,20,0,20,0,0,0,0
25/03/2022 10:55,2021,3,EASTERN EUROPE-EU,POLAND,2,BIGGIN HILL,SZCZECIN (GOLENOW),1,0,1,0,0,0,0
25/03/2022 10:55,2021,3,EASTERN EUROPE-EU,POLAND,2,BIGGIN HILL,WARSAW (CHOPIN),1,0,1,10,0,10,-90
25/03/2022 10:55,2021,3,EASTERN EUROPE-EU,POLAND,2,BIRMINGHAM,BYDGOSZCZ,19636,19563,73,21054,21054,0,-6.73506
25/03/2022 10:55,2021,3,EASTERN EUROPE-EU,POLAND,2,BIRMINGHAM,GDANSK,13238,13238,0,17110,17110,0,-22.63004
25/03/2022 10:55,2021,3,EASTERN EUROPE-EU,POLAND,2,BIRMINGHAM,KATOWICE,11053,11053,0,15355,15355,0,-28.01693
25/03/2022 10:55,2021,3,EASTERN EUROPE-EU,POLAND,2,BIRMINGHAM,KRAKOW,31435,31435,0,51011,50288,723,-38.37604
25/03/2022 10:55,2021,3,EASTERN EUROPE-EU,POLAND,2,BIRMINGHAM,POZNAN,9109,9109,0,6605,6605,0,37.91067
25/03/2022 10:55,2021,3,EASTERN EUROPE-EU,POLAND,2,BIRMINGHAM,WARSAW (CHOPIN),9278,9278,0,19464,19464,0,-52.33251
25/03/2022 10:55,2021,3,EASTERN EUROPE-EU,POLAND,2,BIRMINGHAM,WARSAW (MODLIN MASOVIA),14528,14528,0,19692,19692,0,-26.22385
25/03/2022 10:55,2021,3,EASTERN EUROPE-EU,POLAND,2,BIRMINGHAM,WROCLAW,4192,4192,0,13369,13369,0,-68.64388
25/03/2022 10:55,2021,3,EASTERN EUROPE-EU,POLAND,2,BOURNEMOUTH,KATOWICE,142,142,0,0,0,0,0
25/03/2022 10:55,2021,3,EASTERN EUROPE-EU,POLAND,2,BOURNEMOUTH,KRAKOW,13640,13640,0,17115,17115,0,-20.30383
25/03/2022 10:55,2021,3,EASTERN EUROPE-EU,POLAND,2,BOURNEMOUTH,WROCLAW,2499,2499,0,0,0,0,0
25/03/2022 10:55,2021,3,EASTERN EUROPE-EU,POLAND,2,BRISTOL,GDANSK,14293,14293,0,17128,17128,0,-16.55184
25/03/2022 10:55,2021,3,EASTERN EUROPE-EU,POLAND,2,BRISTOL,KATOWICE,9004,9004,0,18865,18865,0,-52.2714
25/03/2022 10:55,2021,3,EASTERN EUROPE-EU,POLAND,2,BRISTOL,KRAKOW,33717,33717,0,44770,44770,0,-24.68841
25/03/2022 10:55,2021,3,EASTERN EUROPE-EU,POLAND,2,BRISTOL,POZNAN,12932,12932,0,19600,19600,0,-34.02041
25/03/2022 10:55,2021,3,EASTERN EUROPE-EU,POLAND,2,BRISTOL,RZESZOW,3410,3410,0,16221,16221,0,-78.97787
25/03/2022 10:55,2021,3,EASTERN EUROPE-EU,POLAND,2,BRISTOL,WARSAW (MODLIN MASOVIA),19895,19895,0,24890,24890,0,-20.0683
25/03/2022 10:55,2021,3,EASTERN EUROPE-EU,POLAND,2,BRISTOL,WROCLAW,12936,12936,0,16647,16647,0,-22.2923
25/03/2022 10:55,2021,3,EASTERN EUROPE-EU,POLAND,2,CARDIFF WALES,KATOWICE,76,76,0,46,0,46,65.21739
25/03/2022 10:55,2021,3,EASTERN EUROPE-EU,POLAND,2,CARDIFF WALES,KRAKOW,0,0,0,354,0,354,-100
25/03/2022 10:55,2021,3,EASTERN EUROPE-EU,POLAND,2,DONCASTER SHEFFIELD,GDANSK,16141,16141,0,28526,28526,0,-43.41653
25/03/2022 10:55,2021,3,EASTERN EUROPE-EU,POLAND,2,DONCASTER SHEFFIELD,KATOWICE,10413,10413,0,26529,26529,0,-60.74861
25/03/2022 10:55,2021,3,EASTERN EUROPE-EU,POLAND,2,DONCASTER SHEFFIELD,KRAKOW,9235,9235,0,17543,17543,0,-47.35792
25/03/2022 10:55,2021,3,EASTERN EUROPE-EU,POLAND,2,DONCASTER SHEFFIELD,LUBLIN (PORT LOTNICZY),7427,7427,0,636,636,0,1067.7673
25/03/2022 10:55,2021,3,EASTERN EUROPE-EU,POLAND,2,DONCASTER SHEFFIELD,POZNAN,10601,10601,0,21382,21382,0,-50.42091
25/03/2022 10:55,2021,3,EASTERN EUROPE-EU,POLAND,2,DONCASTER SHEFFIELD,WARSAW (CHOPIN),21785,21785,0,25123,25123,0,-13.28663
25/03/2022 10:55,2021,3,EASTERN EUROPE-EU,POLAND,2,DONCASTER SHEFFIELD,WROCLAW,6374,6374,0,15966,15966,0,-60.07767
25/03/2022 10:55,2021,3,EASTERN EUROPE-EU,POLAND,2,EAST MIDLANDS INTERNATIONAL,GDANSK,0,0,0,50,0,50,-100
25/03/2022 10:55,2021,3,EASTERN EUROPE-EU,POLAND,2,EAST MIDLANDS INTERNATIONAL,KRAKOW,12066,12066,0,19827,19413,414,-39.14359
25/03/2022 10:55,2021,3,EASTERN EUROPE-EU,POLAND,2,EAST MIDLANDS INTERNATIONAL,LODZ LUBLINEK,12859,12859,0,16761,16761,0,-23.28023
25/03/2022 10:55,2021,3,EASTERN EUROPE-EU,POLAND,2,EAST MIDLANDS INTERNATIONAL,RZESZOW,14998,14998,0,20829,20829,0,-27.99462
25/03/2022 10:55,2021,3,EASTERN EUROPE-EU,POLAND,2,EAST MIDLANDS INTERNATIONAL,WARSAW (CHOPIN),163,0,163,0,0,0,0
25/03/2022 10:55,2021,3,EASTERN EUROPE-EU,POLAND,2,EAST MIDLANDS INTERNATIONAL,WARSAW (MODLIN MASOVIA),12150,12150,0,16148,16148,0,-24.75848
25/03/2022 10:55,2021,3,EASTERN EUROPE-EU,POLAND,2,EAST MIDLANDS INTERNATIONAL,WROCLAW,19809,19809,0,26862,26862,0,-26.25642
25/03/2022 10:55,2021,3,EASTERN EUROPE-EU,POLAND,2,EDINBURGH,BYDGOSZCZ,0,0,0,5358,5358,0,-100
25/03/2022 10:55,2021,3,EASTERN EUROPE-EU,POLAND,2,EDINBURGH,GDANSK,24094,24094,0,47045,47045,0,-48.78521
25/03/2022 10:55,2021,3,EASTERN EUROPE-EU,POLAND,2,EDINBURGH,KATOWICE,11375,11375,0,15381,15381,0,-26.04512
25/03/2022 10:55,2021,3,EASTERN EUROPE-EU,POLAND,2,EDINBURGH,KRAKOW,35287,35287,0,52827,52827,0,-33.20272
25/03/2022 10:55,2021,3,EASTERN EUROPE-EU,POLAND,2,EDINBURGH,POZNAN,13272,13272,0,16321,16321,0,-18.68145
25/03/2022 10:55,2021,3,EASTERN EUROPE-EU,POLAND,2,EDINBURGH,WARSAW (CHOPIN),1985,1985,0,31195,29027,2168,-93.6368
25/03/2022 10:55,2021,3,EASTERN EUROPE-EU,POLAND,2,EDINBURGH,WARSAW (MODLIN MASOVIA),28017,28017,0,41634,41634,0,-32.70644
25/03/2022 10:55,2021,3,EASTERN EUROPE-EU,POLAND,2,EDINBURGH,WROCLAW,10512,10512,0,15910,15910,0,-33.92835
25/03/2022 10:55,2021,3,EASTERN EUROPE-EU,POLAND,2,EXETER,KRAKOW,132,132,0,0,0,0,0
25/03/2022 10:55,2021,3,EASTERN EUROPE-EU,POLAND,2,GLASGOW,GDANSK,0,0,0,161,161,0,-100
25/03/2022 10:55,2021,3,EASTERN EUROPE-EU,POLAND,2,GLASGOW,KATOWICE,0,0,0,148,148,0,-100
25/03/2022 10:55,2021,3,EASTERN EUROPE-EU,POLAND,2,GLASGOW,KRAKOW,12048,12048,0,22943,22943,0,-47.48725
25/03/2022 10:55,2021,3,EASTERN EUROPE-EU,POLAND,2,GLASGOW,POZNAN,0,0,0,190,0,190,-100
25/03/2022 10:55,2021,3,EASTERN EUROPE-EU,POLAND,2,GLASGOW,WARSAW (MODLIN MASOVIA),6778,6778,0,6492,6492,0,4.40542
25/03/2022 10:55,2021,3,EASTERN EUROPE-EU,POLAND,2,GLASGOW,WROCLAW,9966,9966,0,11301,11301,0,-11.81311
25/03/2022 10:55,2021,3,EASTERN EUROPE-EU,POLAND,2,JERSEY,WARSAW (CHOPIN),0,0,0,117,0,117,-100
25/03/2022 10:55,2021,3,EASTERN EUROPE-EU,POLAND,2,LEEDS BRADFORD,GDANSK,13216,13114,102,18904,18904,0,-30.08887
25/03/2022 10:55,2021,3,EASTERN EUROPE-EU,POLAND,2,LEEDS BRADFORD,KATOWICE,0,0,0,501,501,0,-100
25/03/2022 10:55,2021,3,EASTERN EUROPE-EU,POLAND,2,LEEDS BRADFORD,KRAKOW,23341,23341,0,35529,35529,0,-34.30437
25/03/2022 10:55,2021,3,EASTERN EUROPE-EU,POLAND,2,LEEDS BRADFORD,POZNAN,645,645,0,0,0,0,0
25/03/2022 10:55,2021,3,EASTERN EUROPE-EU,POLAND,2,LEEDS BRADFORD,WARSAW (CHOPIN),0,0,0,77,77,0,-100
25/03/2022 10:55,2021,3,EASTERN EUROPE-EU,POLAND,2,LEEDS BRADFORD,WARSAW (MODLIN MASOVIA),12078,12078,0,16036,16036,0,-24.68197
25/03/2022 10:55,2021,3,EASTERN EUROPE-EU,POLAND,2,LEEDS BRADFORD,WROCLAW,8308,8308,0,14526,14526,0,-42.806
25/03/2022 10:55,2021,3,EASTERN EUROPE-EU,POLAND,2,LIVERPOOL (JOHN LENNON),GDANSK,10026,10026,0,22165,22165,0,-54.76652
25/03/2022 10:55,2021,3,EASTERN EUROPE-EU,POLAND,2,LIVERPOOL (JOHN LENNON),KATOWICE,2643,2643,0,13279,13279,0,-80.09639
25/03/2022 10:55,2021,3,EASTERN EUROPE-EU,POLAND,2,LIVERPOOL (JOHN LENNON),KRAKOW,23354,23354,0,39253,39253,0,-40.50391
25/03/2022 10:55,2021,3,EASTERN EUROPE-EU,POLAND,2,LIVERPOOL (JOHN LENNON),POZNAN,11435,11435,0,14974,14974,0,-23.6343
25/03/2022 10:55,2021,3,EASTERN EUROPE-EU,POLAND,2,LIVERPOOL (JOHN LENNON),SZCZECIN (GOLENOW),12481,12481,0,15463,15463,0,-19.28474
25/03/2022 10:55,2021,3,EASTERN EUROPE-EU,POLAND,2,LIVERPOOL (JOHN LENNON),WARSAW (CHOPIN),10720,10720,0,18473,18473,0,-41.96936
25/03/2022 10:55,2021,3,EASTERN EUROPE-EU,POLAND,2,LIVERPOOL (JOHN LENNON),WARSAW (MODLIN MASOVIA),18590,18590,0,20003,20003,0,-7.06394
25/03/2022 10:55,2021,3,EASTERN EUROPE-EU,POLAND,2,LIVERPOOL (JOHN LENNON),WROCLAW,10724,10724,0,15934,15934,0,-32.69738
25/03/2022 10:55,2021,3,EASTERN EUROPE-EU,POLAND,2,MANCHESTER,GDANSK,18895,18105,790,15646,15646,0,20.76569
25/03/2022 10:55,2021,3,EASTERN EUROPE-EU,POLAND,2,MANCHESTER,KATOWICE,15515,15515,0,18570,18570,0,-16.45127
25/03/2022 10:55,2021,3,EASTERN EUROPE-EU,POLAND,2,MANCHESTER,KRAKOW,44341,44341,0,66524,66524,0,-33.34586
25/03/2022 10:55,2021,3,EASTERN EUROPE-EU,POLAND,2,MANCHESTER,POZNAN,2512,2512,0,0,0,0,0
25/03/2022 10:55,2021,3,EASTERN EUROPE-EU,POLAND,2,MANCHESTER,RZESZOW,11715,11715,0,16711,16711,0,-29.89648
25/03/2022 10:55,2021,3,EASTERN EUROPE-EU,POLAND,2,MANCHESTER,WARSAW (MODLIN MASOVIA),15477,15477,0,15905,15905,0,-2.69098
25/03/2022 10:55,2021,3,EASTERN EUROPE-EU,POLAND,2,MANCHESTER,WROCLAW,15151,15151,0,16672,16672,0,-9.12308
25/03/2022 10:55,2021,3,EASTERN EUROPE-EU,POLAND,2,NEWCASTLE,GDANSK,6030,6030,0,4515,4515,0,33.55482
25/03/2022 10:55,2021,3,EASTERN EUROPE-EU,POLAND,2,NEWCASTLE,KRAKOW,9636,9636,0,9705,9705,0,-0.71097
25/03/2022 10:55,2021,3,EASTERN EUROPE-EU,POLAND,2,NEWCASTLE,POZNAN,0,0,0,201,0,201,-100
25/03/2022 10:55,2021,3,EASTERN EUROPE-EU,POLAND,2,NEWCASTLE,WROCLAW,7594,7594,0,11276,11276,0,-32.65342
25/03/2022 10:55,2021,3,EASTERN EUROPE-EU,POLAND,2,PRESTWICK,KRAKOW,147,0,147,0,0,0,0
25/03/2022 10:55,2021,3,EASTERN EUROPE-EU,ROMANIA,1,GATWICK,BUCHAREST (OTOPENI),4221,3205,1016,48085,47708,377,-91.22179
25/03/2022 10:55,2021,3,EASTERN EUROPE-EU,ROMANIA,1,GATWICK,CLUJ NAPOCA,0,0,0,19855,19855,0,-100
25/03/2022 10:55,2021,3,EASTERN EUROPE-EU,ROMANIA,1,HEATHROW,BUCHAREST (OTOPENI),142185,142171,14,82608,79836,2772,72.12013
25/03/2022 10:55,2021,3,EASTERN EUROPE-EU,ROMANIA,1,HEATHROW,CLUJ NAPOCA,4872,4872,0,0,0,0,0
25/03/2022 10:55,2021,3,EASTERN EUROPE-EU,ROMANIA,1,HEATHROW,IASI,7612,7612,0,0,0,0,0
25/03/2022 10:55,2021,3,EASTERN EUROPE-EU,ROMANIA,1,LONDON CITY,BUCHAREST (OTOPENI),91,0,91,0,0,0,0
25/03/2022 10:55,2021,3,EASTERN EUROPE-EU,ROMANIA,1,LUTON,BACAU,118006,118006,0,42384,42384,0,178.4211
25/03/2022 10:55,2021,3,EASTERN EUROPE-EU,ROMANIA,1,LUTON,BUCHAREST (OTOPENI),228310,228310,0,254593,252652,1941,-10.32354
25/03/2022 10:55,2021,3,EASTERN EUROPE-EU,ROMANIA,1,LUTON,CLUJ NAPOCA,111672,111672,0,92817,92817,0,20.31417
25/03/2022 10:55,2021,3,EASTERN EUROPE-EU,ROMANIA,1,LUTON,CONSTANTA,20119,20119,0,24254,24254,0,-17.04873
25/03/2022 10:55,2021,3,EASTERN EUROPE-EU,ROMANIA,1,LUTON,CRAIOVA,64329,64329,0,63485,63485,0,1.32945
25/03/2022 10:55,2021,3,EASTERN EUROPE-EU,ROMANIA,1,LUTON,IASI,90448,90448,0,97753,97753,0,-7.47292
25/03/2022 10:55,2021,3,EASTERN EUROPE-EU,ROMANIA,1,LUTON,SATU MARE,18759,18687,72,18152,18152,0,3.34398
25/03/2022 10:55,2021,3,EASTERN EUROPE-EU,ROMANIA,1,LUTON,SIBIU,41009,41009,0,19465,19465,0,110.68071
25/03/2022 10:55,2021,3,EASTERN EUROPE-EU,ROMANIA,1,LUTON,SUCEAVA,83237,83237,0,78540,78540,0,5.98039
25/03/2022 10:55,2021,3,EASTERN EUROPE-EU,ROMANIA,1,LUTON,TIMISOARA,42396,42396,0,52929,52929,0,-19.90024
25/03/2022 10:55,2021,3,EASTERN EUROPE-EU,ROMANIA,1,LUTON,TIRGU MURES,13235,13235,0,17293,17293,0,-23.46614
25/03/2022 10:55,2021,3,EASTERN EUROPE-EU,ROMANIA,1,SOUTHEND,BUCHAREST (OTOPENI),12326,12326,0,49398,49398,0,-75.04757
25/03/2022 10:55,2021,3,EASTERN EUROPE-EU,ROMANIA,1,SOUTHEND,SIBIU,0,0,0,19520,19520,0,-100
25/03/2022 10:55,2021,3,EASTERN EUROPE-EU,ROMANIA,1,STANSTED,BUCHAREST (OTOPENI),145772,145772,0,103620,103186,434,40.67941
25/03/2022 10:55,2021,3,EASTERN EUROPE-EU,ROMANIA,1,STANSTED,CLUJ NAPOCA,22499,22499,0,5306,5306,0,324.0294
25/03/2022 10:55,2021,3,EASTERN EUROPE-EU,ROMANIA,1,STANSTED,IASI,0,0,0,651,0,651,-100
25/03/2022 10:55,2021,3,EASTERN EUROPE-EU,ROMANIA,1,STANSTED,ORADEA,11463,11463,0,0,0,0,0
25/03/2022 10:55,2021,3,EASTERN EUROPE-EU,ROMANIA,1,STANSTED,TIMISOARA,89,89,0,0,0,0,0
25/03/2022 10:55,2021,3,EASTERN EUROPE-EU,ROMANIA,2,BELFAST INTERNATIONAL,BUCHAREST (BANEASA),0,0,0,48,0,48,-100
25/03/2022 10:55,2021,3,EASTERN EUROPE-EU,ROMANIA,2,BELFAST INTERNATIONAL,BUCHAREST (OTOPENI),0,0,0,106,0,106,-100
25/03/2022 10:55,2021,3,EASTERN EUROPE-EU,ROMANIA,2,BIGGIN HILL,BUCHAREST (BANEASA),0,0,0,3,0,3,-100
25/03/2022 10:55,2021,3,EASTERN EUROPE-EU,ROMANIA,2,BIGGIN HILL,BUCHAREST (OTOPENI),4,0,4,0,0,0,0
25/03/2022 10:55,2021,3,EASTERN EUROPE-EU,ROMANIA,2,BIRMINGHAM,BUCHAREST (OTOPENI),67885,67885,0,47916,46849,1067,41.67501
25/03/2022 10:55,2021,3,EASTERN EUROPE-EU,ROMANIA,2,BIRMINGHAM,CLUJ NAPOCA,9612,9612,0,15610,15610,0,-38.42409
25/03/2022 10:55,2021,3,EASTERN EUROPE-EU,ROMANIA,2,BIRMINGHAM,CRAIOVA,14192,14192,0,1268,1268,0,1019.2429
25/03/2022 10:55,2021,3,EASTERN EUROPE-EU,ROMANIA,2,BIRMINGHAM,IASI,6623,6623,0,343,343,0,1830.90379
25/03/2022 10:55,2021,3,EASTERN EUROPE-EU,ROMANIA,2,BRISTOL,BUCHAREST (OTOPENI),19248,19248,0,17138,17138,0,12.31182
25/03/2022 10:55,2021,3,EASTERN EUROPE-EU,ROMANIA,2,DONCASTER SHEFFIELD,BUCHAREST (OTOPENI),51320,51320,0,48707,48707,0,5.36473
25/03/2022 10:55,2021,3,EASTERN EUROPE-EU,ROMANIA,2,DONCASTER SHEFFIELD,CLUJ NAPOCA,18516,18516,0,18715,18715,0,-1.06332
25/03/2022 10:55,2021,3,EASTERN EUROPE-EU,ROMANIA,2,DONCASTER SHEFFIELD,CRAIOVA,291,0,291,0,0,0,0
25/03/2022 10:55,2021,3,EASTERN EUROPE-EU,ROMANIA,2,DONCASTER SHEFFIELD,SUCEAVA,1042,1042,0,342,342,0,204.67836
25/03/2022 10:55,2021,3,EASTERN EUROPE-EU,ROMANIA,2,DONCASTER SHEFFIELD,TIMISOARA,0,0,0,990,990,0,-100
25/03/2022 10:55,2021,3,EASTERN EUROPE-EU,ROMANIA,2,EAST MIDLANDS INTERNATIONAL,CRAIOVA,69,0,69,0,0,0,0
25/03/2022 10:55,2021,3,EASTERN EUROPE-EU,ROMANIA,2,EDINBURGH,BUCHAREST (OTOPENI),30669,30669,0,33948,33400,548,-9.65889
25/03/2022 10:55,2021,3,EASTERN EUROPE-EU,ROMANIA,2,EXETER,CONSTANTA,135,0,135,438,0,438,-69.17808
25/03/2022 10:55,2021,3,EASTERN EUROPE-EU,ROMANIA,2,GLASGOW,BUCHAREST (BANEASA),59,0,59,0,0,0,0
25/03/2022 10:55,2021,3,EASTERN EUROPE-EU,ROMANIA,2,GLASGOW,BUCHAREST (OTOPENI),0,0,0,5487,5487,0,-100
25/03/2022 10:55,2021,3,EASTERN EUROPE-EU,ROMANIA,2,HUMBERSIDE,CONSTANTA,0,0,0,145,0,145,-100
25/03/2022 10:55,2021,3,EASTERN EUROPE-EU,ROMANIA,2,LIVERPOOL (JOHN LENNON),BACAU,10977,10977,0,7262,7262,0,51.15671
25/03/2022 10:55,2021,3,EASTERN EUROPE-EU,ROMANIA,2,LIVERPOOL (JOHN LENNON),BUCHAREST (OTOPENI),38269,38190,79,43569,43569,0,-12.16461
25/03/2022 10:55,2021,3,EASTERN EUROPE-EU,ROMANIA,2,LIVERPOOL (JOHN LENNON),CLUJ NAPOCA,781,781,0,7420,7420,0,-89.47439
25/03/2022 10:55,2021,3,EASTERN EUROPE-EU,ROMANIA,2,LIVERPOOL (JOHN LENNON),IASI,12148,12148,0,17570,17570,0,-30.85942
25/03/2022 10:55,2021,3,EASTERN EUROPE-EU,ROMANIA,2,LIVERPOOL (JOHN LENNON),SIBIU,1453,1453,0,0,0,0,0
25/03/2022 10:55,2021,3,EASTERN EUROPE-EU,ROMANIA,2,MANCHESTER,BUCHAREST (OTOPENI),19728,19728,0,0,0,0,0
25/03/2022 10:55,2021,3,EASTERN EUROPE-EU,ROMANIA,2,MANCHESTER,SUCEAVA,1060,1060,0,0,0,0,0
25/03/2022 10:55,2021,3,EASTERN EUROPE-EU,ROMANIA,2,NEWQUAY,BUCHAREST (OTOPENI),0,0,0,128,0,128,-100
25/03/2022 10:55,2021,3,EASTERN EUROPE-EU,ROMANIA,2,TEESSIDE INTERNATIONAL AIRPORT,BUCHAREST (OTOPENI),99,0,99,0,0,0,0
25/03/2022 10:55,2021,3,EASTERN EUROPE-EU,SLOVAK REPUBLIC,1,GATWICK,BRATISLAVA,0,0,0,26,0,26,-100
25/03/2022 10:55,2021,3,EASTERN EUROPE-EU,SLOVAK REPUBLIC,1,LUTON,BRATISLAVA,13036,13036,0,28281,28281,0,-53.90545
25/03/2022 10:55,2021,3,EASTERN EUROPE-EU,SLOVAK REPUBLIC,1,LUTON,KOSICE,38275,38275,0,44371,44371,0,-13.7387
25/03/2022 10:55,2021,3,EASTERN EUROPE-EU,SLOVAK REPUBLIC,1,LUTON,TATRY-POPRAD,8096,8096,0,16548,16548,0,-51.07566
25/03/2022 10:55,2021,3,EASTERN EUROPE-EU,SLOVAK REPUBLIC,1,STANSTED,BRATISLAVA,42130,42130,0,52874,52192,682,-20.32001
25/03/2022 10:55,2021,3,EASTERN EUROPE-EU,SLOVAK REPUBLIC,1,STANSTED,KOSICE,14187,14187,0,6579,6579,0,115.64067
25/03/2022 10:55,2021,3,EASTERN EUROPE-EU,SLOVAK REPUBLIC,2,ABERDEEN,BRATISLAVA,89,0,89,0,0,0,0
25/03/2022 10:55,2021,3,EASTERN EUROPE-EU,SLOVAK REPUBLIC,2,BELFAST INTERNATIONAL,BRATISLAVA,0,0,0,104,0,104,-100
25/03/2022 10:55,2021,3,EASTERN EUROPE-EU,SLOVAK REPUBLIC,2,BIRMINGHAM,BRATISLAVA,11736,11736,0,17223,16052,1171,-31.85856
25/03/2022 10:55,2021,3,EASTERN EUROPE-EU,SLOVAK REPUBLIC,2,CARDIFF WALES,BRATISLAVA,62,0,62,0,0,0,0
25/03/2022 10:55,2021,3,EASTERN EUROPE-EU,SLOVAK REPUBLIC,2,DONCASTER SHEFFIELD,BRATISLAVA,0,0,0,160,160,0,-100
25/03/2022 10:55,2021,3,EASTERN EUROPE-EU,SLOVAK REPUBLIC,2,DONCASTER SHEFFIELD,KOSICE,15024,15024,0,0,0,0,0
25/03/2022 10:55,2021,3,EASTERN EUROPE-EU,SLOVAK REPUBLIC,2,EDINBURGH,BRATISLAVA,5659,5659,0,11948,11948,0,-52.63642
25/03/2022 10:55,2021,3,EASTERN EUROPE-EU,SLOVAK REPUBLIC,2,GLASGOW,BRATISLAVA,0,0,0,95,0,95,-100
25/03/2022 10:55,2021,3,EASTERN EUROPE-EU,SLOVAK REPUBLIC,2,LEEDS BRADFORD,BRATISLAVA,5660,5660,0,6551,6551,0,-13.60098
25/03/2022 10:55,2021,3,EASTERN EUROPE-EU,SLOVAK REPUBLIC,2,LIVERPOOL (JOHN LENNON),KOSICE,7839,7839,0,1041,1041,0,653.02594
25/03/2022 10:55,2021,3,EASTERN EUROPE-EU,SLOVAK REPUBLIC,2,LIVERPOOL (JOHN LENNON),PIESTANY,0,0,0,66,0,66,-100
25/03/2022 10:55,2021,3,EASTERN EUROPE-EU,SLOVAK REPUBLIC,2,MANCHESTER,BRATISLAVA,11528,11528,0,17222,17222,0,-33.06236
25/03/2022 10:55,2021,4,EASTERN EUROPE -OTHER,ALBANIA,1,GATWICK,TIRANA,15382,14491,891,32979,32626,353,-53.3582
25/03/2022 10:55,2021,4,EASTERN EUROPE -OTHER,ALBANIA,1,HEATHROW,TIRANA,71964,71964,0,20406,20406,0,252.66098
25/03/2022 10:55,2021,4,EASTERN EUROPE -OTHER,ALBANIA,1,LUTON,TIRANA,131597,131597,0,76603,74489,2114,71.79092
25/03/2022 10:55,2021,4,EASTERN EUROPE -OTHER,ALBANIA,1,STANSTED,TIRANA,5129,5129,0,3035,3035,0,68.99506
25/03/2022 10:55,2021,4,EASTERN EUROPE -OTHER,ALBANIA,2,BIRMINGHAM,TIRANA,748,0,748,420,0,420,78.09524
25/03/2022 10:55,2021,4,EASTERN EUROPE -OTHER,ALBANIA,2,LIVERPOOL (JOHN LENNON),TIRANA,1372,1372,0,0,0,0,0
25/03/2022 10:55,2021,4,EASTERN EUROPE -OTHER,ALBANIA,2,MANCHESTER,TIRANA,0,0,0,24,0,24,-100
25/03/2022 10:55,2021,4,EASTERN EUROPE -OTHER,ARMENIA,2,GLASGOW,YEREVAN,130,0,130,0,0,0,0
25/03/2022 10:55,2021,4,EASTERN EUROPE -OTHER,ARMENIA,2,MANCHESTER,YEREVAN,53,0,53,0,0,0,0
25/03/2022 10:55,2021,4,EASTERN EUROPE -OTHER,AZERBAIJAN,1,HEATHROW,BAKU (HEYDER ALIYEV INT'L),10841,9804,1037,10959,9349,1610,-1.07674
25/03/2022 10:55,2021,4,EASTERN EUROPE -OTHER,AZERBAIJAN,2,ABERDEEN,BAKU (HEYDER ALIYEV INT'L),88,0,88,0,0,0,0
25/03/2022 10:55,2021,4,EASTERN EUROPE -OTHER,AZERBAIJAN,2,BIRMINGHAM,BAKU (HEYDER ALIYEV INT'L),525,0,525,0,0,0,0
25/03/2022 10:55,2021,4,EASTERN EUROPE -OTHER,AZERBAIJAN,2,CARDIFF WALES,BAKU (HEYDER ALIYEV INT'L),225,0,225,0,0,0,0
25/03/2022 10:55,2021,4,EASTERN EUROPE -OTHER,AZERBAIJAN,2,MANCHESTER,BAKU (HEYDER ALIYEV INT'L),0,0,0,34,0,34,-100
25/03/2022 10:55,2021,4,EASTERN EUROPE -OTHER,BELARUS,1,GATWICK,MINSK INT'L ,6031,6031,0,25648,25648,0,-76.4855
25/03/2022 10:55,2021,4,EASTERN EUROPE -OTHER,GEORGIA,1,GATWICK,TBILISI,0,0,0,1136,1136,0,-100
25/03/2022 10:55,2021,4,EASTERN EUROPE -OTHER,GEORGIA,1,LUTON,KUTAISI,0,0,0,5702,5702,0,-100
25/03/2022 10:55,2021,4,EASTERN EUROPE -OTHER,GEORGIA,2,LIVERPOOL (JOHN LENNON),TBILISI,0,0,0,90,0,90,-100
25/03/2022 10:55,2021,4,EASTERN EUROPE -OTHER,KAZAKHSTAN,1,GATWICK,NURSULTAN NAZERBAYEV INTERNATIONAL,0,0,0,1,0,1,-100
25/03/2022 10:55,2021,4,EASTERN EUROPE -OTHER,KAZAKHSTAN,1,HEATHROW,NURSULTAN NAZERBAYEV INTERNATIONAL,3651,3651,0,6260,6206,54,-41.67732
25/03/2022 10:55,2021,4,EASTERN EUROPE -OTHER,KAZAKHSTAN,1,HEATHROW,PETROPAVLOSVK,0,0,0,95,0,95,-100
25/03/2022 10:55,2021,4,EASTERN EUROPE -OTHER,KAZAKHSTAN,2,BIGGIN HILL,ALMATY,0,0,0,4,0,4,-100
25/03/2022 10:55,2021,4,EASTERN EUROPE -OTHER,REPUBLIC OF MOLDOVA,1,LUTON,CHISINAU (KISHINEV),135991,135991,0,92973,91843,1130,46.26935
25/03/2022 10:55,2021,4,EASTERN EUROPE -OTHER,REPUBLIC OF MOLDOVA,1,STANSTED,CHISINAU (KISHINEV),27182,27182,0,32353,28138,4215,-15.98306
25/03/2022 10:55,2021,4,EASTERN EUROPE -OTHER,REPUBLIC OF MOLDOVA,2,ABERDEEN,CHISINAU (KISHINEV),376,0,376,0,0,0,0
25/03/2022 10:55,2021,4,EASTERN EUROPE -OTHER,REPUBLIC OF MOLDOVA,2,EDINBURGH,CHISINAU (KISHINEV),364,0,364,0,0,0,0
25/03/2022 10:55,2021,4,EASTERN EUROPE -OTHER,REPUBLIC OF MOLDOVA,2,GLASGOW,CHISINAU (KISHINEV),440,0,440,0,0,0,0
25/03/2022 10:55,2021,4,EASTERN EUROPE -OTHER,REPUBLIC OF MOLDOVA,2,LIVERPOOL (JOHN LENNON),CHISINAU (KISHINEV),10688,10654,34,884,884,0,1109.04977
25/03/2022 10:55,2021,4,EASTERN EUROPE -OTHER,RUSSIA,1,GATWICK,KRASNODAR,0,0,0,58,0,58,-100
25/03/2022 10:55,2021,4,EASTERN EUROPE -OTHER,RUSSIA,1,GATWICK,MOSCOW (VNUKOVO),0,0,0,9,0,9,-100
25/03/2022 10:55,2021,4,EASTERN EUROPE -OTHER,RUSSIA,1,GATWICK,ST PETERSBURG,424,0,424,13012,13012,0,-96.74147
25/03/2022 10:55,2021,4,EASTERN EUROPE -OTHER,RUSSIA,1,HEATHROW,ADLER / SOCHI,1112,0,1112,622,0,622,78.77814
25/03/2022 10:55,2021,4,EASTERN EUROPE -OTHER,RUSSIA,1,HEATHROW,MOSCOW (DOMODEDOVO),33928,33928,0,41350,41350,0,-17.94921
25/03/2022 10:55,2021,4,EASTERN EUROPE -OTHER,RUSSIA,1,HEATHROW,MOSCOW (SHEREMETYEVO),89999,81440,8559,167890,166597,1293,-46.39407
25/03/2022 10:55,2021,4,EASTERN EUROPE -OTHER,RUSSIA,1,HEATHROW,ST PETERSBURG,0,0,0,60,0,60,-100
25/03/2022 10:55,2021,4,EASTERN EUROPE -OTHER,RUSSIA,1,LUTON,MOSCOW (VNUKOVO),0,0,0,39660,39660,0,-100
25/03/2022 10:55,2021,4,EASTERN EUROPE -OTHER,RUSSIA,1,LUTON,ST PETERSBURG,0,0,0,34023,34023,0,-100
25/03/2022 10:55,2021,4,EASTERN EUROPE -OTHER,RUSSIA,1,SOUTHEND,ST PETERSBURG,0,0,0,92,92,0,-100
25/03/2022 10:55,2021,4,EASTERN EUROPE -OTHER,RUSSIA,1,STANSTED,ADLER / SOCHI,0,0,0,1,0,1,-100
25/03/2022 10:55,2021,4,EASTERN EUROPE -OTHER,RUSSIA,1,STANSTED,MOSCOW (DOMODEDOVO),0,0,0,6821,6821,0,-100
25/03/2022 10:55,2021,4,EASTERN EUROPE -OTHER,RUSSIA,2,BIGGIN HILL,KALININGRAD,3,0,3,0,0,0,0
25/03/2022 10:55,2021,4,EASTERN EUROPE -OTHER,RUSSIA,2,BIGGIN HILL,MOSCOW (VNUKOVO),63,0,63,44,0,44,43.18182
25/03/2022 10:55,2021,4,EASTERN EUROPE -OTHER,RUSSIA,2,BIGGIN HILL,ST PETERSBURG,6,0,6,3,0,3,100
25/03/2022 10:55,2021,4,EASTERN EUROPE -OTHER,RUSSIA,2,BIRMINGHAM,ADLER / SOCHI,292,0,292,0,0,0,0
25/03/2022 10:55,2021,4,EASTERN EUROPE -OTHER,RUSSIA,2,CARDIFF WALES,BRYANSK INTERNATIONAL,24,0,24,0,0,0,0
25/03/2022 10:55,2021,4,EASTERN EUROPE -OTHER,RUSSIA,2,CARDIFF WALES,KALININGRAD,88,0,88,0,0,0,0
25/03/2022 10:55,2021,4,EASTERN EUROPE -OTHER,RUSSIA,2,CARDIFF WALES,KAZAN,50,0,50,0,0,0,0
25/03/2022 10:55,2021,4,EASTERN EUROPE -OTHER,RUSSIA,2,EAST MIDLANDS INTERNATIONAL,MOSCOW (SHEREMETYEVO),122,0,122,0,0,0,0
25/03/2022 10:55,2021,4,EASTERN EUROPE -OTHER,RUSSIA,2,GLASGOW,BRYANSK INTERNATIONAL,64,0,64,0,0,0,0
25/03/2022 10:55,2021,4,EASTERN EUROPE -OTHER,RUSSIA,2,HUMBERSIDE,ST PETERSBURG,0,0,0,269,0,269,-100
25/03/2022 10:55,2021,4,EASTERN EUROPE -OTHER,RUSSIA,2,MANCHESTER,MOSCOW (VNUKOVO),1,1,0,0,0,0,0
25/03/2022 10:55,2021,4,EASTERN EUROPE -OTHER,TURKMENISTAN,2,BIRMINGHAM,ASHKHABAD,0,0,0,1383,1383,0,-100
25/03/2022 10:55,2021,4,EASTERN EUROPE -OTHER,UKRAINE,1,GATWICK,KIEV (BORISPOL),51526,51526,0,38398,36301,2097,34.18928
25/03/2022 10:55,2021,4,EASTERN EUROPE -OTHER,UKRAINE,1,HEATHROW,KIEV (BORISPOL),14544,14544,0,1875,753,1122,675.68
25/03/2022 10:55,2021,4,EASTERN EUROPE -OTHER,UKRAINE,1,LUTON,KIEV (ZHULYANY),41480,41480,0,31393,31393,0,32.13137
25/03/2022 10:55,2021,4,EASTERN EUROPE -OTHER,UKRAINE,1,LUTON,LVOV,34256,34256,0,18112,18112,0,89.13428
25/03/2022 10:55,2021,4,EASTERN EUROPE -OTHER,UKRAINE,1,SOUTHEND,KIEV (BORISPOL),0,0,0,121,121,0,-100
25/03/2022 10:55,2021,4,EASTERN EUROPE -OTHER,UKRAINE,1,STANSTED,KIEV (BORISPOL),36602,36602,0,26235,26091,144,39.51591
25/03/2022 10:55,2021,4,EASTERN EUROPE -OTHER,UKRAINE,1,STANSTED,LVOV,22594,22594,0,20276,20276,0,11.43224
25/03/2022 10:55,2021,4,EASTERN EUROPE -OTHER,UKRAINE,2,BELFAST INTERNATIONAL,DNEPROPETROVSK,44,0,44,0,0,0,0
25/03/2022 10:55,2021,4,EASTERN EUROPE -OTHER,UKRAINE,2,BELFAST INTERNATIONAL,KIEV (BORISPOL),79,0,79,56,0,56,41.07143
25/03/2022 10:55,2021,4,EASTERN EUROPE -OTHER,UKRAINE,2,BELFAST INTERNATIONAL,KIEV (ZHULYANY),78,0,78,0,0,0,0
25/03/2022 10:55,2021,4,EASTERN EUROPE -OTHER,UKRAINE,2,BIGGIN HILL,KIEV (BORISPOL),0,0,0,3,0,3,-100
25/03/2022 10:55,2021,4,EASTERN EUROPE -OTHER,UKRAINE,2,BIGGIN HILL,KIEV (ZHULYANY),1,0,1,0,0,0,0
25/03/2022 10:55,2021,4,EASTERN EUROPE -OTHER,UKRAINE,2,BIRMINGHAM,KIEV (BORISPOL),0,0,0,578,0,578,-100
25/03/2022 10:55,2021,4,EASTERN EUROPE -OTHER,UKRAINE,2,EDINBURGH,KIEV (BORISPOL),186,0,186,331,0,331,-43.80665
25/03/2022 10:55,2021,4,EASTERN EUROPE -OTHER,UKRAINE,2,GLASGOW,KIEV (BORISPOL),39,0,39,0,0,0,0
25/03/2022 10:55,2021,4,EASTERN EUROPE -OTHER,UKRAINE,2,HUMBERSIDE,KIEV (BORISPOL),0,0,0,93,0,93,-100
25/03/2022 10:55,2021,4,EASTERN EUROPE -OTHER,UKRAINE,2,HUMBERSIDE,ODESSA,0,0,0,88,0,88,-100
25/03/2022 10:55,2021,4,EASTERN EUROPE -OTHER,UKRAINE,2,MANCHESTER,KIEV (BORISPOL),3319,3319,0,13660,13660,0,-75.70278
25/03/2022 10:55,2021,4,EASTERN EUROPE -OTHER,UKRAINE,2,MANCHESTER,LVOV,1629,1629,0,0,0,0,0
25/03/2022 10:55,2021,4,EASTERN EUROPE -OTHER,UKRAINE,2,TEESSIDE INTERNATIONAL AIRPORT,MYKOLAIV,61,0,61,0,0,0,0
25/03/2022 10:55,2021,4,EASTERN EUROPE -OTHER,UZBEKISTAN,1,HEATHROW,TASHKENT,4962,4953,9,5868,5518,350,-15.43967
25/03/2022 10:55,2021,25,NEAR EAST,ISRAEL,1,GATWICK,TEL AVIV,1472,1472,0,9064,9064,0,-83.75993
25/03/2022 10:55,2021,25,NEAR EAST,ISRAEL,1,HEATHROW,TEL AVIV,212030,211593,437,161561,161536,25,31.23836
25/03/2022 10:55,2021,25,NEAR EAST,ISRAEL,1,LUTON,TEL AVIV,46539,46539,0,94041,94041,0,-50.51201
25/03/2022 10:55,2021,25,NEAR EAST,ISRAEL,1,STANSTED,TEL AVIV,0,0,0,7117,6436,681,-100
25/03/2022 10:55,2021,25,NEAR EAST,ISRAEL,2,BIGGIN HILL,TEL AVIV,0,0,0,4,0,4,-100
25/03/2022 10:55,2021,25,NEAR EAST,ISRAEL,2,GLASGOW,TEL AVIV,98,0,98,306,0,306,-67.97386
25/03/2022 10:55,2021,25,NEAR EAST,ISRAEL,2,MANCHESTER,TEL AVIV,11502,11429,73,12865,12865,0,-10.59464
25/03/2022 10:55,2021,25,NEAR EAST,JORDAN,1,GATWICK,AMMAN,0,0,0,6,0,6,-100
25/03/2022 10:55,2021,25,NEAR EAST,JORDAN,1,GATWICK,AQABA,1822,1822,0,6424,6424,0,-71.63761
25/03/2022 10:55,2021,25,NEAR EAST,JORDAN,1,HEATHROW,AMMAN,109350,109350,0,46863,46863,0,133.33973
25/03/2022 10:55,2021,25,NEAR EAST,JORDAN,2,MANCHESTER,AQABA,492,492,0,0,0,0,0
25/03/2022 10:55,2021,25,NEAR EAST,LEBANON,1,HEATHROW,BEIRUT,83181,83181,0,76253,74232,2021,9.08554
25/03/2022 10:55,2021,25,NEAR EAST,LEBANON,2,BIGGIN HILL,BEIRUT,1,0,1,0,0,0,0
25/03/2022 10:55,2021,25,NEAR EAST,LEBANON,2,MANCHESTER,BEIRUT,0,0,0,178,0,178,-100
25/03/2022 10:55,2021,30,NORTH AFRICA,ALGERIA,1,GATWICK,ALGIERS,0,0,0,15224,14678,546,-100
25/03/2022 10:55,2021,30,NORTH AFRICA,ALGERIA,1,HEATHROW,ADRAR,22,0,22,0,0,0,0
25/03/2022 10:55,2021,30,NORTH AFRICA,ALGERIA,1,HEATHROW,ALGIERS,11157,11157,0,14128,12891,1237,-21.02916
25/03/2022 10:55,2021,30,NORTH AFRICA,ALGERIA,1,HEATHROW,HASSI MESSAOUD,0,0,0,66,0,66,-100
25/03/2022 10:55,2021,30,NORTH AFRICA,ALGERIA,1,STANSTED,HASSI MESSAOUD,36,0,36,0,0,0,0
25/03/2022 10:55,2021,30,NORTH AFRICA,EGYPT,1,GATWICK,ALEXANDRIA (BORG EL ARAB),426,0,426,323,0,323,31.88854
25/03/2022 10:55,2021,30,NORTH AFRICA,EGYPT,1,GATWICK,CAIRO,317,0,317,1765,0,1765,-82.03966
25/03/2022 10:55,2021,30,NORTH AFRICA,EGYPT,1,GATWICK,HURGHADA,25180,25180,0,41693,41017,676,-39.60617
25/03/2022 10:55,2021,30,NORTH AFRICA,EGYPT,1,GATWICK,MARSA ALAM,0,0,0,4138,3984,154,-100
25/03/2022 10:55,2021,30,NORTH AFRICA,EGYPT,1,GATWICK,SHARM EL SHEIKH (OPHIRA),17880,17880,0,7143,6219,924,150.31499
25/03/2022 10:55,2021,30,NORTH AFRICA,EGYPT,1,HEATHROW,ALEXANDRIA (BORG EL ARAB),0,0,0,232,0,232,-100
25/03/2022 10:55,2021,30,NORTH AFRICA,EGYPT,1,HEATHROW,CAIRO,154155,154047,108,147026,145563,1463,4.8488
25/03/2022 10:55,2021,30,NORTH AFRICA,EGYPT,1,HEATHROW,LUXOR,827,827,0,2295,2295,0,-63.96514
25/03/2022 10:55,2021,30,NORTH AFRICA,EGYPT,1,HEATHROW,MARSA ALAM,0,0,0,487,320,167,-100
25/03/2022 10:55,2021,30,NORTH AFRICA,EGYPT,1,LUTON,HURGHADA,3820,3820,0,0,0,0,0
25/03/2022 10:55,2021,30,NORTH AFRICA,EGYPT,1,LUTON,SHARM EL SHEIKH (OPHIRA),2088,2088,0,0,0,0,0
25/03/2022 10:55,2021,30,NORTH AFRICA,EGYPT,1,STANSTED,HURGHADA,0,0,0,7444,7444,0,-100
25/03/2022 10:55,2021,30,NORTH AFRICA,EGYPT,1,STANSTED,SHARM EL SHEIKH (OPHIRA),378,378,0,0,0,0,0
25/03/2022 10:55,2021,30,NORTH AFRICA,EGYPT,2,BIGGIN HILL,CAIRO,5,0,5,27,0,27,-81.48148
25/03/2022 10:55,2021,30,NORTH AFRICA,EGYPT,2,BIRMINGHAM,HURGHADA,7161,7161,0,13398,13254,144,-46.55172
25/03/2022 10:55,2021,30,NORTH AFRICA,EGYPT,2,BIRMINGHAM,MARSA ALAM,0,0,0,802,802,0,-100
25/03/2022 10:55,2021,30,NORTH AFRICA,EGYPT,2,BIRMINGHAM,SHARM EL SHEIKH (OPHIRA),4354,4354,0,3744,1301,2443,16.29274
25/03/2022 10:55,2021,30,NORTH AFRICA,EGYPT,2,BRISTOL,HURGHADA,7477,7477,0,14401,10413,3988,-48.07999
25/03/2022 10:55,2021,30,NORTH AFRICA,EGYPT,2,BRISTOL,SHARM EL SHEIKH (OPHIRA),2667,2667,0,0,0,0,0
25/03/2022 10:55,2021,30,NORTH AFRICA,EGYPT,2,DONCASTER SHEFFIELD,HURGHADA,652,652,0,0,0,0,0
25/03/2022 10:55,2021,30,NORTH AFRICA,EGYPT,2,EAST MIDLANDS INTERNATIONAL,HURGHADA,0,0,0,184,184,0,-100
25/03/2022 10:55,2021,30,NORTH AFRICA,EGYPT,2,GLASGOW,HURGHADA,160,0,160,0,0,0,0
25/03/2022 10:55,2021,30,NORTH AFRICA,EGYPT,2,MANCHESTER,HURGHADA,13376,13376,0,30003,28880,1123,-55.41779
25/03/2022 10:55,2021,30,NORTH AFRICA,EGYPT,2,MANCHESTER,MARSA ALAM,0,0,0,3498,3498,0,-100
25/03/2022 10:55,2021,30,NORTH AFRICA,EGYPT,2,MANCHESTER,SHARM EL SHEIKH (OPHIRA),12767,12767,0,4183,3980,203,205.21157
25/03/2022 10:55,2021,30,NORTH AFRICA,EGYPT,2,NEWCASTLE,HURGHADA,2794,2794,0,0,0,0,0
25/03/2022 10:55,2021,30,NORTH AFRICA,MOROCCO,1,GATWICK,AGADIR (AL MASSIRA),8991,8991,0,24308,24019,289,-63.01218
25/03/2022 10:55,2021,30,NORTH AFRICA,MOROCCO,1,GATWICK,CASABLANCA MOHAMED V,17236,17236,0,15167,15137,30,13.64146
25/03/2022 10:55,2021,30,NORTH AFRICA,MOROCCO,1,GATWICK,ERRACHIDIA,215,0,215,0,0,0,0
25/03/2022 10:55,2021,30,NORTH AFRICA,MOROCCO,1,GATWICK,FEZ,0,0,0,3205,3205,0,-100
25/03/2022 10:55,2021,30,NORTH AFRICA,MOROCCO,1,GATWICK,MARRAKESH,18234,18232,2,86681,86347,334,-78.96425
25/03/2022 10:55,2021,30,NORTH AFRICA,MOROCCO,1,GATWICK,OUARZAZATE,161,0,161,0,0,0,0
25/03/2022 10:55,2021,30,NORTH AFRICA,MOROCCO,1,GATWICK,TANGIERS (IBN BATUTA),9797,9797,0,13109,13109,0,-25.26509
25/03/2022 10:55,2021,30,NORTH AFRICA,MOROCCO,1,HEATHROW,CASABLANCA MOHAMED V,25890,25890,0,31695,31435,260,-18.31519
25/03/2022 10:55,2021,30,NORTH AFRICA,MOROCCO,1,HEATHROW,ERRACHIDIA,0,0,0,24,0,24,-100
25/03/2022 10:55,2021,30,NORTH AFRICA,MOROCCO,1,HEATHROW,FEZ,291,0,291,0,0,0,0
25/03/2022 10:55,2021,30,NORTH AFRICA,MOROCCO,1,HEATHROW,MARRAKESH,0,0,0,13113,11883,1230,-100
25/03/2022 10:55,2021,30,NORTH AFRICA,MOROCCO,1,HEATHROW,RABAT,3466,3466,0,2779,2779,0,24.72112
25/03/2022 10:55,2021,30,NORTH AFRICA,MOROCCO,1,LUTON,CASABLANCA MOHAMED V,0,0,0,254,0,254,-100
25/03/2022 10:55,2021,30,NORTH AFRICA,MOROCCO,1,LUTON,MARRAKESH,510,510,0,7290,7290,0,-93.00412
25/03/2022 10:55,2021,30,NORTH AFRICA,MOROCCO,1,SOUTHEND,CASABLANCA MOHAMED V,0,0,0,56,56,0,-100
25/03/2022 10:55,2021,30,NORTH AFRICA,MOROCCO,1,STANSTED,AGADIR (AL MASSIRA),8456,8456,0,7313,7096,217,15.6297
25/03/2022 10:55,2021,30,NORTH AFRICA,MOROCCO,1,STANSTED,CASABLANCA MOHAMED V,0,0,0,533,0,533,-100
25/03/2022 10:55,2021,30,NORTH AFRICA,MOROCCO,1,STANSTED,ERRACHIDIA,94,0,94,0,0,0,0
25/03/2022 10:55,2021,30,NORTH AFRICA,MOROCCO,1,STANSTED,ESSAOUIRA,0,0,0,7026,6975,51,-100
25/03/2022 10:55,2021,30,NORTH AFRICA,MOROCCO,1,STANSTED,FEZ,0,0,0,7651,7651,0,-100
25/03/2022 10:55,2021,30,NORTH AFRICA,MOROCCO,1,STANSTED,MARRAKESH,28875,28875,0,33439,32430,1009,-13.64873
25/03/2022 10:55,2021,30,NORTH AFRICA,MOROCCO,1,STANSTED,RABAT,14888,14888,0,11928,11928,0,24.81556
25/03/2022 10:55,2021,30,NORTH AFRICA,MOROCCO,2,BELFAST INTERNATIONAL,MARRAKESH,0,0,0,7012,7012,0,-100
25/03/2022 10:55,2021,30,NORTH AFRICA,MOROCCO,2,BIRMINGHAM,AGADIR (AL MASSIRA),0,0,0,2007,1818,189,-100
25/03/2022 10:55,2021,30,NORTH AFRICA,MOROCCO,2,BIRMINGHAM,MARRAKESH,314,314,0,374,185,189,-16.04278
25/03/2022 10:55,2021,30,NORTH AFRICA,MOROCCO,2,EAST MIDLANDS INTERNATIONAL,AGADIR (AL MASSIRA),0,0,0,187,187,0,-100
25/03/2022 10:55,2021,30,NORTH AFRICA,MOROCCO,2,LIVERPOOL (JOHN LENNON),MARRAKESH,0,0,0,7283,7283,0,-100
25/03/2022 10:55,2021,30,NORTH AFRICA,MOROCCO,2,MANCHESTER,AGADIR (AL MASSIRA),7383,7383,0,21046,21046,0,-64.9197
25/03/2022 10:55,2021,30,NORTH AFRICA,MOROCCO,2,MANCHESTER,CASABLANCA MOHAMED V,0,0,0,3878,3878,0,-100
25/03/2022 10:55,2021,30,NORTH AFRICA,MOROCCO,2,MANCHESTER,MARRAKESH,14759,14759,0,29870,28849,1021,-50.58922
25/03/2022 10:55,2021,30,NORTH AFRICA,MOROCCO,2,TEESSIDE INTERNATIONAL AIRPORT,AGADIR (AL MASSIRA),52,0,52,0,0,0,0
25/03/2022 10:55,2021,30,NORTH AFRICA,TUNISIA,1,GATWICK,ENFIDHA - HAMMAMET INTL,1254,0,1254,4060,0,4060,-69.1133
25/03/2022 10:55,2021,30,NORTH AFRICA,TUNISIA,1,GATWICK,TUNIS,3870,3870,0,9331,9071,260,-58.52535
25/03/2022 10:55,2021,30,NORTH AFRICA,TUNISIA,1,HEATHROW,TUNIS,5911,5911,0,12911,12840,71,-54.21733
25/03/2022 10:55,2021,30,NORTH AFRICA,TUNISIA,2,BIRMINGHAM,ENFIDHA - HAMMAMET INTL,619,0,619,186,0,186,232.7957
25/03/2022 10:55,2021,30,NORTH AFRICA,TUNISIA,2,MANCHESTER,ENFIDHA - HAMMAMET INTL,2174,0,2174,3792,0,3792,-42.66878
25/03/2022 10:55,2021,35,EAST AFRICA,ETHIOPIA,1,HEATHROW,ADDIS ABABA,97671,97671,0,125797,125739,58,-22.35824
25/03/2022 10:55,2021,35,EAST AFRICA,ETHIOPIA,2,MANCHESTER,ADDIS ABABA,13099,13099,0,18109,18109,0,-27.6658
25/03/2022 10:55,2021,35,EAST AFRICA,KENYA,1,HEATHROW,ELDORET INTERNATIONAL AIRPORT,39,0,39,0,0,0,0
25/03/2022 10:55,2021,35,EAST AFRICA,KENYA,1,HEATHROW,NAIROBI,71814,71813,1,100096,98794,1302,-28.25488
25/03/2022 10:55,2021,35,EAST AFRICA,KENYA,2,BIRMINGHAM,NAIROBI,775,0,775,0,0,0,0
25/03/2022 10:55,2021,35,EAST AFRICA,KENYA,2,EAST MIDLANDS INTERNATIONAL,NAIROBI,138,0,138,0,0,0,0
25/03/2022 10:55,2021,35,EAST AFRICA,RWANDA,1,GATWICK,KIGALI,0,0,0,6252,6252,0,-100
25/03/2022 10:55,2021,35,EAST AFRICA,RWANDA,1,HEATHROW,KIGALI,3289,3289,0,1406,1406,0,133.92603
25/03/2022 10:55,2021,35,EAST AFRICA,SUDAN,1,HEATHROW,KHARTOUM,0,0,0,259,0,259,-100
25/03/2022 10:55,2021,35,EAST AFRICA,TANZANIA,1,HEATHROW,DAR-ES-SALAAM,0,0,0,200,0,200,-100
25/03/2022 10:55,2021,35,EAST AFRICA,UGANDA,1,HEATHROW,ENTEBBE,0,0,0,273,0,273,-100
25/03/2022 10:55,2021,40,WEST AFRICA,BENIN,1,STANSTED,COTONOU,0,0,0,231,0,231,-100
25/03/2022 10:55,2021,40,WEST AFRICA,BURKINO FASO,1,HEATHROW,OUAGADOUGOU,0,0,0,36,0,36,-100
25/03/2022 10:55,2021,40,WEST AFRICA,CAMEROON,1,STANSTED,DOUALA,0,0,0,85,0,85,-100
25/03/2022 10:55,2021,40,WEST AFRICA,EQUATORIAL GUINEA,1,HEATHROW,MALABO,0,0,0,185,0,185,-100
25/03/2022 10:55,2021,40,WEST AFRICA,EQUATORIAL GUINEA,1,STANSTED,MALABO,0,0,0,61,0,61,-100
25/03/2022 10:55,2021,40,WEST AFRICA,GAMBIA,1,GATWICK,BANJUL,6751,0,6751,10119,169,9950,-33.28392
25/03/2022 10:55,2021,40,WEST AFRICA,GAMBIA,1,STANSTED,BANJUL,0,0,0,399,0,399,-100
25/03/2022 10:55,2021,40,WEST AFRICA,GAMBIA,2,BIRMINGHAM,BANJUL,0,0,0,3489,928,2561,-100
25/03/2022 10:55,2021,40,WEST AFRICA,GAMBIA,2,MANCHESTER,BANJUL,2913,0,2913,3976,2632,1344,-26.73541
25/03/2022 10:55,2021,40,WEST AFRICA,GHANA,1,GATWICK,ACCRA,48,0,48,0,0,0,0
25/03/2022 10:55,2021,40,WEST AFRICA,GHANA,1,HEATHROW,ACCRA,169966,169966,0,80899,80464,435,110.09654
25/03/2022 10:55,2021,40,WEST AFRICA,GHANA,1,STANSTED,ACCRA,0,0,0,1413,0,1413,-100
25/03/2022 10:55,2021,40,WEST AFRICA,IVORY COAST,2,ABERDEEN,ABIDJAN,38,0,38,0,0,0,0
25/03/2022 10:55,2021,40,WEST AFRICA,NIGERIA,1,GATWICK,ABUJA,0,0,0,1138,0,1138,-100
25/03/2022 10:55,2021,40,WEST AFRICA,NIGERIA,1,GATWICK,LAGOS,0,0,0,807,0,807,-100
25/03/2022 10:55,2021,40,WEST AFRICA,NIGERIA,1,HEATHROW,ABUJA,105799,105799,0,53517,52767,750,97.69232
25/03/2022 10:55,2021,40,WEST AFRICA,NIGERIA,1,HEATHROW,KANO,0,0,0,24,0,24,-100
25/03/2022 10:55,2021,40,WEST AFRICA,NIGERIA,1,HEATHROW,LAGOS,290593,290574,19,153154,149792,3362,89.73909
25/03/2022 10:55,2021,40,WEST AFRICA,NIGERIA,1,STANSTED,LAGOS,0,0,0,615,0,615,-100
25/03/2022 10:55,2021,40,WEST AFRICA,NIGERIA,2,ABERDEEN,LAGOS,0,0,0,18,0,18,-100
25/03/2022 10:55,2021,40,WEST AFRICA,SENEGAL,2,BIRMINGHAM,DAKAR (BLAISE DIAGNE),59,0,59,166,0,166,-64.45783
25/03/2022 10:55,2021,40,WEST AFRICA,SIERRA LEONE,1,GATWICK,FREETOWN,0,0,0,21,0,21,-100
25/03/2022 10:55,2021,45,CENTRAL AFRICA,ANGOLA,1,GATWICK,LUANDA,0,0,0,114,0,114,-100
25/03/2022 10:55,2021,45,CENTRAL AFRICA,ANGOLA,1,HEATHROW,LUANDA,0,0,0,234,0,234,-100
25/03/2022 10:55,2021,45,CENTRAL AFRICA,ANGOLA,1,STANSTED,LUANDA,0,0,0,25,0,25,-100
25/03/2022 10:55,2021,50,SOUTHERN AFRICA,NAMIBIA,1,HEATHROW,WINDHOEK,0,0,0,127,0,127,-100
25/03/2022 10:55,2021,50,SOUTHERN AFRICA,REPUBLIC OF SOUTH AFRICA,1,GATWICK,CAPE TOWN,0,0,0,22253,22151,102,-100
25/03/2022 10:55,2021,50,SOUTHERN AFRICA,REPUBLIC OF SOUTH AFRICA,1,HEATHROW,CAPE TOWN,18349,18349,0,122303,117985,4318,-84.9971
25/03/2022 10:55,2021,50,SOUTHERN AFRICA,REPUBLIC OF SOUTH AFRICA,1,HEATHROW,DURBAN,0,0,0,13323,13323,0,-100
25/03/2022 10:55,2021,50,SOUTHERN AFRICA,REPUBLIC OF SOUTH AFRICA,1,HEATHROW,JOHANNESBURG,59123,58905,218,240755,238248,2507,-75.44267
25/03/2022 10:55,2021,50,SOUTHERN AFRICA,REPUBLIC OF SOUTH AFRICA,2,EDINBURGH,JOHANNESBURG,80,0,80,0,0,0,0
25/03/2022 10:55,2021,50,SOUTHERN AFRICA,ZIMBABWE,1,GATWICK,HARARE,126,0,126,0,0,0,0
25/03/2022 10:55,2021,55,MIDDLE EAST,BAHRAIN,1,HEATHROW,BAHRAIN,176560,174752,1808,136131,134666,1465,29.6986
25/03/2022 10:55,2021,55,MIDDLE EAST,IRAN,1,HEATHROW,TEHRAN IMAM KHOMEINI,38313,38313,0,33992,33992,0,12.71181
25/03/2022 10:55,2021,55,MIDDLE EAST,IRAN,2,MANCHESTER,TEHRAN IMAM KHOMEINI,0,0,0,3189,3189,0,-100
25/03/2022 10:55,2021,55,MIDDLE EAST,IRAQ,1,GATWICK,BAGHDAD (GECA),1478,1478,0,0,0,0,0
25/03/2022 10:55,2021,55,MIDDLE EAST,IRAQ,1,GATWICK,ERBIL INTERNATIONAL,1,0,1,0,0,0,0
25/03/2022 10:55,2021,55,MIDDLE EAST,IRAQ,1,GATWICK,SULAYMANIYAH INT,1812,1812,0,0,0,0,0
25/03/2022 10:55,2021,55,MIDDLE EAST,IRAQ,1,STANSTED,ERBIL INTERNATIONAL,0,0,0,171,0,171,-100
25/03/2022 10:55,2021,55,MIDDLE EAST,KUWAIT,1,GATWICK,KUWAIT,256,0,256,12630,12338,292,-97.97308
25/03/2022 10:55,2021,55,MIDDLE EAST,KUWAIT,1,HEATHROW,KUWAIT,87834,87762,72,101686,98004,3682,-13.62233
25/03/2022 10:55,2021,55,MIDDLE EAST,KUWAIT,2,BIGGIN HILL,KUWAIT,11,0,11,0,0,0,0
25/03/2022 10:55,2021,55,MIDDLE EAST,KUWAIT,2,EDINBURGH,KUWAIT,174,0,174,0,0,0,0
25/03/2022 10:55,2021,55,MIDDLE EAST,KUWAIT,2,GLASGOW,KUWAIT,0,0,0,594,0,594,-100
25/03/2022 10:55,2021,55,MIDDLE EAST,KUWAIT,2,MANCHESTER,KUWAIT,0,0,0,2093,0,2093,-100
25/03/2022 10:55,2021,55,MIDDLE EAST,OMAN,1,HEATHROW,MUSCAT,25250,24633,617,98680,91391,7289,-74.41224
25/03/2022 10:55,2021,55,MIDDLE EAST,OMAN,2,EAST MIDLANDS INTERNATIONAL,MUSCAT,132,0,132,0,0,0,0
25/03/2022 10:55,2021,55,MIDDLE EAST,OMAN,2,MANCHESTER,MUSCAT,0,0,0,30239,30239,0,-100
25/03/2022 10:55,2021,55,MIDDLE EAST,QATAR,1,GATWICK,DOHA HAMAD,7352,7349,3,82923,82923,0,-91.13394
25/03/2022 10:55,2021,55,MIDDLE EAST,QATAR,1,HEATHROW,DOHA HAMAD,394835,394155,680,486850,480993,5857,-18.90007
25/03/2022 10:55,2021,55,MIDDLE EAST,QATAR,2,BELFAST INTERNATIONAL,DOHA INTERNATIONAL,915,0,915,742,0,742,23.31536
25/03/2022 10:55,2021,55,MIDDLE EAST,QATAR,2,BIRMINGHAM,DOHA HAMAD,0,0,0,30566,30566,0,-100
25/03/2022 10:55,2021,55,MIDDLE EAST,QATAR,2,CARDIFF WALES,DOHA HAMAD,0,0,0,21029,21029,0,-100
25/03/2022 10:55,2021,55,MIDDLE EAST,QATAR,2,EDINBURGH,DOHA HAMAD,26851,26851,0,40879,40879,0,-34.31591
25/03/2022 10:55,2021,55,MIDDLE EAST,QATAR,2,MANCHESTER,DOHA HAMAD,158099,158099,0,219381,218926,455,-27.93405
25/03/2022 10:55,2021,55,MIDDLE EAST,SAUDI ARABIA,1,HEATHROW,DAMMAM,0,0,0,6158,5625,533,-100
25/03/2022 10:55,2021,55,MIDDLE EAST,SAUDI ARABIA,1,HEATHROW,JEDDAH,63799,63074,725,70694,70648,46,-9.7533
25/03/2022 10:55,2021,55,MIDDLE EAST,SAUDI ARABIA,1,HEATHROW,RIYADH,121244,121156,88,85369,85369,0,42.02345
25/03/2022 10:55,2021,55,MIDDLE EAST,SAUDI ARABIA,1,HEATHROW,TABUK,0,0,0,126,126,0,-100
25/03/2022 10:55,2021,55,MIDDLE EAST,SAUDI ARABIA,1,STANSTED,JEDDAH,0,0,0,40,0,40,-100
25/03/2022 10:55,2021,55,MIDDLE EAST,SAUDI ARABIA,1,STANSTED,RIYADH,0,0,0,30,0,30,-100
25/03/2022 10:55,2021,55,MIDDLE EAST,SAUDI ARABIA,2,BIGGIN HILL,JEDDAH,0,0,0,3,0,3,-100
25/03/2022 10:55,2021,55,MIDDLE EAST,SAUDI ARABIA,2,BIGGIN HILL,RIYADH,0,0,0,11,0,11,-100
25/03/2022 10:55,2021,55,MIDDLE EAST,SAUDI ARABIA,2,EDINBURGH,RIYADH,186,0,186,0,0,0,0
25/03/2022 10:55,2021,55,MIDDLE EAST,SAUDI ARABIA,2,GLASGOW,RIYADH,168,168,0,0,0,0,0
25/03/2022 10:55,2021,55,MIDDLE EAST,SAUDI ARABIA,2,MANCHESTER,JEDDAH,2409,2409,0,23213,23213,0,-89.62219
25/03/2022 10:55,2021,55,MIDDLE EAST,SAUDI ARABIA,2,MANCHESTER,RIYADH,0,0,0,531,531,0,-100
25/03/2022 10:55,2021,55,MIDDLE EAST,UNITED ARAB EMIRATES,1,GATWICK,DUBAI,15090,15090,0,207005,207005,0,-92.71032
25/03/2022 10:55,2021,55,MIDDLE EAST,UNITED ARAB EMIRATES,1,GATWICK,DUBAI (WORLD CENTRAL),8,0,8,0,0,0,0
25/03/2022 10:55,2021,55,MIDDLE EAST,UNITED ARAB EMIRATES,1,HEATHROW,ABU DHABI INTERNATIONAL,175874,175761,113,289310,289105,205,-39.20915
25/03/2022 10:55,2021,55,MIDDLE EAST,UNITED ARAB EMIRATES,1,HEATHROW,DUBAI,808620,808620,0,863667,863667,0,-6.37364
25/03/2022 10:55,2021,55,MIDDLE EAST,UNITED ARAB EMIRATES,1,HEATHROW,DUBAI (WORLD CENTRAL),3589,0,3589,0,0,0,0
25/03/2022 10:55,2021,55,MIDDLE EAST,UNITED ARAB EMIRATES,1,STANSTED,DUBAI,0,0,0,97289,97289,0,-100
25/03/2022 10:55,2021,55,MIDDLE EAST,UNITED ARAB EMIRATES,2,BIGGIN HILL,DUBAI (WORLD CENTRAL),11,0,11,11,0,11,0
25/03/2022 10:55,2021,55,MIDDLE EAST,UNITED ARAB EMIRATES,2,BIRMINGHAM,DUBAI,108611,107459,1152,195078,195078,0,-44.32432
25/03/2022 10:55,2021,55,MIDDLE EAST,UNITED ARAB EMIRATES,2,BIRMINGHAM,DUBAI (WORLD CENTRAL),6568,0,6568,0,0,0,0
25/03/2022 10:55,2021,55,MIDDLE EAST,UNITED ARAB EMIRATES,2,EAST MIDLANDS INTERNATIONAL,DUBAI,0,0,0,20,0,20,-100
25/03/2022 10:55,2021,55,MIDDLE EAST,UNITED ARAB EMIRATES,2,EDINBURGH,DUBAI,0,0,0,41806,41806,0,-100
25/03/2022 10:55,2021,55,MIDDLE EAST,UNITED ARAB EMIRATES,2,GLASGOW,DUBAI,67469,67415,54,121022,121022,0,-44.25063
25/03/2022 10:55,2021,55,MIDDLE EAST,UNITED ARAB EMIRATES,2,GLASGOW,DUBAI (WORLD CENTRAL),53,0,53,0,0,0,0
25/03/2022 10:55,2021,55,MIDDLE EAST,UNITED ARAB EMIRATES,2,MANCHESTER,ABU DHABI INTERNATIONAL,60248,60248,0,119745,119745,0,-49.68642
25/03/2022 10:55,2021,55,MIDDLE EAST,UNITED ARAB EMIRATES,2,MANCHESTER,DUBAI,207497,207497,0,319831,319831,0,-35.12292
25/03/2022 10:55,2021,55,MIDDLE EAST,UNITED ARAB EMIRATES,2,MANCHESTER,DUBAI (WORLD CENTRAL),903,113,790,3,0,3,30000
25/03/2022 10:55,2021,55,MIDDLE EAST,UNITED ARAB EMIRATES,2,NEWCASTLE,DUBAI,17657,17657,0,53863,53863,0,-67.21868
25/03/2022 10:55,2021,60,INDIAN SUB-CONTINENT,AFGHANISTAN,1,HEATHROW,BAGRAM,0,0,0,266,0,266,-100
25/03/2022 10:55,2021,60,INDIAN SUB-CONTINENT,AFGHANISTAN,1,STANSTED,KABUL,74,0,74,0,0,0,0
25/03/2022 10:55,2021,60,INDIAN SUB-CONTINENT,AFGHANISTAN,2,BIRMINGHAM,KABUL,545,0,545,0,0,0,0
25/03/2022 10:55,2021,60,INDIAN SUB-CONTINENT,BANGLADESH,1,HEATHROW,DHAKHA,17897,17897,0,30715,27516,3199,-41.73205
25/03/2022 10:55,2021,60,INDIAN SUB-CONTINENT,BANGLADESH,1,HEATHROW,SYLHET,25200,25200,0,18325,18325,0,37.51705
25/03/2022 10:55,2021,60,INDIAN SUB-CONTINENT,BANGLADESH,2,MANCHESTER,DHAKHA,773,773,0,14234,14234,0,-94.56934
25/03/2022 10:55,2021,60,INDIAN SUB-CONTINENT,INDIA,1,GATWICK,GOA,0,0,0,13223,0,13223,-100
25/03/2022 10:55,2021,60,INDIAN SUB-CONTINENT,INDIA,1,GATWICK,MUMBAI,0,0,0,297,0,297,-100
25/03/2022 10:55,2021,60,INDIAN SUB-CONTINENT,INDIA,1,HEATHROW,AHMEDABAD,17129,17084,45,36510,21462,15048,-53.08409
25/03/2022 10:55,2021,60,INDIAN SUB-CONTINENT,INDIA,1,HEATHROW,AMRITSAR,8674,8674,0,13507,0,13507,-35.78145
25/03/2022 10:55,2021,60,INDIAN SUB-CONTINENT,INDIA,1,HEATHROW,BANGALORE (BENGALURU),98558,89229,9329,81017,69675,11342,21.65101
25/03/2022 10:55,2021,60,INDIAN SUB-CONTINENT,INDIA,1,HEATHROW,BIJU PATNAIK INTERNATIONAL,0,0,0,67,0,67,-100
25/03/2022 10:55,2021,60,INDIAN SUB-CONTINENT,INDIA,1,HEATHROW,CHENNAI,25457,25457,0,43020,40334,2686,-40.8252
25/03/2022 10:55,2021,60,INDIAN SUB-CONTINENT,INDIA,1,HEATHROW,COCHIN,24378,24378,0,15770,0,15770,54.58465
25/03/2022 10:55,2021,60,INDIAN SUB-CONTINENT,INDIA,1,HEATHROW,DELHI,323844,305887,17957,293018,234380,58638,10.52017
25/03/2022 10:55,2021,60,INDIAN SUB-CONTINENT,INDIA,1,HEATHROW,GOA,16350,16123,227,11010,0,11010,48.50136
25/03/2022 10:55,2021,60,INDIAN SUB-CONTINENT,INDIA,1,HEATHROW,HYDERABAD ( RAJIV GHANDI ),61728,61728,0,47356,45527,1829,30.34885
25/03/2022 10:55,2021,60,INDIAN SUB-CONTINENT,INDIA,1,HEATHROW,KOLKATA,7499,7499,0,3675,0,3675,104.05442
25/03/2022 10:55,2021,60,INDIAN SUB-CONTINENT,INDIA,1,HEATHROW,MUMBAI,226928,209708,17220,226350,188311,38039,0.25536
25/03/2022 10:55,2021,60,INDIAN SUB-CONTINENT,INDIA,1,HEATHROW,VIJAYAWADA,0,0,0,136,0,136,-100
25/03/2022 10:55,2021,60,INDIAN SUB-CONTINENT,INDIA,1,HEATHROW,VISHAKHPATNAM,0,0,0,287,0,287,-100
25/03/2022 10:55,2021,60,INDIAN SUB-CONTINENT,INDIA,1,STANSTED,AMRITSAR,0,0,0,13513,13513,0,-100
25/03/2022 10:55,2021,60,INDIAN SUB-CONTINENT,INDIA,1,STANSTED,GOA,0,0,0,932,0,932,-100
25/03/2022 10:55,2021,60,INDIAN SUB-CONTINENT,INDIA,1,STANSTED,MUMBAI,0,0,0,4553,4553,0,-100
25/03/2022 10:55,2021,60,INDIAN SUB-CONTINENT,INDIA,2,BIRMINGHAM,AMRITSAR,8146,7953,193,18634,16057,2577,-56.28421
25/03/2022 10:55,2021,60,INDIAN SUB-CONTINENT,INDIA,2,BIRMINGHAM,DELHI,117,0,117,18392,15272,3120,-99.36385
25/03/2022 10:55,2021,60,INDIAN SUB-CONTINENT,INDIA,2,GLASGOW,MUMBAI,119,0,119,0,0,0,0
25/03/2022 10:55,2021,60,INDIAN SUB-CONTINENT,INDIA,2,MANCHESTER,GOA,0,0,0,13091,0,13091,-100
25/03/2022 10:55,2021,60,INDIAN SUB-CONTINENT,NEPAL,1,STANSTED,KATHMANDU,0,0,0,754,0,754,-100
25/03/2022 10:55,2021,60,INDIAN SUB-CONTINENT,PAKISTAN,1,GATWICK,BENAZIR BHUTTO INTERNATIONAL AIRPORT,195,0,195,100,0,100,95
25/03/2022 10:55,2021,60,INDIAN SUB-CONTINENT,PAKISTAN,1,HEATHROW,ISLAMABAD INTERNATIONAL AIRPORT,159665,142602,17063,107872,107057,815,48.01339
25/03/2022 10:55,2021,60,INDIAN SUB-CONTINENT,PAKISTAN,1,HEATHROW,KARACHI,0,0,0,7680,7334,346,-100
25/03/2022 10:55,2021,60,INDIAN SUB-CONTINENT,PAKISTAN,1,HEATHROW,LAHORE,90105,89888,217,44248,43822,426,103.63632
25/03/2022 10:55,2021,60,INDIAN SUB-CONTINENT,PAKISTAN,1,HEATHROW,SIALKOT,0,0,0,4545,4545,0,-100
25/03/2022 10:55,2021,60,INDIAN SUB-CONTINENT,PAKISTAN,1,STANSTED,ISLAMABAD INTERNATIONAL AIRPORT,479,0,479,0,0,0,0
25/03/2022 10:55,2021,60,INDIAN SUB-CONTINENT,PAKISTAN,2,BIRMINGHAM,ISLAMABAD INTERNATIONAL AIRPORT,8624,0,8624,32508,32508,0,-73.47115
25/03/2022 10:55,2021,60,INDIAN SUB-CONTINENT,PAKISTAN,2,BIRMINGHAM,LAHORE,37,0,37,0,0,0,0
25/03/2022 10:55,2021,60,INDIAN SUB-CONTINENT,PAKISTAN,2,MANCHESTER,ISLAMABAD INTERNATIONAL AIRPORT,65515,39194,26321,80858,69530,11328,-18.97524
25/03/2022 10:55,2021,60,INDIAN SUB-CONTINENT,PAKISTAN,2,MANCHESTER,LAHORE,1530,251,1279,17310,16567,743,-91.16118
25/03/2022 10:55,2021,60,INDIAN SUB-CONTINENT,SRI LANKA,1,GATWICK,COLOMBO,0,0,0,248,0,248,-100
25/03/2022 10:55,2021,60,INDIAN SUB-CONTINENT,SRI LANKA,1,HEATHROW,COLOMBO,36789,36789,0,70392,70392,0,-47.73696
25/03/2022 10:55,2021,60,INDIAN SUB-CONTINENT,SRI LANKA,1,HEATHROW,MATTALA RAJAPAKSA,40,0,40,57,0,57,-29.82456
25/03/2022 10:55,2021,60,INDIAN SUB-CONTINENT,SRI LANKA,1,STANSTED,COLOMBO,0,0,0,585,0,585,-100
25/03/2022 10:55,2021,60,INDIAN SUB-CONTINENT,SRI LANKA,2,BIRMINGHAM,COLOMBO,36,0,36,0,0,0,0
25/03/2022 10:55,2021,65,FAR EAST,BRUNEI,1,HEATHROW,BANDAR SERI BEGAWAN,3418,3418,0,28616,28616,0,-88.05563
25/03/2022 10:55,2021,65,FAR EAST,CHINA,1,GATWICK,CHENGDU,0,0,0,85,0,85,-100
25/03/2022 10:55,2021,65,FAR EAST,CHINA,1,GATWICK,NANJING LUKOU INTERNATIONAL,0,0,0,119,0,119,-100
25/03/2022 10:55,2021,65,FAR EAST,CHINA,1,GATWICK,SHANGHAI (PU DONG),0,0,0,24173,24173,0,-100
25/03/2022 10:55,2021,65,FAR EAST,CHINA,1,HEATHROW,BEIJING,171,0,171,53437,53437,0,-99.68
25/03/2022 10:55,2021,65,FAR EAST,CHINA,1,HEATHROW,BEIJING DAXING INTERNATIONAL AIRPORT,0,0,0,9564,9564,0,-100
25/03/2022 10:55,2021,65,FAR EAST,CHINA,1,HEATHROW,CHANGSHA HUANGHUA INTERNATIONAL AIRPORT,0,0,0,4294,3768,526,-100
25/03/2022 10:55,2021,65,FAR EAST,CHINA,1,HEATHROW,CHENGDU,0,0,0,6158,5667,491,-100
25/03/2022 10:55,2021,65,FAR EAST,CHINA,1,HEATHROW,CHONGQING JIANGBEI INTERNATIONAL,0,0,0,2569,2057,512,-100
25/03/2022 10:55,2021,65,FAR EAST,CHINA,1,HEATHROW,GUANGZHOU BAIYUN INTERNATIONAL,0,0,0,40220,40216,4,-100
25/03/2022 10:55,2021,65,FAR EAST,CHINA,1,HEATHROW,HAIKOU,0,0,0,271,0,271,-100
25/03/2022 10:55,2021,65,FAR EAST,CHINA,1,HEATHROW,HANGZHOU,0,0,0,140,0,140,-100
25/03/2022 10:55,2021,65,FAR EAST,CHINA,1,HEATHROW,HEFEI,0,0,0,253,0,253,-100
25/03/2022 10:55,2021,65,FAR EAST,CHINA,1,HEATHROW,JINAN YAOQIANG INTERNATIONAL,0,0,0,385,181,204,-100
25/03/2022 10:55,2021,65,FAR EAST,CHINA,1,HEATHROW,NANJING LUKOU INTERNATIONAL,0,0,0,369,0,369,-100
25/03/2022 10:55,2021,65,FAR EAST,CHINA,1,HEATHROW,QINGDAO,0,0,0,13718,13222,496,-100
25/03/2022 10:55,2021,65,FAR EAST,CHINA,1,HEATHROW,SANYA PHOENIX INTERNATIONAL,0,0,0,2254,2254,0,-100
25/03/2022 10:55,2021,65,FAR EAST,CHINA,1,HEATHROW,SHANGHAI (PU DONG),456,251,205,104273,104213,60,-99.56269
25/03/2022 10:55,2021,65,FAR EAST,CHINA,1,HEATHROW,SHENZHEN (HUANGTIAN),0,0,0,7249,6465,784,-100
25/03/2022 10:55,2021,65,FAR EAST,CHINA,1,HEATHROW,TIANJIN,0,0,0,1404,1171,233,-100
25/03/2022 10:55,2021,65,FAR EAST,CHINA,1,HEATHROW,WUHAN TIANHE INTERNATIONAL,0,0,0,4252,3999,253,-100
25/03/2022 10:55,2021,65,FAR EAST,CHINA,1,HEATHROW,XIAN XIANYANG,0,0,0,5907,5418,489,-100
25/03/2022 10:55,2021,65,FAR EAST,CHINA,1,HEATHROW,ZHENGZHOU XINZHENG,0,0,0,4060,3275,785,-100
25/03/2022 10:55,2021,65,FAR EAST,CHINA,2,EDINBURGH,BEIJING,0,0,0,745,0,745,-100
25/03/2022 10:55,2021,65,FAR EAST,CHINA,2,MANCHESTER,BEIJING,0,0,0,6072,6072,0,-100
25/03/2022 10:55,2021,65,FAR EAST,CHINA,2,MANCHESTER,CHONGQING JIANGBEI INTERNATIONAL,2827,0,2827,6979,215,6764,-59.49276
25/03/2022 10:55,2021,65,FAR EAST,CHINA,2,MANCHESTER,GUANGZHOU BAIYUN INTERNATIONAL,0,0,0,501,0,501,-100
25/03/2022 10:55,2021,65,FAR EAST,CHINA,2,MANCHESTER,HANGZHOU,0,0,0,164,164,0,-100
25/03/2022 10:55,2021,65,FAR EAST,CHINA,2,MANCHESTER,JINAN YAOQIANG INTERNATIONAL,0,0,0,735,0,735,-100
25/03/2022 10:55,2021,65,FAR EAST,CHINA,2,MANCHESTER,TIANJIN,0,0,0,240,0,240,-100
25/03/2022 10:55,2021,65,FAR EAST,HONG KONG,1,GATWICK,HONG KONG (CHEK LAP KOK),0,0,0,17259,17259,0,-100
25/03/2022 10:55,2021,65,FAR EAST,HONG KONG,1,HEATHROW,HONG KONG (CHEK LAP KOK),191096,191096,0,352214,351490,724,-45.74435
25/03/2022 10:55,2021,65,FAR EAST,HONG KONG,2,ABERDEEN,HONG KONG (CHEK LAP KOK),0,0,0,50,0,50,-100
25/03/2022 10:55,2021,65,FAR EAST,HONG KONG,2,MANCHESTER,HONG KONG (CHEK LAP KOK),17498,17498,0,33920,33920,0,-48.41392
25/03/2022 10:55,2021,65,FAR EAST,INDONESIA,1,HEATHROW,BALI INTERNATIONAL,0,0,0,1383,957,426,-100
25/03/2022 10:55,2021,65,FAR EAST,INDONESIA,1,HEATHROW,KUALANAMU INTERNATIONAL AIRPORT,0,0,0,3201,3201,0,-100
25/03/2022 10:55,2021,65,FAR EAST,JAPAN,1,HEATHROW,NAGOYA,114,114,0,0,0,0,0
25/03/2022 10:55,2021,65,FAR EAST,JAPAN,1,HEATHROW,OSAKA (KANSAI),1161,1161,0,11133,11133,0,-89.57154
25/03/2022 10:55,2021,65,FAR EAST,JAPAN,1,HEATHROW,TOKYO (HANEDA),63795,63795,0,142681,142681,0,-55.28837
25/03/2022 10:55,2021,65,FAR EAST,JAPAN,1,HEATHROW,TOKYO (NARITA),0,0,0,26369,26369,0,-100
25/03/2022 10:55,2021,65,FAR EAST,MALAYSIA,1,GATWICK,LANGKAWI,0,0,0,2598,0,2598,-100
25/03/2022 10:55,2021,65,FAR EAST,MALAYSIA,1,HEATHROW,KUALA LUMPUR (SEPANG),14914,14849,65,114054,114054,0,-86.92374
25/03/2022 10:55,2021,65,FAR EAST,MALAYSIA,2,BIRMINGHAM,LANGKAWI,0,0,0,2646,0,2646,-100
25/03/2022 10:55,2021,65,FAR EAST,MALAYSIA,2,MANCHESTER,LANGKAWI,0,0,0,2812,0,2812,-100
25/03/2022 10:55,2021,65,FAR EAST,PHILIPPINES,1,GATWICK,CLARK INTERNATIONAL,0,0,0,426,0,426,-100
25/03/2022 10:55,2021,65,FAR EAST,PHILIPPINES,1,GATWICK,MANILA,0,0,0,1114,0,1114,-100
25/03/2022 10:55,2021,65,FAR EAST,PHILIPPINES,1,HEATHROW,CEBU,0,0,0,447,447,0,-100
25/03/2022 10:55,2021,65,FAR EAST,PHILIPPINES,1,HEATHROW,CLARK INTERNATIONAL,0,0,0,671,671,0,-100
25/03/2022 10:55,2021,65,FAR EAST,PHILIPPINES,1,HEATHROW,MANILA,2549,2549,0,34431,31883,2548,-92.59679
25/03/2022 10:55,2021,65,FAR EAST,REPUBLIC OF KOREA,1,HEATHROW,SEOUL (INCHEON),21290,21290,0,106712,106712,0,-80.0491
25/03/2022 10:55,2021,65,FAR EAST,SINGAPORE,1,HEATHROW,SINGAPORE,187739,187674,65,349219,349147,72,-46.24032
25/03/2022 10:55,2021,65,FAR EAST,SINGAPORE,2,MANCHESTER,SINGAPORE,10372,10372,0,21730,21730,0,-52.26875
25/03/2022 10:55,2021,65,FAR EAST,TAIWAN,1,GATWICK,TAIPEI,0,0,0,21951,21951,0,-100
25/03/2022 10:55,2021,65,FAR EAST,TAIWAN,1,HEATHROW,TAIPEI,1617,1617,0,13590,13590,0,-88.10155
25/03/2022 10:55,2021,65,FAR EAST,THAILAND,1,GATWICK,PHUKET,468,0,468,6911,0,6911,-93.22819
25/03/2022 10:55,2021,65,FAR EAST,THAILAND,1,GATWICK,U-TAPAO,0,0,0,2695,0,2695,-100
25/03/2022 10:55,2021,65,FAR EAST,THAILAND,1,HEATHROW,BANGKOK SUVARNABHUMI ,32631,18532,14099,216277,209288,6989,-84.9124
25/03/2022 10:55,2021,65,FAR EAST,THAILAND,1,HEATHROW,PHUKET,1417,37,1380,0,0,0,0
25/03/2022 10:55,2021,65,FAR EAST,THAILAND,2,BIRMINGHAM,U-TAPAO,0,0,0,3542,263,3279,-100
25/03/2022 10:55,2021,65,FAR EAST,THAILAND,2,MANCHESTER,PHUKET,0,0,0,6614,0,6614,-100
25/03/2022 10:55,2021,65,FAR EAST,THAILAND,2,MANCHESTER,U-TAPAO,0,0,0,3158,0,3158,-100
25/03/2022 10:55,2021,65,FAR EAST,VIETNAM,1,GATWICK,PHU QUOC INTERNATIONAL,0,0,0,5413,0,5413,-100
25/03/2022 10:55,2021,65,FAR EAST,VIETNAM,1,HEATHROW,HANOI,825,654,171,23047,22870,177,-96.42036
25/03/2022 10:55,2021,65,FAR EAST,VIETNAM,1,HEATHROW,HO CHI MINH CITY,346,346,0,16232,16209,23,-97.86841
25/03/2022 10:55,2021,65,FAR EAST,VIETNAM,1,STANSTED,HO CHI MINH CITY,0,0,0,63,0,63,-100
25/03/2022 10:55,2021,65,FAR EAST,VIETNAM,2,BIRMINGHAM,VAN DON INTERNATIONAL,299,0,299,0,0,0,0
25/03/2022 10:55,2021,70,AUSTRALASIA,AUSTRALIA,1,HEATHROW,DARWIN,10580,10580,0,2470,2470,0,328.34008
25/03/2022 10:55,2021,70,AUSTRALASIA,AUSTRALIA,1,HEATHROW,MELBOURNE,3971,3971,0,4635,4635,0,-14.32578
25/03/2022 10:55,2021,70,AUSTRALASIA,AUSTRALIA,1,HEATHROW,PERTH (AUSTRALIA),179,179,0,32130,32130,0,-99.44289
25/03/2022 10:55,2021,70,AUSTRALASIA,AUSTRALIA,1,HEATHROW,SYDNEY,13557,13557,0,44854,44854,0,-69.77527
25/03/2022 10:55,2021,70,AUSTRALASIA,NEW ZEALAND,1,HEATHROW,AUCKLAND INTERNATIONAL,0,0,0,4995,4995,0,-100
25/03/2022 10:55,2021,75,CANADA,CANADA,1,GATWICK,CALGARY,27739,27739,0,30345,30345,0,-8.58791
25/03/2022 10:55,2021,75,CANADA,CANADA,1,GATWICK,TORONTO,47963,47963,0,85434,85434,0,-43.85959
25/03/2022 10:55,2021,75,CANADA,CANADA,1,HEATHROW,CALGARY,15127,15127,0,36986,36986,0,-59.10074
25/03/2022 10:55,2021,75,CANADA,CANADA,1,HEATHROW,MONTREAL (DORVAL),55477,55477,0,73749,73749,0,-24.77593
25/03/2022 10:55,2021,75,CANADA,CANADA,1,HEATHROW,OTTAWA INTERNATIONAL,0,0,0,18601,18601,0,-100
25/03/2022 10:55,2021,75,CANADA,CANADA,1,HEATHROW,TORONTO,297113,297113,0,292973,292973,0,1.4131
25/03/2022 10:55,2021,75,CANADA,CANADA,1,HEATHROW,VANCOUVER,114306,114306,0,127505,127505,0,-10.35175
25/03/2022 10:55,2021,75,CANADA,CANADA,1,HEATHROW,WINNIPEG,218,0,218,0,0,0,0
25/03/2022 10:55,2021,75,CANADA,CANADA,2,EAST MIDLANDS INTERNATIONAL,CALGARY,0,0,0,203,0,203,-100
25/03/2022 10:55,2021,75,CANADA,CANADA,2,GLASGOW,TORONTO,998,998,0,9020,9020,0,-88.9357
25/03/2022 10:55,2021,75,CANADA,CANADA,2,MANCHESTER,TORONTO,3609,3609,0,13251,13251,0,-72.76432
25/03/2022 10:55,2021,80,UNITED STATES OF AMERICA,USA,1,GATWICK,AUSTIN (BERGSTROM),72,0,72,3494,3494,0,-97.93932
25/03/2022 10:55,2021,80,UNITED STATES OF AMERICA,USA,1,GATWICK,BOSTON,0,0,0,32945,32945,0,-100
25/03/2022 10:55,2021,80,UNITED STATES OF AMERICA,USA,1,GATWICK,HONOLULU,0,0,0,237,0,237,-100
25/03/2022 10:55,2021,80,UNITED STATES OF AMERICA,USA,1,GATWICK,LAS VEGAS,0,0,0,16725,16725,0,-100
25/03/2022 10:55,2021,80,UNITED STATES OF AMERICA,USA,1,GATWICK,LOS ANGELES INTERNATIONAL,0,0,0,39200,39200,0,-100
25/03/2022 10:55,2021,80,UNITED STATES OF AMERICA,USA,1,GATWICK,MIAMI INTERNATIONAL,0,0,0,35934,35934,0,-100
25/03/2022 10:55,2021,80,UNITED STATES OF AMERICA,USA,1,GATWICK,NEW YORK (JF KENNEDY),12649,12649,0,114745,114745,0,-88.97643
25/03/2022 10:55,2021,80,UNITED STATES OF AMERICA,USA,1,GATWICK,ORLANDO,8118,8118,0,133715,133715,0,-93.92888
25/03/2022 10:55,2021,80,UNITED STATES OF AMERICA,USA,1,GATWICK,SAN FRANCISCO,0,0,0,22230,22230,0,-100
25/03/2022 10:55,2021,80,UNITED STATES OF AMERICA,USA,1,GATWICK,TAMPA,16381,16381,0,41457,41457,0,-60.48677
25/03/2022 10:55,2021,80,UNITED STATES OF AMERICA,USA,1,GATWICK,WILLIAM P HOBBY AIRPORT,449,0,449,0,0,0,0
25/03/2022 10:55,2021,80,UNITED STATES OF AMERICA,USA,1,HEATHROW,ATLANTA,164335,164179,156,140492,140492,0,16.97107
25/03/2022 10:55,2021,80,UNITED STATES OF AMERICA,USA,1,HEATHROW,AUSTIN (BERGSTROM),14209,13035,1174,29216,29216,0,-51.36569
25/03/2022 10:55,2021,80,UNITED STATES OF AMERICA,USA,1,HEATHROW,BALTIMORE,5864,5864,0,22377,22377,0,-73.79452
25/03/2022 10:55,2021,80,UNITED STATES OF AMERICA,USA,1,HEATHROW,BOSTON,172975,172975,0,181294,181294,0,-4.58868
25/03/2022 10:55,2021,80,UNITED STATES OF AMERICA,USA,1,HEATHROW,CHARLOTTE,78121,78121,0,56536,56536,0,38.17921
25/03/2022 10:55,2021,80,UNITED STATES OF AMERICA,USA,1,HEATHROW,CHICAGO (O'HARE),236746,236746,0,238020,238020,0,-0.53525
25/03/2022 10:55,2021,80,UNITED STATES OF AMERICA,USA,1,HEATHROW,DALLAS/FORT WORTH,198773,198773,0,210470,210470,0,-5.55756
25/03/2022 10:55,2021,80,UNITED STATES OF AMERICA,USA,1,HEATHROW,DENVER INTERNATIONAL,22158,22158,0,52596,52596,0,-57.87132
25/03/2022 10:55,2021,80,UNITED STATES OF AMERICA,USA,1,HEATHROW,DETROIT,13011,13011,0,23602,23602,0,-44.87332
25/03/2022 10:55,2021,80,UNITED STATES OF AMERICA,USA,1,HEATHROW,FORT LAUDERDALE,0,0,0,225,0,225,-100
25/03/2022 10:55,2021,80,UNITED STATES OF AMERICA,USA,1,HEATHROW,HOUSTON,78022,78022,0,83269,83151,118,-6.30126
25/03/2022 10:55,2021,80,UNITED STATES OF AMERICA,USA,1,HEATHROW,JACKSONVILLE,140,0,140,0,0,0,0
25/03/2022 10:55,2021,80,UNITED STATES OF AMERICA,USA,1,HEATHROW,LAS VEGAS,26767,26767,0,77426,77426,0,-65.42893
25/03/2022 10:55,2021,80,UNITED STATES OF AMERICA,USA,1,HEATHROW,LOS ANGELES INTERNATIONAL,287992,287992,0,370164,369620,544,-22.19881
25/03/2022 10:55,2021,80,UNITED STATES OF AMERICA,USA,1,HEATHROW,MIAMI INTERNATIONAL,201288,201288,0,288335,287287,1048,-30.18954
25/03/2022 10:55,2021,80,UNITED STATES OF AMERICA,USA,1,HEATHROW,MILWAUKEE,297,0,297,0,0,0,0
25/03/2022 10:55,2021,80,UNITED STATES OF AMERICA,USA,1,HEATHROW,MINNEAPOLIS-ST PAUL,0,0,0,20384,20384,0,-100
25/03/2022 10:55,2021,80,UNITED STATES OF AMERICA,USA,1,HEATHROW,NASHVILLE METROPOLITAN,2740,2740,0,15100,15100,0,-81.8543
25/03/2022 10:55,2021,80,UNITED STATES OF AMERICA,USA,1,HEATHROW,NEW ORLEANS,2206,2206,0,17586,17586,0,-87.45593
25/03/2022 10:55,2021,80,UNITED STATES OF AMERICA,USA,1,HEATHROW,NEW YORK (JF KENNEDY),615543,615278,265,659182,659182,0,-6.62017
25/03/2022 10:55,2021,80,UNITED STATES OF AMERICA,USA,1,HEATHROW,NEW YORK (NEWARK),140398,140398,0,196464,196464,0,-28.53754
25/03/2022 10:55,2021,80,UNITED STATES OF AMERICA,USA,1,HEATHROW,ORLANDO,44763,44763,0,0,0,0,0
25/03/2022 10:55,2021,80,UNITED STATES OF AMERICA,USA,1,HEATHROW,PHILADELPHIA INTERNATIONAL,79874,79874,0,69052,69052,0,15.67225
25/03/2022 10:55,2021,80,UNITED STATES OF AMERICA,USA,1,HEATHROW,PHOENIX,31326,31326,0,52122,52122,0,-39.8987
25/03/2022 10:55,2021,80,UNITED STATES OF AMERICA,USA,1,HEATHROW,PITTSBURGH,0,0,0,9923,9923,0,-100
25/03/2022 10:55,2021,80,UNITED STATES OF AMERICA,USA,1,HEATHROW,RALEIGH,0,0,0,21239,21239,0,-100
25/03/2022 10:55,2021,80,UNITED STATES OF AMERICA,USA,1,HEATHROW,SALT LAKE CITY,0,0,0,18478,18478,0,-100
25/03/2022 10:55,2021,80,UNITED STATES OF AMERICA,USA,1,HEATHROW,SAN DIEGO,14374,14374,0,34195,34195,0,-57.96461
25/03/2022 10:55,2021,80,UNITED STATES OF AMERICA,USA,1,HEATHROW,SAN FRANCISCO,157290,157203,87,194126,194126,0,-18.9753
25/03/2022 10:55,2021,80,UNITED STATES OF AMERICA,USA,1,HEATHROW,SAN JOSE,0,0,0,17675,17675,0,-100
25/03/2022 10:55,2021,80,UNITED STATES OF AMERICA,USA,1,HEATHROW,SEATTLE (TACOMA),77833,77833,0,75783,75783,0,2.70509
25/03/2022 10:55,2021,80,UNITED STATES OF AMERICA,USA,1,HEATHROW,WASHINGTON (DULLES),188355,188355,0,177565,177299,266,6.07665
25/03/2022 10:55,2021,80,UNITED STATES OF AMERICA,USA,1,LONDON CITY,NEW YORK (JF KENNEDY),0,0,0,2040,2040,0,-100
25/03/2022 10:55,2021,80,UNITED STATES OF AMERICA,USA,1,STANSTED,ATLANTA,139,0,139,0,0,0,0
25/03/2022 10:55,2021,80,UNITED STATES OF AMERICA,USA,1,STANSTED,MIAMI INTERNATIONAL,160,0,160,0,0,0,0
25/03/2022 10:55,2021,80,UNITED STATES OF AMERICA,USA,1,STANSTED,NEW YORK (NEWARK),294,0,294,0,0,0,0
25/03/2022 10:55,2021,80,UNITED STATES OF AMERICA,USA,2,BIGGIN HILL,WASHINGTON (DULLES),0,0,0,4,0,4,-100
25/03/2022 10:55,2021,80,UNITED STATES OF AMERICA,USA,2,EAST MIDLANDS INTERNATIONAL,BANGOR,0,0,0,8,0,8,-100
25/03/2022 10:55,2021,80,UNITED STATES OF AMERICA,USA,2,EDINBURGH,DETROIT,24,0,24,114,0,114,-78.94737
25/03/2022 10:55,2021,80,UNITED STATES OF AMERICA,USA,2,EDINBURGH,NEW YORK (JF KENNEDY),0,0,0,13074,13074,0,-100
25/03/2022 10:55,2021,80,UNITED STATES OF AMERICA,USA,2,EDINBURGH,NEW YORK (NEWARK),0,0,0,21929,21929,0,-100
25/03/2022 10:55,2021,80,UNITED STATES OF AMERICA,USA,2,GLASGOW,DETROIT,0,0,0,142,0,142,-100
25/03/2022 10:55,2021,80,UNITED STATES OF AMERICA,USA,2,GLASGOW,ORLANDO,0,0,0,262,262,0,-100
25/03/2022 10:55,2021,80,UNITED STATES OF AMERICA,USA,2,GLASGOW,PHILADELPHIA INTERNATIONAL,36,0,36,0,0,0,0
25/03/2022 10:55,2021,80,UNITED STATES OF AMERICA,USA,2,LEEDS BRADFORD,NEW YORK (NEWARK),0,0,0,220,220,0,-100
25/03/2022 10:55,2021,80,UNITED STATES OF AMERICA,USA,2,MANCHESTER,ATLANTA,3903,3903,0,15765,15765,0,-75.24263
25/03/2022 10:55,2021,80,UNITED STATES OF AMERICA,USA,2,MANCHESTER,HOUSTON,1541,1541,0,11199,11199,0,-86.23984
25/03/2022 10:55,2021,80,UNITED STATES OF AMERICA,USA,2,MANCHESTER,NEW YORK (JF KENNEDY),24553,24553,0,36605,36605,0,-32.92446
25/03/2022 10:55,2021,80,UNITED STATES OF AMERICA,USA,2,MANCHESTER,NEW YORK (NEWARK),0,0,0,26501,26501,0,-100
25/03/2022 10:55,2021,80,UNITED STATES OF AMERICA,USA,2,MANCHESTER,ORLANDO,21790,21676,114,49505,49505,0,-55.98424
25/03/2022 10:55,2021,80,UNITED STATES OF AMERICA,USA,2,MANCHESTER,PHILADELPHIA INTERNATIONAL,0,0,0,20147,20147,0,-100
25/03/2022 10:55,2021,85,CENTRAL AMERICA,COSTA RICA,1,GATWICK,LIBERIA,2438,0,2438,7077,0,7077,-65.55037
25/03/2022 10:55,2021,85,CENTRAL AMERICA,COSTA RICA,1,GATWICK,SAN JOSE COST RICA,4670,4670,0,19767,19767,0,-76.37477
25/03/2022 10:55,2021,85,CENTRAL AMERICA,COSTA RICA,1,HEATHROW,SAN JOSE COST RICA,0,0,0,172,0,172,-100
25/03/2022 10:55,2021,85,CENTRAL AMERICA,CUBA,1,GATWICK,HAVANA,0,0,0,11104,11104,0,-100
25/03/2022 10:55,2021,85,CENTRAL AMERICA,CUBA,1,GATWICK,VARADERO,730,0,730,2661,0,2661,-72.5667
25/03/2022 10:55,2021,85,CENTRAL AMERICA,CUBA,1,HEATHROW,HAVANA,0,0,0,996,342,654,-100
25/03/2022 10:55,2021,85,CENTRAL AMERICA,CUBA,2,MANCHESTER,VARADERO,5248,0,5248,3794,0,3794,38.32367
25/03/2022 10:55,2021,85,CENTRAL AMERICA,DOMINICAN REPUBLIC,1,GATWICK,PUNTA CANA,13109,5059,8050,48382,32073,16309,-72.90521
25/03/2022 10:55,2021,85,CENTRAL AMERICA,DOMINICAN REPUBLIC,1,HEATHROW,PUNTA CANA,0,0,0,162,0,162,-100
25/03/2022 10:55,2021,85,CENTRAL AMERICA,DOMINICAN REPUBLIC,2,MANCHESTER,LA ROMANA,0,0,0,1082,0,1082,-100
25/03/2022 10:55,2021,85,CENTRAL AMERICA,DOMINICAN REPUBLIC,2,MANCHESTER,PUNTA CANA,7656,0,7656,15000,0,15000,-48.96
25/03/2022 10:55,2021,85,CENTRAL AMERICA,HONDURAS,1,HEATHROW,SAN PEDRO SULA,0,0,0,285,0,285,-100
25/03/2022 10:55,2021,85,CENTRAL AMERICA,MEXICO,1,GATWICK,CANCUN,76473,76473,0,65786,65786,0,16.2451
25/03/2022 10:55,2021,85,CENTRAL AMERICA,MEXICO,1,GATWICK,LOS CABOS,0,0,0,6162,0,6162,-100
25/03/2022 10:55,2021,85,CENTRAL AMERICA,MEXICO,1,GATWICK,MEXICO CITY,66,66,0,141,0,141,-53.19149
25/03/2022 10:55,2021,85,CENTRAL AMERICA,MEXICO,1,GATWICK,PUERTO VALLARTA,2929,0,2929,0,0,0,0
25/03/2022 10:55,2021,85,CENTRAL AMERICA,MEXICO,1,HEATHROW,CANCUN,1091,1091,0,0,0,0,0
25/03/2022 10:55,2021,85,CENTRAL AMERICA,MEXICO,1,HEATHROW,MEXICO CITY,45564,44727,837,60549,60549,0,-24.74855
25/03/2022 10:55,2021,85,CENTRAL AMERICA,MEXICO,2,BIRMINGHAM,CANCUN,9806,9806,0,15901,15901,0,-38.33092
25/03/2022 10:55,2021,85,CENTRAL AMERICA,MEXICO,2,EAST MIDLANDS INTERNATIONAL,MERIDA,0,0,0,51,0,51,-100
25/03/2022 10:55,2021,85,CENTRAL AMERICA,MEXICO,2,MANCHESTER,CANCUN,21892,21892,0,22636,22429,207,-3.2868
25/03/2022 10:55,2021,85,CENTRAL AMERICA,MEXICO,2,MANCHESTER,PUERTO VALLARTA,4777,0,4777,16036,0,16036,-70.21078
25/03/2022 10:55,2021,90,SOUTH AMERICA,ARGENTINA,1,GATWICK,BUENOS AIRES,0,0,0,32579,32251,328,-100
25/03/2022 10:55,2021,90,SOUTH AMERICA,ARGENTINA,1,HEATHROW,BUENOS AIRES,6583,6583,0,41390,41137,253,-84.09519
25/03/2022 10:55,2021,90,SOUTH AMERICA,BRAZIL,1,GATWICK,RIO DE JANEIRO (GALEAO),0,0,0,22968,22968,0,-100
25/03/2022 10:55,2021,90,SOUTH AMERICA,BRAZIL,1,HEATHROW,RECIFE,0,0,0,172,0,172,-100
25/03/2022 10:55,2021,90,SOUTH AMERICA,BRAZIL,1,HEATHROW,RIO DE JANEIRO (GALEAO),6477,6477,0,31554,31554,0,-79.47328
25/03/2022 10:55,2021,90,SOUTH AMERICA,BRAZIL,1,HEATHROW,SAO PAULO (GUARULHOS),23066,22975,91,164708,164061,647,-85.99582
25/03/2022 10:55,2021,90,SOUTH AMERICA,BRAZIL,2,BELFAST INTERNATIONAL,MARECHAL CUNHA MACHADO INTERNATIONAL,35,0,35,0,0,0,0
25/03/2022 10:55,2021,90,SOUTH AMERICA,BRAZIL,2,MANCHESTER,RECIFE,0,0,0,25,0,25,-100
25/03/2022 10:55,2021,90,SOUTH AMERICA,CHILE,1,HEATHROW,SANTIAGO DE CHILE,5241,5241,0,24514,24332,182,-78.62038
25/03/2022 10:55,2021,90,SOUTH AMERICA,COLOMBIA,1,HEATHROW,BOGOTA,0,0,0,38222,38044,178,-100
25/03/2022 10:55,2021,90,SOUTH AMERICA,COLOMBIA,1,HEATHROW,CARTAGENA,0,0,0,204,0,204,-100
25/03/2022 10:55,2021,90,SOUTH AMERICA,ECUADOR,1,GATWICK,GUAYAQUIL,0,0,0,155,0,155,-100
25/03/2022 10:55,2021,90,SOUTH AMERICA,ECUADOR,1,HEATHROW,GUAYAQUIL,0,0,0,175,0,175,-100
25/03/2022 10:55,2021,90,SOUTH AMERICA,ECUADOR,1,HEATHROW,MARISCAL SUCRE INTERNATIONAL,0,0,0,77,0,77,-100
25/03/2022 10:55,2021,90,SOUTH AMERICA,GUYANA,1,HEATHROW,GEORGETOWN (GUYANA),964,0,964,949,0,949,1.58061
25/03/2022 10:55,2021,90,SOUTH AMERICA,GUYANA,1,STANSTED,GEORGETOWN (GUYANA),43,0,43,92,0,92,-53.26087
25/03/2022 10:55,2021,90,SOUTH AMERICA,GUYANA,2,GLASGOW,GEORGETOWN (GUYANA),0,0,0,135,0,135,-100
25/03/2022 10:55,2021,90,SOUTH AMERICA,PERU,1,GATWICK,JORGE CHAVEZ INTERNATIONAL,0,0,0,577,0,577,-100
25/03/2022 10:55,2021,90,SOUTH AMERICA,PERU,1,HEATHROW,JORGE CHAVEZ INTERNATIONAL,0,0,0,1203,0,1203,-100
25/03/2022 10:55,2021,90,SOUTH AMERICA,SURINAM,1,STANSTED,PARAMARIBO,16,0,16,0,0,0,0
25/03/2022 10:55,2021,95,CARIBBEAN AREA,ANTIGUA AND BARBUDA,1,GATWICK,ANTIGUA,71290,71290,0,72050,72050,0,-1.05482
25/03/2022 10:55,2021,95,CARIBBEAN AREA,ANTIGUA AND BARBUDA,1,HEATHROW,ANTIGUA,32702,32702,0,4041,3809,232,709.25513
25/03/2022 10:55,2021,95,CARIBBEAN AREA,ANTIGUA AND BARBUDA,2,MANCHESTER,ANTIGUA,0,0,0,75,0,75,-100
25/03/2022 10:55,2021,95,CARIBBEAN AREA,ANTIGUA AND BARBUDA,2,MANCHESTER,ST MAARTEN,0,0,0,232,0,232,-100
25/03/2022 10:55,2021,95,CARIBBEAN AREA,BAHAMAS,1,HEATHROW,FREEPORT,0,0,0,117,0,117,-100
25/03/2022 10:55,2021,95,CARIBBEAN AREA,BAHAMAS,1,HEATHROW,NASSAU,37251,37251,0,13324,12971,353,179.5782
25/03/2022 10:55,2021,95,CARIBBEAN AREA,BARBADOS,1,GATWICK,BRIDGETOWN,26483,17008,9475,179585,133193,46392,-85.25322
25/03/2022 10:55,2021,95,CARIBBEAN AREA,BARBADOS,1,HEATHROW,BRIDGETOWN,159048,159048,0,27965,24087,3878,468.7395
25/03/2022 10:55,2021,95,CARIBBEAN AREA,BARBADOS,1,STANSTED,BRIDGETOWN,0,0,0,294,0,294,-100
25/03/2022 10:55,2021,95,CARIBBEAN AREA,BARBADOS,2,BELFAST INTERNATIONAL,BRIDGETOWN,0,0,0,567,0,567,-100
25/03/2022 10:55,2021,95,CARIBBEAN AREA,BARBADOS,2,BIRMINGHAM,BRIDGETOWN,4735,0,4735,28564,0,28564,-83.42319
25/03/2022 10:55,2021,95,CARIBBEAN AREA,BARBADOS,2,BOURNEMOUTH,BRIDGETOWN,0,0,0,1245,0,1245,-100
25/03/2022 10:55,2021,95,CARIBBEAN AREA,BARBADOS,2,BRISTOL,BRIDGETOWN,0,0,0,603,0,603,-100
25/03/2022 10:55,2021,95,CARIBBEAN AREA,BARBADOS,2,CARDIFF WALES,BRIDGETOWN,283,0,283,1775,0,1775,-84.05634
25/03/2022 10:55,2021,95,CARIBBEAN AREA,BARBADOS,2,DONCASTER SHEFFIELD,BRIDGETOWN,0,0,0,611,0,611,-100
25/03/2022 10:55,2021,95,CARIBBEAN AREA,BARBADOS,2,EDINBURGH,BRIDGETOWN,707,707,0,0,0,0,0
25/03/2022 10:55,2021,95,CARIBBEAN AREA,BARBADOS,2,GLASGOW,BRIDGETOWN,798,0,798,4170,391,3779,-80.86331
25/03/2022 10:55,2021,95,CARIBBEAN AREA,BARBADOS,2,MANCHESTER,BRIDGETOWN,36849,25305,11544,52679,21740,30939,-30.04993
25/03/2022 10:55,2021,95,CARIBBEAN AREA,BARBADOS,2,NEWCASTLE,BRIDGETOWN,0,0,0,2404,2404,0,-100
25/03/2022 10:55,2021,95,CARIBBEAN AREA,BERMUDA,1,GATWICK,BERMUDA,3043,3043,0,32440,32440,0,-90.61961
25/03/2022 10:55,2021,95,CARIBBEAN AREA,BERMUDA,1,HEATHROW,BERMUDA,40224,40224,0,298,0,298,13397.98658
25/03/2022 10:55,2021,95,CARIBBEAN AREA,CAYMAN ISLANDS,1,GATWICK,GRAND CAYMAN,0,0,0,498,0,498,-100
25/03/2022 10:55,2021,95,CARIBBEAN AREA,CAYMAN ISLANDS,1,HEATHROW,GRAND CAYMAN,10142,10142,0,12752,11325,1427,-20.46738
25/03/2022 10:55,2021,95,CARIBBEAN AREA,GRENADA,1,GATWICK,GRENADA,8435,8435,0,14815,14815,0,-43.06446
25/03/2022 10:55,2021,95,CARIBBEAN AREA,GRENADA,1,HEATHROW,GRENADA,3161,3161,0,293,293,0,978.83959
25/03/2022 10:55,2021,95,CARIBBEAN AREA,GUADELOUPE,1,HEATHROW,POINTE A PITRE GUADELOUPE,0,0,0,166,0,166,-100
25/03/2022 10:55,2021,95,CARIBBEAN AREA,ISLE OF CURACAO NETH.ANTILLES,1,GATWICK,ARUBA,274,0,274,1123,0,1123,-75.60107
25/03/2022 10:55,2021,95,CARIBBEAN AREA,ISLE OF CURACAO NETH.ANTILLES,1,HEATHROW,CURACAO,0,0,0,225,0,225,-100
25/03/2022 10:55,2021,95,CARIBBEAN AREA,ISLE OF CURACAO NETH.ANTILLES,1,STANSTED,CURACAO,0,0,0,19,19,0,-100
25/03/2022 10:55,2021,95,CARIBBEAN AREA,JAMAICA,1,GATWICK,KINGSTON,48508,48382,126,44145,43789,356,9.88334
25/03/2022 10:55,2021,95,CARIBBEAN AREA,JAMAICA,1,GATWICK,MONTEGO BAY,40572,16998,23574,51756,27065,24691,-21.60909
25/03/2022 10:55,2021,95,CARIBBEAN AREA,JAMAICA,1,HEATHROW,KINGSTON,0,0,0,167,0,167,-100
25/03/2022 10:55,2021,95,CARIBBEAN AREA,JAMAICA,1,HEATHROW,MONTEGO BAY,27325,27325,0,5564,5564,0,391.10352
25/03/2022 10:55,2021,95,CARIBBEAN AREA,JAMAICA,2,BIRMINGHAM,MONTEGO BAY,7204,0,7204,7505,0,7505,-4.01066
25/03/2022 10:55,2021,95,CARIBBEAN AREA,JAMAICA,2,CARDIFF WALES,MONTEGO BAY,0,0,0,1188,0,1188,-100
25/03/2022 10:55,2021,95,CARIBBEAN AREA,JAMAICA,2,DONCASTER SHEFFIELD,KINGSTON,0,0,0,119,0,119,-100
25/03/2022 10:55,2021,95,CARIBBEAN AREA,JAMAICA,2,DONCASTER SHEFFIELD,MONTEGO BAY,0,0,0,611,0,611,-100
25/03/2022 10:55,2021,95,CARIBBEAN AREA,JAMAICA,2,GLASGOW,MONTEGO BAY,0,0,0,878,0,878,-100
25/03/2022 10:55,2021,95,CARIBBEAN AREA,JAMAICA,2,MANCHESTER,MONTEGO BAY,18291,0,18291,24424,0,24424,-25.11055
25/03/2022 10:55,2021,95,CARIBBEAN AREA,JAMAICA,2,NEWCASTLE,MONTEGO BAY,0,0,0,1198,1198,0,-100
25/03/2022 10:55,2021,95,CARIBBEAN AREA,SAINT KITTS AND NEVIS,1,GATWICK,ST KITTS,3558,3558,0,4334,4334,0,-17.90494
25/03/2022 10:55,2021,95,CARIBBEAN AREA,SAINT VINCENT AND THE GRENADINES,1,HEATHROW,E T JOSHUA,1530,1530,0,0,0,0,0
25/03/2022 10:55,2021,95,CARIBBEAN AREA,ST LUCIA,1,GATWICK,ST LUCIA (HEWANORRA),59390,44777,14613,64435,58693,5742,-7.8296
25/03/2022 10:55,2021,95,CARIBBEAN AREA,ST LUCIA,1,HEATHROW,ST LUCIA (HEWANORRA),11240,11240,0,29,29,0,38658.62069
25/03/2022 10:55,2021,95,CARIBBEAN AREA,ST LUCIA,2,MANCHESTER,ST LUCIA (HEWANORRA),541,0,541,2407,0,2407,-77.52389
25/03/2022 10:55,2021,95,CARIBBEAN AREA,TRINIDAD AND TOBAGO,1,GATWICK,PORT OF SPAIN,4880,4880,0,15152,15152,0,-67.79303
25/03/2022 10:55,2021,95,CARIBBEAN AREA,TRINIDAD AND TOBAGO,1,GATWICK,TOBAGO,0,0,0,8961,8961,0,-100
25/03/2022 10:55,2021,95,CARIBBEAN AREA,TURKS AND CAICOS ISLANDS,1,GATWICK,PROVIDENCIALES,6183,6183,0,2710,2710,0,128.15498
25/03/2022 10:55,2021,95,CARIBBEAN AREA,TURKS AND CAICOS ISLANDS,1,HEATHROW,PROVIDENCIALES,1231,1231,0,338,0,338,264.20118
25/03/2022 10:55,2021,100,INDIAN OCEAN ISLANDS,MALDIVE ISLANDS,1,GATWICK,MALE INTERNATIONAL,0,0,0,20929,20929,0,-100
25/03/2022 10:55,2021,100,INDIAN OCEAN ISLANDS,MALDIVE ISLANDS,1,HEATHROW,MALE INTERNATIONAL,43221,43221,0,12692,12692,0,240.53735
25/03/2022 10:55,2021,100,INDIAN OCEAN ISLANDS,MAURITIUS,1,GATWICK,MAURITIUS,28560,28560,0,35488,35488,0,-19.52209
25/03/2022 10:55,2021,100,INDIAN OCEAN ISLANDS,MAURITIUS,1,HEATHROW,MAURITIUS,21354,21354,0,19338,19034,304,10.42507
25/03/2022 10:55,2021,100,INDIAN OCEAN ISLANDS,SEYCHELLES,1,HEATHROW,SEYCHELLES,272,272,0,9995,9995,0,-97.27864
25/03/2022 10:55,2021,105,ATLANTIC OCEAN ISLANDS,ASCENSION ISLAND,1,STANSTED,SAINT HELENA,1280,0,1280,107,0,107,1096.26168
25/03/2022 10:55,2021,105,ATLANTIC OCEAN ISLANDS,CAPE VERDE ISLANDS,1,GATWICK,BOA VISTA (RABIL),6575,6575,0,20097,19466,631,-67.28367
25/03/2022 10:55,2021,105,ATLANTIC OCEAN ISLANDS,CAPE VERDE ISLANDS,1,GATWICK,ILHA DO SAL C.VERDE,8073,8073,0,15354,14729,625,-47.42087
25/03/2022 10:55,2021,105,ATLANTIC OCEAN ISLANDS,CAPE VERDE ISLANDS,1,STANSTED,ILHA DO SAL C.VERDE,0,0,0,217,0,217,-100
25/03/2022 10:55,2021,105,ATLANTIC OCEAN ISLANDS,CAPE VERDE ISLANDS,1,STANSTED,PRAIA,25,0,25,0,0,0,0
25/03/2022 10:55,2021,105,ATLANTIC OCEAN ISLANDS,CAPE VERDE ISLANDS,2,BIGGIN HILL,ILHA DO SAL C.VERDE,0,0,0,7,0,7,-100
25/03/2022 10:55,2021,105,ATLANTIC OCEAN ISLANDS,CAPE VERDE ISLANDS,2,BIRMINGHAM,BOA VISTA (RABIL),2968,2968,0,9739,9657,82,-69.52459
25/03/2022 10:55,2021,105,ATLANTIC OCEAN ISLANDS,CAPE VERDE ISLANDS,2,BIRMINGHAM,ILHA DO SAL C.VERDE,3304,3304,0,8617,8617,0,-61.65719
25/03/2022 10:55,2021,105,ATLANTIC OCEAN ISLANDS,CAPE VERDE ISLANDS,2,BRISTOL,ILHA DO SAL C.VERDE,566,566,0,3781,0,3781,-85.03042
25/03/2022 10:55,2021,105,ATLANTIC OCEAN ISLANDS,CAPE VERDE ISLANDS,2,MANCHESTER,BOA VISTA (RABIL),6387,6387,0,14283,14283,0,-55.2825
25/03/2022 10:55,2021,105,ATLANTIC OCEAN ISLANDS,CAPE VERDE ISLANDS,2,MANCHESTER,ILHA DO SAL C.VERDE,7802,7802,0,13634,13599,35,-42.77541
25/03/2022 10:55,2021,105,ATLANTIC OCEAN ISLANDS,GREENLAND,1,STANSTED,SONDRE STROMFJORD,431,0,431,0,0,0,0
25/03/2022 10:55,2021,115,OIL RIGS,OIL RIGS,2,ABERDEEN,OIL RIGS,321890,0,321890,310057,0,310057,3.8164
25/03/2022 10:55,2021,115,OIL RIGS,OIL RIGS,2,BLACKPOOL,OIL RIGS,0,0,0,11412,0,11412,-100
25/03/2022 10:55,2021,115,OIL RIGS,OIL RIGS,2,HUMBERSIDE,OIL RIGS,14224,0,14224,7408,0,7408,92.00864
25/03/2022 10:55,2021,115,OIL RIGS,OIL RIGS,2,INVERNESS,OIL RIGS,0,0,0,19,0,19,-100
25/03/2022 10:55,2021,115,OIL RIGS,OIL RIGS,2,KIRKWALL,OIL RIGS,76,0,76,47,0,47,61.70213
25/03/2022 10:55,2021,115,OIL RIGS,OIL RIGS,2,NORWICH,OIL RIGS,70894,0,70894,58042,0,58042,22.14259
25/03/2022 10:55,2021,115,OIL RIGS,OIL RIGS,2,SCATSTA,OIL RIGS,0,0,0,16361,0,16361,-100
25/03/2022 10:55,2021,115,OIL RIGS,OIL RIGS,2,SUMBURGH,OIL RIGS,67292,0,67292,38009,0,38009,77.04228
25/03/2022 10:55,2021,115,OIL RIGS,OIL RIGS,2,WICK JOHN O GROATS,OIL RIGS,0,0,0,8,0,8,-100

